År,Måned,Dag,Fra_time,Volum til SNTR,Volum til DNP,Volum totalt
2015,12,16,11,265,232,497
2015,12,16,12,243,223,466
2015,12,16,13,251,289,540
2015,12,16,14,369,409,778
2015,12,16,15,283,365,648
2015,12,16,16,219,200,419
2015,12,16,17,180,160,340
2015,12,16,18,162,211,373
2015,12,16,19,119,142,261
2015,12,16,20,77,126,203
2015,12,16,21,66,357,423
2015,12,16,22,44,312,356
2015,12,16,23,25,39,64
2015,12,17,0,17,39,56
2015,12,17,1,14,25,39
2015,12,17,2,10,31,41
2015,12,17,3,7,35,42
2015,12,17,4,21,20,41
2015,12,17,5,110,73,183
2015,12,17,6,274,203,477
2015,12,17,7,481,233,714
2015,12,17,8,267,181,448
2015,12,17,9,252,181,433
2015,12,17,10,242,226,468
2015,12,17,11,266,217,483
2015,12,17,12,256,261,517
2015,12,17,13,248,309,557
2015,12,17,14,369,429,798
2015,12,17,15,333,387,720
2015,12,17,16,235,226,461
2015,12,17,17,199,200,399
2015,12,17,18,175,184,359
2015,12,17,19,106,142,248
2015,12,17,20,121,124,245
2015,12,17,21,69,76,145
2015,12,17,22,59,70,129
2015,12,17,23,25,43,68
2015,12,18,0,28,38,66
2015,12,18,1,12,39,51
2015,12,18,2,13,41,54
2015,12,18,3,8,20,28
2015,12,18,4,27,18,45
2015,12,18,5,109,77,186
2015,12,18,6,267,188,455
2015,12,18,7,408,191,599
2015,12,18,8,275,180,455
2015,12,18,9,232,192,424
2015,12,18,10,276,197,473
2015,12,18,11,267,245,512
2015,12,18,12,308,276,584
2015,12,18,13,320,357,677
2015,12,18,14,388,431,819
2015,12,18,15,295,394,689
2015,12,18,16,352,241,593
2015,12,18,17,189,203,392
2015,12,18,18,157,162,319
2015,12,18,19,113,154,267
2015,12,18,20,78,88,166
2015,12,18,21,55,62,117
2015,12,18,22,66,83,149
2015,12,18,23,37,52,89
2015,12,19,0,28,47,75
2015,12,19,1,22,40,62
2015,12,19,2,17,40,57
2015,12,19,3,16,31,47
2015,12,19,4,20,13,33
2015,12,19,5,27,25,52
2015,12,19,6,26,22,48
2015,12,19,7,42,34,76
2015,12,19,8,58,57,115
2015,12,19,9,94,69,163
2015,12,19,10,162,126,288
2015,12,19,11,194,152,346
2015,12,19,12,165,166,331
2015,12,19,13,198,221,419
2015,12,19,14,208,182,390
2015,12,19,15,156,150,306
2015,12,19,16,154,158,312
2015,12,19,17,126,153,279
2015,12,19,18,145,144,289
2015,12,19,19,91,99,190
2015,12,19,20,60,90,150
2015,12,19,21,41,72,113
2015,12,19,22,40,72,112
2015,12,19,23,44,61,105
2015,12,20,0,48,68,116
2015,12,20,1,36,38,74
2015,12,20,2,23,58,81
2015,12,20,3,25,50,75
2015,12,20,4,20,26,46
2015,12,20,5,21,14,35
2015,12,20,6,16,22,38
2015,12,20,7,21,19,40
2015,12,20,8,33,35,68
2015,12,20,9,91,47,138
2015,12,20,10,104,85,189
2015,12,20,11,166,132,298
2015,12,20,12,169,151,320
2015,12,20,13,222,194,416
2015,12,20,14,178,207,385
2015,12,20,15,178,166,344
2015,12,20,16,146,114,260
2015,12,20,17,116,123,239
2015,12,20,18,158,149,307
2015,12,20,19,137,151,288
2015,12,20,20,102,117,219
2015,12,20,21,62,60,122
2015,12,20,22,43,66,109
2015,12,20,23,21,39,60
2015,12,21,0,15,25,40
2015,12,21,1,12,13,25
2015,12,21,2,12,11,23
2015,12,21,3,9,16,25
2015,12,21,4,28,24,52
2015,12,21,5,105,92,197
2015,12,21,6,254,185,439
2015,12,21,7,347,202,549
2015,12,21,8,235,153,388
2015,12,21,9,248,213,461
2015,12,21,10,295,244,539
2015,12,21,11,282,257,539
2015,12,21,12,299,336,635
2015,12,21,13,318,367,685
2015,12,21,14,364,444,808
2015,12,21,15,338,443,781
2015,12,21,16,231,248,479
2015,12,21,17,161,200,361
2015,12,21,18,145,224,369
2015,12,21,19,136,174,310
2015,12,21,20,111,123,234
2015,12,21,21,78,85,163
2015,12,21,22,51,77,128
2015,12,21,23,19,38,57
2015,12,22,0,12,32,44
2015,12,22,1,5,17,22
2015,12,22,2,13,21,34
2015,12,22,3,8,12,20
2015,12,22,4,12,16,28
2015,12,22,5,87,57,144
2015,12,22,6,234,163,397
2015,12,22,7,335,185,520
2015,12,22,8,254,169,423
2015,12,22,9,253,229,482
2015,12,22,10,262,256,518
2015,12,22,11,244,265,509
2015,12,22,12,290,275,565
2015,12,22,13,310,325,635
2015,12,22,14,331,413,744
2015,12,22,15,241,299,540
2015,12,22,16,190,185,375
2015,12,22,17,143,135,278
2015,12,22,18,139,173,312
2015,12,22,19,128,150,278
2015,12,22,20,94,97,191
2015,12,22,21,71,67,138
2015,12,22,22,46,58,104
2015,12,22,23,26,31,57
2015,12,23,0,12,25,37
2015,12,23,1,17,28,45
2015,12,23,2,15,21,36
2015,12,23,3,11,14,25
2015,12,23,4,16,19,35
2015,12,23,5,64,48,112
2015,12,23,6,174,117,291
2015,12,23,7,179,113,292
2015,12,23,8,162,114,276
2015,12,23,9,192,164,356
2015,12,23,10,209,188,397
2015,12,23,11,259,233,492
2015,12,23,12,254,282,536
2015,12,23,13,290,244,534
2015,12,23,14,251,278,529
2015,12,23,15,195,218,413
2015,12,23,16,176,167,343
2015,12,23,17,135,126,261
2015,12,23,18,119,123,242
2015,12,23,19,93,102,195
2015,12,23,20,81,73,154
2015,12,23,21,48,47,95
2015,12,23,22,46,48,94
2015,12,23,23,19,22,41
2015,12,24,0,15,26,41
2015,12,24,1,14,10,24
2015,12,24,2,5,6,11
2015,12,24,3,6,9,15
2015,12,24,4,3,7,10
2015,12,24,5,24,16,40
2015,12,24,6,41,40,81
2015,12,24,7,40,34,74
2015,12,24,8,55,56,111
2015,12,24,9,82,75,157
2015,12,24,10,107,113,220
2015,12,24,11,190,169,359
2015,12,24,12,173,161,334
2015,12,24,13,149,112,261
2015,12,24,14,152,126,278
2015,12,24,15,135,157,292
2015,12,24,16,76,92,168
2015,12,24,17,49,47,96
2015,12,24,18,23,39,62
2015,12,24,19,38,31,69
2015,12,24,20,46,43,89
2015,12,24,21,74,99,173
2015,12,24,22,54,49,103
2015,12,24,23,68,67,135
2015,12,25,0,27,29,56
2015,12,25,1,19,18,37
2015,12,25,2,13,5,18
2015,12,25,3,6,12,18
2015,12,25,4,5,4,9
2015,12,25,5,11,15,26
2015,12,25,6,17,12,29
2015,12,25,7,9,7,16
2015,12,25,8,14,10,24
2015,12,25,9,32,25,57
2015,12,25,10,37,38,75
2015,12,25,11,62,72,134
2015,12,25,12,85,88,173
2015,12,25,13,107,116,223
2015,12,25,14,113,93,206
2015,12,25,15,119,131,250
2015,12,25,16,79,80,159
2015,12,25,17,73,73,146
2015,12,25,18,64,83,147
2015,12,25,19,66,79,145
2015,12,25,20,63,64,127
2015,12,25,21,52,43,95
2015,12,25,22,25,45,70
2015,12,25,23,35,37,72
2015,12,26,0,16,23,39
2015,12,26,1,22,17,39
2015,12,26,2,15,20,35
2015,12,26,3,12,22,34
2015,12,26,4,11,7,18
2015,12,26,5,17,13,30
2015,12,26,6,24,18,42
2015,12,26,7,9,13,22
2015,12,26,8,22,15,37
2015,12,26,9,40,36,76
2015,12,26,10,69,53,122
2015,12,26,11,97,88,185
2015,12,26,12,108,125,233
2015,12,26,13,128,141,269
2015,12,26,14,129,130,259
2015,12,26,15,121,105,226
2015,12,26,16,108,93,201
2015,12,26,17,125,105,230
2015,12,26,18,115,92,207
2015,12,26,19,130,110,240
2015,12,26,20,108,92,200
2015,12,26,21,60,68,128
2015,12,26,22,52,50,102
2015,12,26,23,34,49,83
2015,12,27,0,27,41,68
2015,12,27,1,22,34,56
2015,12,27,2,22,55,77
2015,12,27,3,16,33,49
2015,12,27,4,20,40,60
2015,12,27,5,12,11,23
2015,12,27,6,17,15,32
2015,12,27,7,20,17,37
2015,12,27,8,19,25,44
2015,12,27,9,56,29,85
2015,12,27,10,61,51,112
2015,12,27,11,93,89,182
2015,12,27,12,84,80,164
2015,12,27,13,104,116,220
2015,12,27,14,101,135,236
2015,12,27,15,101,121,222
2015,12,27,16,112,94,206
2015,12,27,17,104,74,178
2015,12,27,18,105,101,206
2015,12,27,19,92,120,212
2015,12,27,20,74,78,152
2015,12,27,21,51,43,94
2015,12,27,22,29,47,76
2015,12,27,23,21,35,56
2015,12,28,0,17,25,42
2015,12,28,1,7,20,27
2015,12,28,2,13,15,28
2015,12,28,3,13,11,24
2015,12,28,4,14,11,25
2015,12,28,5,48,20,68
2015,12,28,6,98,83,181
2015,12,28,7,115,60,175
2015,12,28,8,116,78,194
2015,12,28,9,121,101,222
2015,12,28,10,139,107,246
2015,12,28,11,149,126,275
2015,12,28,12,180,149,329
2015,12,28,13,165,170,335
2015,12,28,14,193,196,389
2015,12,28,15,132,135,267
2015,12,28,16,124,105,229
2015,12,28,17,102,76,178
2015,12,28,18,91,107,198
2015,12,28,19,73,73,146
2015,12,28,20,64,68,132
2015,12,28,21,45,55,100
2015,12,28,22,56,50,106
2015,12,28,23,24,37,61
2015,12,29,0,9,16,25
2015,12,29,1,13,20,33
2015,12,29,2,12,19,31
2015,12,29,3,13,15,28
2015,12,29,4,16,12,28
2015,12,29,5,51,19,70
2015,12,29,6,98,63,161
2015,12,29,7,124,77,201
2015,12,29,8,119,85,204
2015,12,29,9,140,98,238
2015,12,29,10,151,112,263
2015,12,29,11,161,136,297
2015,12,29,12,200,190,390
2015,12,29,13,210,177,387
2015,12,29,14,211,233,444
2015,12,29,15,196,196,392
2015,12,29,16,131,126,257
2015,12,29,17,93,115,208
2015,12,29,18,93,116,209
2015,12,29,19,109,111,220
2015,12,29,20,63,75,138
2015,12,29,21,46,59,105
2015,12,29,22,39,49,88
2015,12,29,23,29,22,51
2015,12,30,0,21,22,43
2015,12,30,1,9,26,35
2015,12,30,2,19,19,38
2015,12,30,3,2,13,15
2015,12,30,4,14,7,21
2015,12,30,5,47,24,71
2015,12,30,6,96,68,164
2015,12,30,7,100,78,178
2015,12,30,8,105,65,170
2015,12,30,9,134,109,243
2015,12,30,10,180,124,304
2015,12,30,11,196,148,344
2015,12,30,12,193,182,375
2015,12,30,13,195,184,379
2015,12,30,14,221,232,453
2015,12,30,15,158,177,335
2015,12,30,16,141,138,279
2015,12,30,17,116,131,247
2015,12,30,18,100,94,194
2015,12,30,19,96,98,194
2015,12,30,20,70,86,156
2015,12,30,21,44,48,92
2015,12,30,22,37,48,85
2015,12,30,23,29,34,63
2015,12,31,0,14,27,41
2015,12,31,1,15,19,34
2015,12,31,2,11,16,27
2015,12,31,3,8,10,18
2015,12,31,4,6,4,10
2015,12,31,5,24,18,42
2015,12,31,6,42,42,84
2015,12,31,7,41,32,73
2015,12,31,8,66,43,109
2015,12,31,9,50,57,107
2015,12,31,10,100,102,202
2015,12,31,11,147,117,264
2015,12,31,12,124,147,271
2015,12,31,13,122,130,252
2015,12,31,14,133,128,261
2015,12,31,15,117,107,224
2015,12,31,16,118,100,218
2015,12,31,17,88,99,187
2015,12,31,18,76,83,159
2015,12,31,19,83,75,158
2015,12,31,20,53,58,111
2015,12,31,21,50,78,128
2015,12,31,22,65,52,117
2015,12,31,23,45,78,123
2016,1,1,0,62,72,134
2016,1,1,1,47,59,106
2016,1,1,2,63,56,119
2016,1,1,3,35,52,87
2016,1,1,4,34,43,77
2016,1,1,5,34,31,65
2016,1,1,6,27,19,46
2016,1,1,7,18,8,26
2016,1,1,8,22,16,38
2016,1,1,9,22,17,39
2016,1,1,10,36,38,74
2016,1,1,11,41,54,95
2016,1,1,12,64,67,131
2016,1,1,13,96,97,193
2016,1,1,14,89,113,202
2016,1,1,15,123,120,243
2016,1,1,16,87,106,193
2016,1,1,17,88,89,177
2016,1,1,18,75,72,147
2016,1,1,19,79,91,170
2016,1,1,20,59,73,132
2016,1,1,21,40,53,93
2016,1,1,22,35,48,83
2016,1,1,23,29,37,66
2016,1,2,0,18,31,49
2016,1,2,1,13,16,29
2016,1,2,2,5,10,15
2016,1,2,3,7,15,22
2016,1,2,4,6,10,16
2016,1,2,5,23,19,42
2016,1,2,6,26,18,44
2016,1,2,7,30,25,55
2016,1,2,8,38,29,67
2016,1,2,9,59,51,110
2016,1,2,10,100,73,173
2016,1,2,11,93,103,196
2016,1,2,12,137,100,237
2016,1,2,13,131,145,276
2016,1,2,14,149,141,290
2016,1,2,15,139,135,274
2016,1,2,16,114,128,242
2016,1,2,17,99,107,206
2016,1,2,18,89,101,190
2016,1,2,19,73,82,155
2016,1,2,20,75,66,141
2016,1,2,21,48,55,103
2016,1,2,22,54,60,114
2016,1,2,23,29,51,80
2016,1,3,0,23,35,58
2016,1,3,1,17,28,45
2016,1,3,2,22,33,55
2016,1,3,3,12,35,47
2016,1,3,4,8,14,22
2016,1,3,5,15,13,28
2016,1,3,6,18,13,31
2016,1,3,7,23,17,40
2016,1,3,8,34,21,55
2016,1,3,9,63,39,102
2016,1,3,10,53,56,109
2016,1,3,11,100,101,201
2016,1,3,12,120,124,244
2016,1,3,13,175,144,319
2016,1,3,14,128,174,302
2016,1,3,15,193,159,352
2016,1,3,16,173,129,302
2016,1,3,17,136,141,277
2016,1,3,18,133,178,311
2016,1,3,19,92,115,207
2016,1,3,20,97,88,185
2016,1,3,21,49,50,99
2016,1,3,22,44,44,88
2016,1,3,23,18,23,41
2016,1,4,0,11,13,24
2016,1,4,1,3,13,16
2016,1,4,2,8,4,12
2016,1,4,3,3,8,11
2016,1,4,4,13,14,27
2016,1,4,5,113,67,180
2016,1,4,6,283,174,457
2016,1,4,7,357,221,578
2016,1,4,8,219,151,370
2016,1,4,9,193,174,367
2016,1,4,10,215,168,383
2016,1,4,11,180,167,347
2016,1,4,12,184,189,373
2016,1,4,13,203,228,431
2016,1,4,14,334,356,690
2016,1,4,15,224,314,538
2016,1,4,16,162,166,328
2016,1,4,17,182,150,332
2016,1,4,18,126,122,248
2016,1,4,19,121,111,232
2016,1,4,20,68,91,159
2016,1,4,21,62,59,121
2016,1,4,22,35,33,68
2016,1,4,23,16,15,31
2016,1,5,0,9,17,26
2016,1,5,1,6,9,15
2016,1,5,2,15,8,23
2016,1,5,3,6,7,13
2016,1,5,4,19,6,25
2016,1,5,5,109,65,174
2016,1,5,6,288,196,484
2016,1,5,7,366,189,555
2016,1,5,8,217,145,362
2016,1,5,9,206,143,349
2016,1,5,10,193,183,376
2016,1,5,11,205,179,384
2016,1,5,12,198,171,369
2016,1,5,13,223,215,438
2016,1,5,14,304,345,649
2016,1,5,15,262,302,564
2016,1,5,16,168,181,349
2016,1,5,17,158,141,299
2016,1,5,18,160,130,290
2016,1,5,19,118,125,243
2016,1,5,20,85,87,172
2016,1,5,21,71,106,177
2016,1,5,22,35,33,68
2016,1,5,23,19,25,44
2016,1,6,0,7,10,17
2016,1,6,1,11,9,20
2016,1,6,2,9,11,20
2016,1,6,3,5,16,21
2016,1,6,4,21,13,34
2016,1,6,5,88,64,152
2016,1,6,6,247,167,414
2016,1,6,7,296,166,462
2016,1,6,8,196,127,323
2016,1,6,9,175,154,329
2016,1,6,10,182,149,331
2016,1,6,11,167,156,323
2016,1,6,12,205,171,376
2016,1,6,13,193,205,398
2016,1,6,14,258,270,528
2016,1,6,15,224,209,433
2016,1,6,16,162,139,301
2016,1,6,17,127,131,258
2016,1,6,18,105,136,241
2016,1,6,19,89,92,181
2016,1,6,20,69,87,156
2016,1,6,21,62,85,147
2016,1,6,22,31,68,99
2016,1,6,23,22,26,48
2016,1,7,0,14,26,40
2016,1,7,1,15,19,34
2016,1,7,2,8,11,19
2016,1,7,3,5,12,17
2016,1,7,4,17,16,33
2016,1,7,5,100,63,163
2016,1,7,6,259,163,422
2016,1,7,7,330,173,503
2016,1,7,8,186,136,322
2016,1,7,9,184,140,324
2016,1,7,10,181,162,343
2016,1,7,11,172,170,342
2016,1,7,12,142,184,326
2016,1,7,13,202,211,413
2016,1,7,14,248,291,539
2016,1,7,15,186,241,427
2016,1,7,16,139,127,266
2016,1,7,17,149,134,283
2016,1,7,18,102,109,211
2016,1,7,19,93,96,189
2016,1,7,20,72,98,170
2016,1,7,21,49,69,118
2016,1,7,22,32,38,70
2016,1,7,23,19,37,56
2016,1,8,0,6,18,24
2016,1,8,1,13,19,32
2016,1,8,2,14,24,38
2016,1,8,3,7,12,19
2016,1,8,4,17,16,33
2016,1,8,5,97,75,172
2016,1,8,6,246,140,386
2016,1,8,7,296,183,479
2016,1,8,8,208,145,353
2016,1,8,9,189,153,342
2016,1,8,10,190,161,351
2016,1,8,11,171,170,341
2016,1,8,12,184,187,371
2016,1,8,13,225,224,449
2016,1,8,14,272,283,555
2016,1,8,15,185,263,448
2016,1,8,16,139,125,264
2016,1,8,17,86,85,171
2016,1,8,18,104,84,188
2016,1,8,19,55,83,138
2016,1,8,20,62,77,139
2016,1,8,21,55,57,112
2016,1,8,22,42,51,93
2016,1,8,23,34,57,91
2016,1,9,0,30,37,67
2016,1,9,1,22,32,54
2016,1,9,2,21,36,57
2016,1,9,3,11,26,37
2016,1,9,4,9,9,18
2016,1,9,5,35,8,43
2016,1,9,6,25,27,52
2016,1,9,7,37,25,62
2016,1,9,8,60,37,97
2016,1,9,9,87,71,158
2016,1,9,10,115,96,211
2016,1,9,11,146,144,290
2016,1,9,12,163,141,304
2016,1,9,13,156,163,319
2016,1,9,14,176,169,345
2016,1,9,15,124,176,300
2016,1,9,16,129,163,292
2016,1,9,17,131,140,271
2016,1,9,18,135,160,295
2016,1,9,19,90,92,182
2016,1,9,20,60,58,118
2016,1,9,21,41,47,88
2016,1,9,22,51,64,115
2016,1,9,23,41,69,110
2016,1,10,0,37,52,89
2016,1,10,1,30,52,82
2016,1,10,2,29,55,84
2016,1,10,3,18,49,67
2016,1,10,4,13,15,28
2016,1,10,5,18,14,32
2016,1,10,6,18,16,34
2016,1,10,7,28,23,51
2016,1,10,8,69,35,104
2016,1,10,9,80,50,130
2016,1,10,10,86,70,156
2016,1,10,11,110,160,270
2016,1,10,12,150,154,304
2016,1,10,13,179,192,371
2016,1,10,14,187,175,362
2016,1,10,15,173,226,399
2016,1,10,16,144,179,323
2016,1,10,17,141,169,310
2016,1,10,18,137,172,309
2016,1,10,19,99,122,221
2016,1,10,20,83,90,173
2016,1,10,21,60,60,120
2016,1,10,22,38,49,87
2016,1,10,23,23,25,48
2016,1,11,0,9,13,22
2016,1,11,1,7,13,20
2016,1,11,2,13,11,24
2016,1,11,3,6,9,15
2016,1,11,4,14,16,30
2016,1,11,5,125,66,191
2016,1,11,6,266,173,439
2016,1,11,7,330,206,536
2016,1,11,8,219,133,352
2016,1,11,9,200,161,361
2016,1,11,10,191,159,350
2016,1,11,11,187,160,347
2016,1,11,12,193,172,365
2016,1,11,13,177,201,378
2016,1,11,14,256,326,582
2016,1,11,15,191,248,439
2016,1,11,16,175,144,319
2016,1,11,17,140,143,283
2016,1,11,18,107,118,225
2016,1,11,19,99,112,211
2016,1,11,20,80,90,170
2016,1,11,21,60,75,135
2016,1,11,22,24,38,62
2016,1,11,23,18,24,42
2016,1,12,0,14,15,29
2016,1,12,1,13,14,27
2016,1,12,2,6,9,15
2016,1,12,3,1,8,9
2016,1,12,4,18,17,35
2016,1,12,5,125,71,196
2016,1,12,6,268,176,444
2016,1,12,7,336,213,549
2016,1,12,8,225,169,394
2016,1,12,9,196,158,354
2016,1,12,10,159,129,288
2016,1,12,11,198,191,389
2016,1,12,12,174,190,364
2016,1,12,13,228,248,476
2016,1,12,14,290,299,589
2016,1,12,15,232,277,509
2016,1,12,16,153,188,341
2016,1,12,17,147,138,285
2016,1,12,18,137,133,270
2016,1,12,19,102,106,208
2016,1,12,20,69,98,167
2016,1,12,21,65,91,156
2016,1,12,22,32,45,77
2016,1,12,23,13,16,29
2016,1,13,0,11,14,25
2016,1,13,1,8,9,17
2016,1,13,2,8,19,27
2016,1,13,3,7,12,19
2016,1,13,4,16,16,32
2016,1,13,5,132,75,207
2016,1,13,6,254,202,456
2016,1,13,7,434,239,673
2016,1,13,8,255,150,405
2016,1,13,9,229,180,409
2016,1,13,10,233,186,419
2016,1,13,11,187,194,381
2016,1,13,12,211,219,430
2016,1,13,13,198,241,439
2016,1,13,14,329,364,693
2016,1,13,15,259,326,585
2016,1,13,16,183,201,384
2016,1,13,17,141,136,277
2016,1,13,18,142,131,273
2016,1,13,19,114,123,237
2016,1,13,20,94,113,207
2016,1,13,21,55,81,136
2016,1,13,22,42,52,94
2016,1,13,23,23,25,48
2016,1,14,0,10,20,30
2016,1,14,1,7,14,21
2016,1,14,2,11,9,20
2016,1,14,3,5,18,23
2016,1,14,4,16,13,29
2016,1,14,5,120,68,188
2016,1,14,6,276,192,468
2016,1,14,7,395,217,612
2016,1,14,8,253,159,412
2016,1,14,9,213,171,384
2016,1,14,10,200,179,379
2016,1,14,11,204,166,370
2016,1,14,12,223,237,460
2016,1,14,13,236,237,473
2016,1,14,14,344,335,679
2016,1,14,15,254,303,557
2016,1,14,16,169,189,358
2016,1,14,17,197,189,386
2016,1,14,18,150,144,294
2016,1,14,19,109,115,224
2016,1,14,20,84,116,200
2016,1,14,21,54,103,157
2016,1,14,22,39,50,89
2016,1,14,23,24,28,52
2016,1,15,0,16,19,35
2016,1,15,1,17,31,48
2016,1,15,2,23,28,51
2016,1,15,3,9,28,37
2016,1,15,4,20,17,37
2016,1,15,5,131,63,194
2016,1,15,6,275,182,457
2016,1,15,7,424,213,637
2016,1,15,8,274,150,424
2016,1,15,9,216,195,411
2016,1,15,10,226,192,418
2016,1,15,11,248,188,436
2016,1,15,12,251,265,516
2016,1,15,13,287,286,573
2016,1,15,14,280,247,527
2016,1,15,15,250,251,501
2016,1,15,16,148,327,475
2016,1,15,17,145,323,468
2016,1,15,18,101,144,245
2016,1,15,19,88,105,193
2016,1,15,20,63,85,148
2016,1,15,21,63,71,134
2016,1,15,22,56,64,120
2016,1,15,23,40,51,91
2016,1,16,0,24,44,68
2016,1,16,1,24,50,74
2016,1,16,2,19,39,58
2016,1,16,3,15,46,61
2016,1,16,4,14,10,24
2016,1,16,5,27,19,46
2016,1,16,6,46,36,82
2016,1,16,7,33,26,59
2016,1,16,8,46,42,88
2016,1,16,9,71,62,133
2016,1,16,10,99,70,169
2016,1,16,11,116,123,239
2016,1,16,12,131,119,250
2016,1,16,13,119,138,257
2016,1,16,14,129,109,238
2016,1,16,15,111,118,229
2016,1,16,16,113,124,237
2016,1,16,17,116,99,215
2016,1,16,18,112,106,218
2016,1,16,19,87,75,162
2016,1,16,20,64,67,131
2016,1,16,21,47,52,99
2016,1,16,22,51,62,113
2016,1,16,23,41,54,95
2016,1,17,0,35,50,85
2016,1,17,1,29,52,81
2016,1,17,2,29,51,80
2016,1,17,3,21,36,57
2016,1,17,4,15,23,38
2016,1,17,5,17,15,32
2016,1,17,6,18,11,29
2016,1,17,7,30,29,59
2016,1,17,8,42,36,78
2016,1,17,9,68,47,115
2016,1,17,10,76,52,128
2016,1,17,11,92,113,205
2016,1,17,12,125,92,217
2016,1,17,13,162,140,302
2016,1,17,14,146,131,277
2016,1,17,15,138,165,303
2016,1,17,16,140,139,279
2016,1,17,17,98,104,202
2016,1,17,18,132,112,244
2016,1,17,19,110,101,211
2016,1,17,20,69,92,161
2016,1,17,21,65,52,117
2016,1,17,22,50,43,93
2016,1,17,23,16,19,35
2016,1,18,0,13,15,28
2016,1,18,1,6,14,20
2016,1,18,2,10,9,19
2016,1,18,3,8,7,15
2016,1,18,4,17,15,32
2016,1,18,5,130,56,186
2016,1,18,6,269,173,442
2016,1,18,7,373,165,538
2016,1,18,8,259,183,442
2016,1,18,9,194,164,358
2016,1,18,10,204,160,364
2016,1,18,11,209,148,357
2016,1,18,12,208,206,414
2016,1,18,13,187,240,427
2016,1,18,14,297,294,591
2016,1,18,15,225,293,518
2016,1,18,16,145,168,313
2016,1,18,17,146,120,266
2016,1,18,18,123,122,245
2016,1,18,19,102,101,203
2016,1,18,20,83,105,188
2016,1,18,21,53,219,272
2016,1,18,22,27,162,189
2016,1,18,23,19,40,59
2016,1,19,0,25,20,45
2016,1,19,1,9,9,18
2016,1,19,2,13,11,24
2016,1,19,3,12,9,21
2016,1,19,4,26,22,48
2016,1,19,5,114,67,181
2016,1,19,6,248,184,432
2016,1,19,7,391,172,563
2016,1,19,8,249,162,411
2016,1,19,9,213,137,350
2016,1,19,10,221,160,381
2016,1,19,11,213,177,390
2016,1,19,12,210,189,399
2016,1,19,13,213,244,457
2016,1,19,14,285,348,633
2016,1,19,15,246,278,524
2016,1,19,16,173,165,338
2016,1,19,17,191,159,350
2016,1,19,18,156,133,289
2016,1,19,19,99,109,208
2016,1,19,20,90,88,178
2016,1,19,21,57,82,139
2016,1,19,22,44,40,84
2016,1,19,23,17,29,46
2016,1,20,0,12,23,35
2016,1,20,1,13,17,30
2016,1,20,2,25,23,48
2016,1,20,3,7,13,20
2016,1,20,4,17,20,37
2016,1,20,5,116,68,184
2016,1,20,6,276,183,459
2016,1,20,7,390,211,601
2016,1,20,8,243,151,394
2016,1,20,9,219,162,381
2016,1,20,10,224,159,383
2016,1,20,11,195,191,386
2016,1,20,12,193,173,366
2016,1,20,13,230,276,506
2016,1,20,14,307,321,628
2016,1,20,15,209,311,520
2016,1,20,16,202,213,415
2016,1,20,17,178,126,304
2016,1,20,18,154,134,288
2016,1,20,19,102,114,216
2016,1,20,20,58,81,139
2016,1,20,21,57,58,115
2016,1,20,22,45,43,88
2016,1,20,23,16,33,49
2016,1,21,0,14,17,31
2016,1,21,1,8,16,24
2016,1,21,2,9,16,25
2016,1,21,3,11,9,20
2016,1,21,4,19,13,32
2016,1,21,5,121,66,187
2016,1,21,6,255,173,428
2016,1,21,7,422,192,614
2016,1,21,8,260,155,415
2016,1,21,9,218,157,375
2016,1,21,10,173,144,317
2016,1,21,11,146,144,290
2016,1,21,12,218,181,399
2016,1,21,13,203,240,443
2016,1,21,14,309,328,637
2016,1,21,15,264,301,565
2016,1,21,16,188,180,368
2016,1,21,17,163,169,332
2016,1,21,18,168,159,327
2016,1,21,19,103,116,219
2016,1,21,20,82,113,195
2016,1,21,21,83,62,145
2016,1,21,22,38,45,83
2016,1,21,23,25,31,56
2016,1,22,0,14,22,36
2016,1,22,1,13,27,40
2016,1,22,2,16,19,35
2016,1,22,3,12,13,25
2016,1,22,4,16,11,27
2016,1,22,5,128,69,197
2016,1,22,6,247,172,419
2016,1,22,7,377,208,585
2016,1,22,8,238,157,395
2016,1,22,9,217,180,397
2016,1,22,10,233,178,411
2016,1,22,11,214,230,444
2016,1,22,12,231,244,475
2016,1,22,13,271,308,579
2016,1,22,14,332,356,688
2016,1,22,15,226,291,517
2016,1,22,16,155,170,325
2016,1,22,17,176,139,315
2016,1,22,18,124,121,245
2016,1,22,19,95,89,184
2016,1,22,20,68,84,152
2016,1,22,21,48,63,111
2016,1,22,22,46,68,114
2016,1,22,23,30,61,91
2016,1,23,0,32,47,79
2016,1,23,1,23,41,64
2016,1,23,2,14,48,62
2016,1,23,3,14,39,53
2016,1,23,4,14,9,23
2016,1,23,5,31,17,48
2016,1,23,6,35,18,53
2016,1,23,7,39,25,64
2016,1,23,8,66,40,106
2016,1,23,9,87,67,154
2016,1,23,10,143,113,256
2016,1,23,11,164,126,290
2016,1,23,12,152,159,311
2016,1,23,13,180,148,328
2016,1,23,14,140,189,329
2016,1,23,15,144,163,307
2016,1,23,16,120,130,250
2016,1,23,17,120,127,247
2016,1,23,18,106,118,224
2016,1,23,19,82,78,160
2016,1,23,20,61,99,160
2016,1,23,21,60,52,112
2016,1,23,22,49,48,97
2016,1,23,23,42,88,130
2016,1,24,0,32,64,96
2016,1,24,1,33,61,94
2016,1,24,2,44,74,118
2016,1,24,3,24,36,60
2016,1,24,4,16,25,41
2016,1,24,5,30,14,44
2016,1,24,6,11,14,25
2016,1,24,7,27,15,42
2016,1,24,8,36,30,66
2016,1,24,9,90,46,136
2016,1,24,10,101,78,179
2016,1,24,11,128,108,236
2016,1,24,12,145,158,303
2016,1,24,13,181,197,378
2016,1,24,14,145,188,333
2016,1,24,15,163,212,375
2016,1,24,16,141,132,273
2016,1,24,17,139,126,265
2016,1,24,18,169,133,302
2016,1,24,19,101,154,255
2016,1,24,20,74,95,169
2016,1,24,21,61,86,147
2016,1,24,22,33,44,77
2016,1,24,23,14,18,32
2016,1,25,0,7,17,24
2016,1,25,1,5,12,17
2016,1,25,2,8,11,19
2016,1,25,3,8,11,19
2016,1,25,4,17,19,36
2016,1,25,5,123,61,184
2016,1,25,6,270,181,451
2016,1,25,7,380,219,599
2016,1,25,8,276,149,425
2016,1,25,9,225,175,400
2016,1,25,10,232,195,427
2016,1,25,11,218,190,408
2016,1,25,12,220,200,420
2016,1,25,13,206,283,489
2016,1,25,14,298,363,661
2016,1,25,15,235,297,532
2016,1,25,16,212,201,413
2016,1,25,17,195,154,349
2016,1,25,18,144,159,303
2016,1,25,19,106,122,228
2016,1,25,20,85,129,214
2016,1,25,21,68,78,146
2016,1,25,22,31,49,80
2016,1,25,23,17,42,59
2016,1,26,0,7,21,28
2016,1,26,1,4,6,10
2016,1,26,2,8,11,19
2016,1,26,3,4,3,7
2016,1,26,4,19,16,35
2016,1,26,5,126,60,186
2016,1,26,6,293,198,491
2016,1,26,7,415,216,631
2016,1,26,8,246,173,419
2016,1,26,9,210,171,381
2016,1,26,10,241,192,433
2016,1,26,11,229,219,448
2016,1,26,12,222,226,448
2016,1,26,13,268,273,541
2016,1,26,14,325,361,686
2016,1,26,15,263,309,572
2016,1,26,16,181,197,378
2016,1,26,17,192,173,365
2016,1,26,18,135,150,285
2016,1,26,19,134,128,262
2016,1,26,20,77,101,178
2016,1,26,21,63,85,148
2016,1,26,22,33,41,74
2016,1,26,23,16,23,39
2016,1,27,0,8,25,33
2016,1,27,1,9,16,25
2016,1,27,2,15,24,39
2016,1,27,3,4,10,14
2016,1,27,4,9,17,26
2016,1,27,5,141,79,220
2016,1,27,6,283,214,497
2016,1,27,7,438,212,650
2016,1,27,8,260,143,403
2016,1,27,9,249,179,428
2016,1,27,10,232,196,428
2016,1,27,11,225,224,449
2016,1,27,12,224,199,423
2016,1,27,13,230,250,480
2016,1,27,14,324,367,691
2016,1,27,15,254,278,532
2016,1,27,16,234,199,433
2016,1,27,17,175,166,341
2016,1,27,18,142,151,293
2016,1,27,19,110,124,234
2016,1,27,20,82,114,196
2016,1,27,21,36,89,125
2016,1,27,22,25,46,71
2016,1,27,23,11,31,42
2016,1,28,0,6,22,28
2016,1,28,1,7,21,28
2016,1,28,2,11,16,27
2016,1,28,3,4,11,15
2016,1,28,4,16,20,36
2016,1,28,5,134,64,198
2016,1,28,6,289,195,484
2016,1,28,7,467,218,685
2016,1,28,8,253,179,432
2016,1,28,9,232,188,420
2016,1,28,10,218,201,419
2016,1,28,11,252,203,455
2016,1,28,12,191,192,383
2016,1,28,13,236,294,530
2016,1,28,14,315,355,670
2016,1,28,15,250,297,547
2016,1,28,16,204,230,434
2016,1,28,17,179,169,348
2016,1,28,18,158,177,335
2016,1,28,19,124,129,253
2016,1,28,20,88,107,195
2016,1,28,21,69,82,151
2016,1,28,22,40,53,93
2016,1,28,23,19,32,51
2016,1,29,0,10,29,39
2016,1,29,1,11,29,40
2016,1,29,2,19,21,40
2016,1,29,3,7,16,23
2016,1,29,4,18,20,38
2016,1,29,5,132,69,201
2016,1,29,6,274,171,445
2016,1,29,7,453,249,702
2016,1,29,8,245,166,411
2016,1,29,9,249,217,466
2016,1,29,10,275,278,553
2016,1,29,11,287,342,629
2016,1,29,12,233,278,511
2016,1,29,13,228,239,467
2016,1,29,14,205,225,430
2016,1,29,15,156,184,340
2016,1,29,16,159,154,313
2016,1,29,17,114,116,230
2016,1,29,18,98,89,187
2016,1,29,19,73,74,147
2016,1,29,20,68,67,135
2016,1,29,21,60,85,145
2016,1,29,22,50,66,116
2016,1,29,23,36,58,94
2016,1,30,0,35,38,73
2016,1,30,1,18,44,62
2016,1,30,2,24,44,68
2016,1,30,3,13,28,41
2016,1,30,4,13,16,29
2016,1,30,5,29,12,41
2016,1,30,6,30,19,49
2016,1,30,7,47,38,85
2016,1,30,8,54,32,86
2016,1,30,9,103,80,183
2016,1,30,10,146,106,252
2016,1,30,11,162,143,305
2016,1,30,12,176,164,340
2016,1,30,13,158,188,346
2016,1,30,14,155,186,341
2016,1,30,15,159,163,322
2016,1,30,16,150,165,315
2016,1,30,17,132,122,254
2016,1,30,18,112,103,215
2016,1,30,19,88,114,202
2016,1,30,20,66,69,135
2016,1,30,21,67,67,134
2016,1,30,22,53,73,126
2016,1,30,23,40,71,111
2016,1,31,0,31,57,88
2016,1,31,1,40,65,105
2016,1,31,2,34,91,125
2016,1,31,3,18,40,58
2016,1,31,4,19,27,46
2016,1,31,5,17,16,33
2016,1,31,6,26,20,46
2016,1,31,7,29,21,50
2016,1,31,8,35,34,69
2016,1,31,9,79,50,129
2016,1,31,10,104,72,176
2016,1,31,11,125,103,228
2016,1,31,12,121,130,251
2016,1,31,13,177,169,346
2016,1,31,14,120,163,283
2016,1,31,15,145,205,350
2016,1,31,16,149,161,310
2016,1,31,17,130,130,260
2016,1,31,18,124,138,262
2016,1,31,19,109,126,235
2016,1,31,20,73,83,156
2016,1,31,21,38,190,228
2016,1,31,22,43,122,165
2016,1,31,23,25,31,56
2016,2,1,0,15,14,29
2016,2,1,1,12,4,16
2016,2,1,2,5,9,14
2016,2,1,3,7,13,20
2016,2,1,4,19,16,35
2016,2,1,5,137,72,209
2016,2,1,6,242,179,421
2016,2,1,7,355,184,539
2016,2,1,8,273,168,441
2016,2,1,9,197,178,375
2016,2,1,10,234,173,407
2016,2,1,11,143,136,279
2016,2,1,12,215,209,424
2016,2,1,13,217,237,454
2016,2,1,14,256,323,579
2016,2,1,15,226,282,508
2016,2,1,16,197,185,382
2016,2,1,17,155,126,281
2016,2,1,18,143,144,287
2016,2,1,19,110,120,230
2016,2,1,20,64,107,171
2016,2,1,21,60,80,140
2016,2,1,22,35,42,77
2016,2,1,23,19,12,31
2016,2,2,0,7,17,24
2016,2,2,1,7,8,15
2016,2,2,2,6,8,14
2016,2,2,3,8,10,18
2016,2,2,4,19,13,32
2016,2,2,5,138,79,217
2016,2,2,6,236,187,423
2016,2,2,7,364,188,552
2016,2,2,8,286,176,462
2016,2,2,9,231,168,399
2016,2,2,10,256,206,462
2016,2,2,11,218,191,409
2016,2,2,12,204,203,407
2016,2,2,13,212,274,486
2016,2,2,14,234,336,570
2016,2,2,15,227,286,513
2016,2,2,16,228,188,416
2016,2,2,17,184,186,370
2016,2,2,18,137,162,299
2016,2,2,19,112,132,244
2016,2,2,20,96,95,191
2016,2,2,21,72,86,158
2016,2,2,22,33,30,63
2016,2,2,23,18,19,37
2016,2,3,0,7,21,28
2016,2,3,1,8,13,21
2016,2,3,2,11,15,26
2016,2,3,3,12,13,25
2016,2,3,4,9,23,32
2016,2,3,5,124,71,195
2016,2,3,6,231,164,395
2016,2,3,7,341,201,542
2016,2,3,8,264,170,434
2016,2,3,9,221,149,370
2016,2,3,10,214,184,398
2016,2,3,11,192,185,377
2016,2,3,12,251,227,478
2016,2,3,13,223,252,475
2016,2,3,14,265,324,589
2016,2,3,15,233,266,499
2016,2,3,16,213,181,394
2016,2,3,17,184,144,328
2016,2,3,18,145,150,295
2016,2,3,19,96,127,223
2016,2,3,20,73,105,178
2016,2,3,21,65,82,147
2016,2,3,22,33,49,82
2016,2,3,23,25,26,51
2016,2,4,0,17,27,44
2016,2,4,1,13,19,32
2016,2,4,2,12,13,25
2016,2,4,3,3,6,9
2016,2,4,4,19,17,36
2016,2,4,5,103,61,164
2016,2,4,6,218,172,390
2016,2,4,7,338,168,506
2016,2,4,8,258,156,414
2016,2,4,9,206,170,376
2016,2,4,10,203,167,370
2016,2,4,11,190,176,366
2016,2,4,12,210,196,406
2016,2,4,13,210,241,451
2016,2,4,14,239,351,590
2016,2,4,15,202,256,458
2016,2,4,16,194,210,404
2016,2,4,17,173,133,306
2016,2,4,18,226,155,381
2016,2,4,19,114,117,231
2016,2,4,20,89,110,199
2016,2,4,21,72,69,141
2016,2,4,22,42,41,83
2016,2,4,23,20,43,63
2016,2,5,0,18,40,58
2016,2,5,1,14,31,45
2016,2,5,2,16,24,40
2016,2,5,3,14,15,29
2016,2,5,4,23,17,40
2016,2,5,5,138,73,211
2016,2,5,6,224,177,401
2016,2,5,7,250,173,423
2016,2,5,8,236,154,390
2016,2,5,9,220,166,386
2016,2,5,10,262,208,470
2016,2,5,11,235,230,465
2016,2,5,12,230,196,426
2016,2,5,13,204,268,472
2016,2,5,14,272,327,599
2016,2,5,15,205,259,464
2016,2,5,16,142,186,328
2016,2,5,17,139,123,262
2016,2,5,18,113,125,238
2016,2,5,19,87,86,173
2016,2,5,20,71,87,158
2016,2,5,21,54,65,119
2016,2,5,22,36,53,89
2016,2,5,23,43,46,89
2016,2,6,0,17,42,59
2016,2,6,1,19,38,57
2016,2,6,2,22,36,58
2016,2,6,3,19,33,52
2016,2,6,4,9,9,18
2016,2,6,5,29,17,46
2016,2,6,6,29,23,52
2016,2,6,7,30,36,66
2016,2,6,8,109,65,174
2016,2,6,9,106,69,175
2016,2,6,10,139,110,249
2016,2,6,11,171,140,311
2016,2,6,12,179,151,330
2016,2,6,13,153,161,314
2016,2,6,14,151,210,361
2016,2,6,15,123,157,280
2016,2,6,16,138,160,298
2016,2,6,17,143,101,244
2016,2,6,18,112,91,203
2016,2,6,19,74,97,171
2016,2,6,20,70,84,154
2016,2,6,21,58,57,115
2016,2,6,22,37,75,112
2016,2,6,23,40,63,103
2016,2,7,0,34,52,86
2016,2,7,1,42,62,104
2016,2,7,2,31,69,100
2016,2,7,3,17,49,66
2016,2,7,4,23,24,47
2016,2,7,5,20,20,40
2016,2,7,6,28,18,46
2016,2,7,7,24,19,43
2016,2,7,8,36,25,61
2016,2,7,9,90,50,140
2016,2,7,10,107,75,182
2016,2,7,11,102,108,210
2016,2,7,12,136,166,302
2016,2,7,13,181,171,352
2016,2,7,14,160,185,345
2016,2,7,15,177,234,411
2016,2,7,16,163,167,330
2016,2,7,17,142,145,287
2016,2,7,18,157,146,303
2016,2,7,19,98,137,235
2016,2,7,20,68,97,165
2016,2,7,21,61,61,122
2016,2,7,22,39,50,89
2016,2,7,23,23,33,56
2016,2,8,0,10,19,29
2016,2,8,1,7,7,14
2016,2,8,2,12,5,17
2016,2,8,3,6,11,17
2016,2,8,4,15,15,30
2016,2,8,5,131,76,207
2016,2,8,6,257,186,443
2016,2,8,7,384,197,581
2016,2,8,8,275,141,416
2016,2,8,9,201,187,388
2016,2,8,10,215,178,393
2016,2,8,11,215,188,403
2016,2,8,12,194,218,412
2016,2,8,13,216,267,483
2016,2,8,14,243,332,575
2016,2,8,15,243,296,539
2016,2,8,16,204,166,370
2016,2,8,17,201,153,354
2016,2,8,18,127,154,281
2016,2,8,19,128,131,259
2016,2,8,20,76,101,177
2016,2,8,21,85,96,181
2016,2,8,22,33,36,69
2016,2,8,23,28,22,50
2016,2,9,0,15,11,26
2016,2,9,1,5,7,12
2016,2,9,2,12,8,20
2016,2,9,3,4,4,8
2016,2,9,4,12,14,26
2016,2,9,5,139,78,217
2016,2,9,6,275,186,461
2016,2,9,7,357,231,588
2016,2,9,8,275,159,434
2016,2,9,9,229,218,447
2016,2,9,10,233,181,414
2016,2,9,11,217,205,422
2016,2,9,12,179,218,397
2016,2,9,13,245,251,496
2016,2,9,14,260,312,572
2016,2,9,15,233,270,503
2016,2,9,16,194,209,403
2016,2,9,17,183,157,340
2016,2,9,18,160,156,316
2016,2,9,19,112,122,234
2016,2,9,20,94,147,241
2016,2,9,21,66,66,132
2016,2,9,22,37,50,87
2016,2,9,23,14,22,36
2016,2,10,0,10,20,30
2016,2,10,1,7,11,18
2016,2,10,2,14,18,32
2016,2,10,3,10,9,19
2016,2,10,4,14,21,35
2016,2,10,5,128,62,190
2016,2,10,6,243,165,408
2016,2,10,7,351,203,554
2016,2,10,8,260,165,425
2016,2,10,9,226,163,389
2016,2,10,10,212,180,392
2016,2,10,11,210,204,414
2016,2,10,12,223,187,410
2016,2,10,13,219,238,457
2016,2,10,14,229,297,526
2016,2,10,15,217,266,483
2016,2,10,16,232,190,422
2016,2,10,17,190,186,376
2016,2,10,18,129,157,286
2016,2,10,19,123,164,287
2016,2,10,20,84,122,206
2016,2,10,21,61,84,145
2016,2,10,22,38,42,80
2016,2,10,23,25,25,50
2016,2,11,0,15,21,36
2016,2,11,1,5,24,29
2016,2,11,2,11,14,25
2016,2,11,3,9,5,14
2016,2,11,4,18,11,29
2016,2,11,5,110,67,177
2016,2,11,6,231,171,402
2016,2,11,7,374,182,556
2016,2,11,8,250,147,397
2016,2,11,9,217,150,367
2016,2,11,10,183,154,337
2016,2,11,11,222,206,428
2016,2,11,12,208,215,423
2016,2,11,13,212,250,462
2016,2,11,14,248,334,582
2016,2,11,15,222,280,502
2016,2,11,16,195,203,398
2016,2,11,17,192,155,347
2016,2,11,18,168,178,346
2016,2,11,19,100,125,225
2016,2,11,20,93,121,214
2016,2,11,21,78,84,162
2016,2,11,22,46,44,90
2016,2,11,23,20,30,50
2016,2,12,0,17,27,44
2016,2,12,1,11,19,30
2016,2,12,2,12,26,38
2016,2,12,3,5,15,20
2016,2,12,4,18,21,39
2016,2,12,5,127,71,198
2016,2,12,6,259,182,441
2016,2,12,7,377,204,581
2016,2,12,8,273,179,452
2016,2,12,9,247,190,437
2016,2,12,10,210,186,396
2016,2,12,11,253,201,454
2016,2,12,12,219,248,467
2016,2,12,13,272,291,563
2016,2,12,14,262,355,617
2016,2,12,15,203,265,468
2016,2,12,16,178,177,355
2016,2,12,17,171,154,325
2016,2,12,18,127,140,267
2016,2,12,19,118,101,219
2016,2,12,20,77,106,183
2016,2,12,21,71,68,139
2016,2,12,22,52,66,118
2016,2,12,23,43,54,97
2016,2,13,0,39,49,88
2016,2,13,1,28,40,68
2016,2,13,2,32,58,90
2016,2,13,3,19,31,50
2016,2,13,4,8,16,24
2016,2,13,5,25,14,39
2016,2,13,6,30,30,60
2016,2,13,7,71,43,114
2016,2,13,8,62,53,115
2016,2,13,9,98,75,173
2016,2,13,10,120,107,227
2016,2,13,11,162,127,289
2016,2,13,12,158,136,294
2016,2,13,13,130,161,291
2016,2,13,14,151,142,293
2016,2,13,15,144,176,320
2016,2,13,16,122,149,271
2016,2,13,17,135,152,287
2016,2,13,18,97,110,207
2016,2,13,19,86,93,179
2016,2,13,20,61,81,142
2016,2,13,21,56,69,125
2016,2,13,22,55,66,121
2016,2,13,23,33,35,68
2016,2,14,0,30,28,58
2016,2,14,1,27,37,64
2016,2,14,2,34,67,101
2016,2,14,3,28,41,69
2016,2,14,4,21,24,45
2016,2,14,5,13,14,27
2016,2,14,6,23,15,38
2016,2,14,7,41,24,65
2016,2,14,8,53,48,101
2016,2,14,9,89,53,142
2016,2,14,10,98,83,181
2016,2,14,11,143,123,266
2016,2,14,12,149,161,310
2016,2,14,13,193,157,350
2016,2,14,14,174,179,353
2016,2,14,15,159,183,342
2016,2,14,16,144,179,323
2016,2,14,17,156,153,309
2016,2,14,18,161,136,297
2016,2,14,19,124,157,281
2016,2,14,20,108,93,201
2016,2,14,21,53,64,117
2016,2,14,22,39,49,88
2016,2,14,23,10,20,30
2016,2,15,0,12,18,30
2016,2,15,1,7,3,10
2016,2,15,2,9,7,16
2016,2,15,3,6,11,17
2016,2,15,4,15,16,31
2016,2,15,5,137,88,225
2016,2,15,6,253,181,434
2016,2,15,7,345,215,560
2016,2,15,8,270,166,436
2016,2,15,9,231,186,417
2016,2,15,10,234,182,416
2016,2,15,11,229,202,431
2016,2,15,12,210,212,422
2016,2,15,13,216,259,475
2016,2,15,14,257,343,600
2016,2,15,15,206,280,486
2016,2,15,16,200,207,407
2016,2,15,17,197,167,364
2016,2,15,18,156,152,308
2016,2,15,19,106,116,222
2016,2,15,20,79,117,196
2016,2,15,21,66,83,149
2016,2,15,22,37,48,85
2016,2,15,23,20,12,32
2016,2,16,0,5,8,13
2016,2,16,1,9,8,17
2016,2,16,2,9,13,22
2016,2,16,3,5,4,9
2016,2,16,4,17,12,29
2016,2,16,5,145,71,216
2016,2,16,6,260,176,436
2016,2,16,7,357,214,571
2016,2,16,8,244,167,411
2016,2,16,9,257,188,445
2016,2,16,10,254,183,437
2016,2,16,11,235,205,440
2016,2,16,12,220,222,442
2016,2,16,13,209,259,468
2016,2,16,14,244,347,591
2016,2,16,15,238,304,542
2016,2,16,16,222,188,410
2016,2,16,17,209,159,368
2016,2,16,18,148,144,292
2016,2,16,19,132,140,272
2016,2,16,20,82,128,210
2016,2,16,21,67,99,166
2016,2,16,22,38,46,84
2016,2,16,23,16,24,40
2016,2,17,0,11,26,37
2016,2,17,1,9,20,29
2016,2,17,2,7,14,21
2016,2,17,3,6,7,13
2016,2,17,4,14,15,29
2016,2,17,5,145,78,223
2016,2,17,6,271,180,451
2016,2,17,7,358,203,561
2016,2,17,8,277,180,457
2016,2,17,9,244,171,415
2016,2,17,10,235,175,410
2016,2,17,11,199,180,379
2016,2,17,12,214,202,416
2016,2,17,13,235,301,536
2016,2,17,14,265,329,594
2016,2,17,15,250,289,539
2016,2,17,16,239,205,444
2016,2,17,17,180,153,333
2016,2,17,18,181,169,350
2016,2,17,19,140,127,267
2016,2,17,20,89,154,243
2016,2,17,21,59,111,170
2016,2,17,22,41,45,86
2016,2,17,23,13,16,29
2016,2,18,0,15,23,38
2016,2,18,1,9,19,28
2016,2,18,2,9,18,27
2016,2,18,3,10,14,24
2016,2,18,4,17,13,30
2016,2,18,5,129,69,198
2016,2,18,6,240,174,414
2016,2,18,7,358,183,541
2016,2,18,8,263,160,423
2016,2,18,9,228,157,385
2016,2,18,10,221,170,391
2016,2,18,11,199,218,417
2016,2,18,12,221,237,458
2016,2,18,13,215,269,484
2016,2,18,14,272,346,618
2016,2,18,15,219,308,527
2016,2,18,16,201,207,408
2016,2,18,17,204,155,359
2016,2,18,18,168,151,319
2016,2,18,19,113,125,238
2016,2,18,20,102,122,224
2016,2,18,21,72,77,149
2016,2,18,22,55,59,114
2016,2,18,23,26,30,56
2016,2,19,0,13,30,43
2016,2,19,1,13,25,38
2016,2,19,2,25,35,60
2016,2,19,3,12,18,30
2016,2,19,4,20,16,36
2016,2,19,5,141,64,205
2016,2,19,6,253,180,433
2016,2,19,7,374,200,574
2016,2,19,8,252,156,408
2016,2,19,9,220,175,395
2016,2,19,10,230,198,428
2016,2,19,11,243,216,459
2016,2,19,12,252,230,482
2016,2,19,13,251,296,547
2016,2,19,14,311,355,666
2016,2,19,15,221,285,506
2016,2,19,16,172,207,379
2016,2,19,17,150,163,313
2016,2,19,18,135,158,293
2016,2,19,19,99,104,203
2016,2,19,20,57,102,159
2016,2,19,21,60,67,127
2016,2,19,22,47,58,105
2016,2,19,23,48,61,109
2016,2,20,0,33,58,91
2016,2,20,1,33,57,90
2016,2,20,2,29,48,77
2016,2,20,3,23,37,60
2016,2,20,4,16,16,32
2016,2,20,5,25,21,46
2016,2,20,6,27,27,54
2016,2,20,7,58,36,94
2016,2,20,8,70,55,125
2016,2,20,9,110,79,189
2016,2,20,10,151,111,262
2016,2,20,11,165,136,301
2016,2,20,12,204,175,379
2016,2,20,13,151,173,324
2016,2,20,14,171,189,360
2016,2,20,15,143,198,341
2016,2,20,16,138,160,298
2016,2,20,17,156,156,312
2016,2,20,18,136,151,287
2016,2,20,19,94,110,204
2016,2,20,20,70,72,142
2016,2,20,21,50,65,115
2016,2,20,22,55,65,120
2016,2,20,23,57,73,130
2016,2,21,0,46,72,118
2016,2,21,1,24,41,65
2016,2,21,2,39,56,95
2016,2,21,3,19,44,63
2016,2,21,4,23,19,42
2016,2,21,5,23,18,41
2016,2,21,6,22,13,35
2016,2,21,7,31,27,58
2016,2,21,8,32,37,69
2016,2,21,9,106,51,157
2016,2,21,10,117,80,197
2016,2,21,11,150,127,277
2016,2,21,12,157,158,315
2016,2,21,13,167,183,350
2016,2,21,14,194,207,401
2016,2,21,15,155,219,374
2016,2,21,16,146,160,306
2016,2,21,17,169,152,321
2016,2,21,18,140,133,273
2016,2,21,19,104,142,246
2016,2,21,20,67,89,156
2016,2,21,21,65,68,133
2016,2,21,22,46,38,84
2016,2,21,23,22,24,46
2016,2,22,0,10,13,23
2016,2,22,1,9,11,20
2016,2,22,2,8,11,19
2016,2,22,3,10,9,19
2016,2,22,4,12,8,20
2016,2,22,5,122,73,195
2016,2,22,6,261,173,434
2016,2,22,7,575,240,815
2016,2,22,8,636,213,849
2016,2,22,9,607,172,779
2016,2,22,10,276,159,435
2016,2,22,11,236,166,402
2016,2,22,12,221,215,436
2016,2,22,13,191,259,450
2016,2,22,14,239,316,555
2016,2,22,15,238,297,535
2016,2,22,16,195,201,396
2016,2,22,17,178,133,311
2016,2,22,18,155,147,302
2016,2,22,19,134,147,281
2016,2,22,20,99,105,204
2016,2,22,21,72,51,123
2016,2,22,22,38,24,62
2016,2,22,23,14,9,23
2016,2,23,0,9,7,16
2016,2,23,1,5,3,8
2016,2,23,2,8,5,13
2016,2,23,3,8,6,14
2016,2,23,4,24,19,43
2016,2,23,5,130,77,207
2016,2,23,6,286,176,462
2016,2,23,7,375,212,587
2016,2,23,8,273,173,446
2016,2,23,9,220,192,412
2016,2,23,10,243,179,422
2016,2,23,11,212,189,401
2016,2,23,12,206,207,413
2016,2,23,13,219,263,482
2016,2,23,14,260,351,611
2016,2,23,15,241,319,560
2016,2,23,16,216,181,397
2016,2,23,17,176,174,350
2016,2,23,18,143,141,284
2016,2,23,19,104,108,212
2016,2,23,20,103,101,204
2016,2,23,21,59,57,116
2016,2,23,22,38,27,65
2016,2,23,23,17,12,29
2016,2,24,0,11,10,21
2016,2,24,1,5,3,8
2016,2,24,2,11,15,26
2016,2,24,3,7,18,25
2016,2,24,4,19,6,25
2016,2,24,5,123,77,200
2016,2,24,6,260,185,445
2016,2,24,7,340,206,546
2016,2,24,8,241,140,381
2016,2,24,9,199,160,359
2016,2,24,10,214,156,370
2016,2,24,11,204,189,393
2016,2,24,12,189,196,385
2016,2,24,13,196,235,431
2016,2,24,14,236,330,566
2016,2,24,15,228,288,516
2016,2,24,16,199,171,370
2016,2,24,17,170,149,319
2016,2,24,18,154,143,297
2016,2,24,19,110,162,272
2016,2,24,20,67,107,174
2016,2,24,21,75,79,154
2016,2,24,22,43,41,84
2016,2,24,23,22,31,53
2016,2,25,0,18,41,59
2016,2,25,1,9,23,32
2016,2,25,2,14,29,43
2016,2,25,3,8,26,34
2016,2,25,4,17,16,33
2016,2,25,5,120,67,187
2016,2,25,6,238,163,401
2016,2,25,7,398,183,581
2016,2,25,8,242,157,399
2016,2,25,9,241,181,422
2016,2,25,10,228,184,412
2016,2,25,11,193,183,376
2016,2,25,12,200,190,390
2016,2,25,13,223,241,464
2016,2,25,14,271,359,630
2016,2,25,15,217,269,486
2016,2,25,16,212,203,415
2016,2,25,17,213,191,404
2016,2,25,18,150,142,292
2016,2,25,19,116,121,237
2016,2,25,20,92,118,210
2016,2,25,21,54,100,154
2016,2,25,22,37,54,91
2016,2,25,23,21,21,42
2016,2,26,0,7,25,32
2016,2,26,1,7,24,31
2016,2,26,2,19,27,46
2016,2,26,3,9,10,19
2016,2,26,4,20,17,37
2016,2,26,5,133,62,195
2016,2,26,6,242,168,410
2016,2,26,7,351,199,550
2016,2,26,8,247,157,404
2016,2,26,9,218,162,380
2016,2,26,10,212,186,398
2016,2,26,11,218,218,436
2016,2,26,12,226,258,484
2016,2,26,13,266,286,552
2016,2,26,14,269,336,605
2016,2,26,15,219,285,504
2016,2,26,16,170,187,357
2016,2,26,17,137,130,267
2016,2,26,18,135,126,261
2016,2,26,19,71,63,134
2016,2,26,20,61,74,135
2016,2,26,21,51,74,125
2016,2,26,22,57,52,109
2016,2,26,23,44,62,106
2016,2,27,0,26,40,66
2016,2,27,1,20,28,48
2016,2,27,2,21,29,50
2016,2,27,3,16,36,52
2016,2,27,4,15,21,36
2016,2,27,5,22,23,45
2016,2,27,6,33,26,59
2016,2,27,7,42,30,72
2016,2,27,8,52,44,96
2016,2,27,9,112,76,188
2016,2,27,10,132,109,241
2016,2,27,11,147,118,265
2016,2,27,12,156,160,316
2016,2,27,13,184,173,357
2016,2,27,14,138,162,300
2016,2,27,15,151,190,341
2016,2,27,16,138,206,344
2016,2,27,17,133,132,265
2016,2,27,18,99,126,225
2016,2,27,19,90,105,195
2016,2,27,20,69,69,138
2016,2,27,21,60,66,126
2016,2,27,22,55,63,118
2016,2,27,23,38,66,104
2016,2,28,0,31,66,97
2016,2,28,1,39,59,98
2016,2,28,2,31,65,96
2016,2,28,3,16,34,50
2016,2,28,4,13,11,24
2016,2,28,5,23,14,37
2016,2,28,6,20,14,34
2016,2,28,7,29,21,50
2016,2,28,8,36,47,83
2016,2,28,9,95,54,149
2016,2,28,10,116,77,193
2016,2,28,11,151,130,281
2016,2,28,12,164,157,321
2016,2,28,13,178,184,362
2016,2,28,14,157,197,354
2016,2,28,15,145,205,350
2016,2,28,16,149,167,316
2016,2,28,17,138,144,282
2016,2,28,18,145,150,295
2016,2,28,19,111,141,252
2016,2,28,20,72,72,144
2016,2,28,21,39,69,108
2016,2,28,22,43,47,90
2016,2,28,23,20,22,42
2016,2,29,0,11,15,26
2016,2,29,1,8,14,22
2016,2,29,2,4,11,15
2016,2,29,3,8,14,22
2016,2,29,4,15,14,29
2016,2,29,5,125,73,198
2016,2,29,6,265,170,435
2016,2,29,7,382,209,591
2016,2,29,8,252,145,397
2016,2,29,9,222,178,400
2016,2,29,10,194,174,368
2016,2,29,11,219,200,419
2016,2,29,12,213,212,425
2016,2,29,13,234,231,465
2016,2,29,14,264,356,620
2016,2,29,15,250,343,593
2016,2,29,16,198,209,407
2016,2,29,17,169,161,330
2016,2,29,18,129,152,281
2016,2,29,19,124,132,256
2016,2,29,20,79,109,188
2016,2,29,21,83,85,168
2016,2,29,22,34,37,71
2016,2,29,23,17,19,36
2016,3,1,0,14,12,26
2016,3,1,1,8,7,15
2016,3,1,2,8,9,17
2016,3,1,3,9,10,19
2016,3,1,4,16,11,27
2016,3,1,5,130,72,202
2016,3,1,6,261,176,437
2016,3,1,7,377,206,583
2016,3,1,8,266,186,452
2016,3,1,9,232,159,391
2016,3,1,10,229,187,416
2016,3,1,11,207,230,437
2016,3,1,12,202,228,430
2016,3,1,13,218,261,479
2016,3,1,14,254,332,586
2016,3,1,15,223,278,501
2016,3,1,16,215,213,428
2016,3,1,17,218,180,398
2016,3,1,18,146,160,306
2016,3,1,19,110,124,234
2016,3,1,20,124,121,245
2016,3,1,21,67,113,180
2016,3,1,22,40,30,70
2016,3,1,23,29,25,54
2016,3,2,0,11,20,31
2016,3,2,1,20,20,40
2016,3,2,2,11,15,26
2016,3,2,3,9,7,16
2016,3,2,4,18,15,33
2016,3,2,5,127,67,194
2016,3,2,6,253,167,420
2016,3,2,7,337,191,528
2016,3,2,8,278,178,456
2016,3,2,9,190,161,351
2016,3,2,10,206,192,398
2016,3,2,11,197,192,389
2016,3,2,12,210,193,403
2016,3,2,13,230,283,513
2016,3,2,14,252,305,557
2016,3,2,15,206,282,488
2016,3,2,16,210,209,419
2016,3,2,17,175,143,318
2016,3,2,18,149,149,298
2016,3,2,19,118,112,230
2016,3,2,20,60,84,144
2016,3,2,21,59,96,155
2016,3,2,22,40,34,74
2016,3,2,23,10,25,35
2016,3,3,0,8,12,20
2016,3,3,1,9,16,25
2016,3,3,2,6,11,17
2016,3,3,3,11,11,22
2016,3,3,4,21,17,38
2016,3,3,5,112,65,177
2016,3,3,6,264,169,433
2016,3,3,7,371,235,606
2016,3,3,8,284,172,456
2016,3,3,9,208,156,364
2016,3,3,10,215,165,380
2016,3,3,11,231,201,432
2016,3,3,12,217,225,442
2016,3,3,13,222,224,446
2016,3,3,14,239,335,574
2016,3,3,15,219,291,510
2016,3,3,16,203,206,409
2016,3,3,17,176,176,352
2016,3,3,18,165,167,332
2016,3,3,19,117,100,217
2016,3,3,20,84,114,198
2016,3,3,21,51,86,137
2016,3,3,22,43,53,96
2016,3,3,23,30,36,66
2016,3,4,0,12,26,38
2016,3,4,1,16,23,39
2016,3,4,2,11,26,37
2016,3,4,3,14,15,29
2016,3,4,4,18,11,29
2016,3,4,5,122,61,183
2016,3,4,6,250,169,419
2016,3,4,7,394,188,582
2016,3,4,8,240,147,387
2016,3,4,9,220,160,380
2016,3,4,10,239,210,449
2016,3,4,11,244,196,440
2016,3,4,12,228,230,458
2016,3,4,13,228,283,511
2016,3,4,14,246,320,566
2016,3,4,15,198,266,464
2016,3,4,16,161,152,313
2016,3,4,17,127,154,281
2016,3,4,18,135,139,274
2016,3,4,19,90,104,194
2016,3,4,20,75,93,168
2016,3,4,21,45,73,118
2016,3,4,22,56,76,132
2016,3,4,23,31,50,81
2016,3,5,0,20,29,49
2016,3,5,1,12,35,47
2016,3,5,2,21,41,62
2016,3,5,3,19,27,46
2016,3,5,4,12,11,23
2016,3,5,5,28,21,49
2016,3,5,6,42,30,72
2016,3,5,7,76,40,116
2016,3,5,8,87,57,144
2016,3,5,9,101,90,191
2016,3,5,10,141,111,252
2016,3,5,11,152,131,283
2016,3,5,12,170,147,317
2016,3,5,13,149,176,325
2016,3,5,14,142,157,299
2016,3,5,15,137,172,309
2016,3,5,16,144,166,310
2016,3,5,17,113,145,258
2016,3,5,18,88,95,183
2016,3,5,19,75,83,158
2016,3,5,20,53,77,130
2016,3,5,21,51,77,128
2016,3,5,22,48,67,115
2016,3,5,23,30,60,90
2016,3,6,0,34,54,88
2016,3,6,1,31,51,82
2016,3,6,2,31,63,94
2016,3,6,3,24,38,62
2016,3,6,4,9,22,31
2016,3,6,5,20,15,35
2016,3,6,6,15,28,43
2016,3,6,7,34,22,56
2016,3,6,8,60,40,100
2016,3,6,9,105,64,169
2016,3,6,10,100,90,190
2016,3,6,11,155,137,292
2016,3,6,12,169,146,315
2016,3,6,13,161,188,349
2016,3,6,14,143,167,310
2016,3,6,15,159,175,334
2016,3,6,16,145,159,304
2016,3,6,17,161,145,306
2016,3,6,18,150,153,303
2016,3,6,19,118,138,256
2016,3,6,20,93,112,205
2016,3,6,21,52,76,128
2016,3,6,22,36,39,75
2016,3,6,23,18,15,33
2016,3,7,0,11,9,20
2016,3,7,1,5,11,16
2016,3,7,2,9,13,22
2016,3,7,3,5,8,13
2016,3,7,4,21,16,37
2016,3,7,5,115,59,174
2016,3,7,6,269,180,449
2016,3,7,7,389,195,584
2016,3,7,8,266,169,435
2016,3,7,9,233,169,402
2016,3,7,10,214,165,379
2016,3,7,11,140,144,284
2016,3,7,12,198,168,366
2016,3,7,13,210,252,462
2016,3,7,14,247,329,576
2016,3,7,15,229,320,549
2016,3,7,16,225,204,429
2016,3,7,17,169,137,306
2016,3,7,18,156,162,318
2016,3,7,19,125,132,257
2016,3,7,20,91,129,220
2016,3,7,21,57,86,143
2016,3,7,22,38,38,76
2016,3,7,23,23,20,43
2016,3,8,0,17,16,33
2016,3,8,1,4,5,9
2016,3,8,2,6,6,12
2016,3,8,3,5,8,13
2016,3,8,4,15,14,29
2016,3,8,5,122,68,190
2016,3,8,6,238,172,410
2016,3,8,7,367,207,574
2016,3,8,8,277,183,460
2016,3,8,9,225,159,384
2016,3,8,10,216,172,388
2016,3,8,11,237,177,414
2016,3,8,12,216,218,434
2016,3,8,13,211,259,470
2016,3,8,14,242,340,582
2016,3,8,15,236,302,538
2016,3,8,16,218,214,432
2016,3,8,17,166,157,323
2016,3,8,18,138,145,283
2016,3,8,19,106,144,250
2016,3,8,20,88,134,222
2016,3,8,21,59,101,160
2016,3,8,22,40,53,93
2016,3,8,23,19,15,34
2016,3,9,0,10,17,27
2016,3,9,1,8,10,18
2016,3,9,2,10,17,27
2016,3,9,3,11,11,22
2016,3,9,4,16,16,32
2016,3,9,5,119,63,182
2016,3,9,6,258,209,467
2016,3,9,7,424,190,614
2016,3,9,8,271,170,441
2016,3,9,9,184,155,339
2016,3,9,10,229,188,417
2016,3,9,11,216,185,401
2016,3,9,12,217,230,447
2016,3,9,13,238,252,490
2016,3,9,14,241,338,579
2016,3,9,15,231,282,513
2016,3,9,16,202,207,409
2016,3,9,17,201,152,353
2016,3,9,18,141,175,316
2016,3,9,19,117,114,231
2016,3,9,20,90,140,230
2016,3,9,21,52,95,147
2016,3,9,22,36,43,79
2016,3,9,23,29,29,58
2016,3,10,0,9,15,24
2016,3,10,1,4,12,16
2016,3,10,2,11,12,23
2016,3,10,3,5,12,17
2016,3,10,4,20,6,26
2016,3,10,5,114,78,192
2016,3,10,6,236,174,410
2016,3,10,7,369,218,587
2016,3,10,8,274,156,430
2016,3,10,9,218,191,409
2016,3,10,10,206,168,374
2016,3,10,11,212,187,399
2016,3,10,12,208,240,448
2016,3,10,13,226,254,480
2016,3,10,14,273,337,610
2016,3,10,15,198,252,450
2016,3,10,16,229,212,441
2016,3,10,17,192,179,371
2016,3,10,18,130,171,301
2016,3,10,19,121,174,295
2016,3,10,20,87,112,199
2016,3,10,21,62,344,406
2016,3,10,22,41,254,295
2016,3,10,23,16,100,116
2016,3,11,0,9,49,58
2016,3,11,1,14,43,57
2016,3,11,2,23,34,57
2016,3,11,3,11,13,24
2016,3,11,4,23,13,36
2016,3,11,5,116,64,180
2016,3,11,6,247,172,419
2016,3,11,7,339,180,519
2016,3,11,8,264,161,425
2016,3,11,9,211,223,434
2016,3,11,10,221,191,412
2016,3,11,11,237,214,451
2016,3,11,12,263,231,494
2016,3,11,13,251,283,534
2016,3,11,14,260,351,611
2016,3,11,15,201,273,474
2016,3,11,16,179,201,380
2016,3,11,17,180,154,334
2016,3,11,18,141,152,293
2016,3,11,19,101,120,221
2016,3,11,20,74,104,178
2016,3,11,21,70,85,155
2016,3,11,22,52,71,123
2016,3,11,23,42,59,101
2016,3,12,0,18,44,62
2016,3,12,1,27,48,75
2016,3,12,2,25,48,73
2016,3,12,3,19,38,57
2016,3,12,4,13,15,28
2016,3,12,5,28,19,47
2016,3,12,6,34,19,53
2016,3,12,7,66,38,104
2016,3,12,8,85,85,170
2016,3,12,9,155,94,249
2016,3,12,10,170,139,309
2016,3,12,11,185,148,333
2016,3,12,12,193,190,383
2016,3,12,13,199,202,401
2016,3,12,14,172,173,345
2016,3,12,15,127,161,288
2016,3,12,16,160,189,349
2016,3,12,17,128,151,279
2016,3,12,18,128,130,258
2016,3,12,19,72,98,170
2016,3,12,20,75,77,152
2016,3,12,21,57,64,121
2016,3,12,22,35,62,97
2016,3,12,23,38,69,107
2016,3,13,0,35,73,108
2016,3,13,1,45,80,125
2016,3,13,2,33,58,91
2016,3,13,3,30,41,71
2016,3,13,4,21,15,36
2016,3,13,5,14,12,26
2016,3,13,6,17,24,41
2016,3,13,7,60,23,83
2016,3,13,8,67,70,137
2016,3,13,9,125,80,205
2016,3,13,10,147,112,259
2016,3,13,11,150,143,293
2016,3,13,12,155,156,311
2016,3,13,13,178,243,421
2016,3,13,14,148,186,334
2016,3,13,15,127,220,347
2016,3,13,16,156,174,330
2016,3,13,17,139,124,263
2016,3,13,18,97,121,218
2016,3,13,19,133,153,286
2016,3,13,20,96,99,195
2016,3,13,21,50,74,124
2016,3,13,22,32,29,61
2016,3,13,23,12,23,35
2016,3,14,0,15,13,28
2016,3,14,1,9,22,31
2016,3,14,2,9,11,20
2016,3,14,3,6,11,17
2016,3,14,4,15,12,27
2016,3,14,5,121,73,194
2016,3,14,6,250,170,420
2016,3,14,7,370,181,551
2016,3,14,8,255,165,420
2016,3,14,9,221,145,366
2016,3,14,10,194,182,376
2016,3,14,11,201,186,387
2016,3,14,12,211,187,398
2016,3,14,13,229,248,477
2016,3,14,14,235,317,552
2016,3,14,15,259,291,550
2016,3,14,16,202,198,400
2016,3,14,17,199,165,364
2016,3,14,18,154,178,332
2016,3,14,19,110,128,238
2016,3,14,20,97,127,224
2016,3,14,21,45,65,110
2016,3,14,22,36,41,77
2016,3,14,23,19,27,46
2016,3,15,0,6,12,18
2016,3,15,1,6,10,16
2016,3,15,2,9,6,15
2016,3,15,3,3,6,9
2016,3,15,4,16,9,25
2016,3,15,5,130,62,192
2016,3,15,6,241,196,437
2016,3,15,7,360,203,563
2016,3,15,8,256,167,423
2016,3,15,9,231,175,406
2016,3,15,10,207,193,400
2016,3,15,11,231,191,422
2016,3,15,12,237,207,444
2016,3,15,13,233,246,479
2016,3,15,14,233,316,549
2016,3,15,15,247,285,532
2016,3,15,16,187,196,383
2016,3,15,17,201,174,375
2016,3,15,18,163,166,329
2016,3,15,19,134,123,257
2016,3,15,20,78,135,213
2016,3,15,21,71,92,163
2016,3,15,22,23,28,51
2016,3,15,23,22,19,41
2016,3,16,0,14,19,33
2016,3,16,1,12,14,26
2016,3,16,2,13,19,32
2016,3,16,3,3,7,10
2016,3,16,4,16,10,26
2016,3,16,5,105,73,178
2016,3,16,6,258,179,437
2016,3,16,7,346,210,556
2016,3,16,8,280,159,439
2016,3,16,9,242,184,426
2016,3,16,10,206,170,376
2016,3,16,11,208,212,420
2016,3,16,12,242,237,479
2016,3,16,13,247,304,551
2016,3,16,14,268,320,588
2016,3,16,15,234,311,545
2016,3,16,16,242,207,449
2016,3,16,17,181,155,336
2016,3,16,18,178,180,358
2016,3,16,19,134,158,292
2016,3,16,20,98,118,216
2016,3,16,21,66,106,172
2016,3,16,22,43,61,104
2016,3,16,23,19,29,48
2016,3,17,0,13,24,37
2016,3,17,1,6,13,19
2016,3,17,2,8,12,20
2016,3,17,3,6,7,13
2016,3,17,4,16,10,26
2016,3,17,5,135,71,206
2016,3,17,6,256,193,449
2016,3,17,7,390,215,605
2016,3,17,8,257,173,430
2016,3,17,9,159,123,282
2016,3,17,10,234,192,426
2016,3,17,11,260,200,460
2016,3,17,12,202,215,417
2016,3,17,13,232,294,526
2016,3,17,14,331,456,787
2016,3,17,15,262,318,580
2016,3,17,16,206,181,387
2016,3,17,17,223,177,400
2016,3,17,18,176,178,354
2016,3,17,19,132,160,292
2016,3,17,20,93,124,217
2016,3,17,21,63,82,145
2016,3,17,22,46,65,111
2016,3,17,23,18,28,46
2016,3,18,0,14,35,49
2016,3,18,1,9,28,37
2016,3,18,2,13,26,39
2016,3,18,3,12,18,30
2016,3,18,4,23,9,32
2016,3,18,5,123,78,201
2016,3,18,6,229,164,393
2016,3,18,7,364,194,558
2016,3,18,8,270,160,430
2016,3,18,9,222,188,410
2016,3,18,10,230,196,426
2016,3,18,11,287,231,518
2016,3,18,12,276,265,541
2016,3,18,13,292,297,589
2016,3,18,14,258,303,561
2016,3,18,15,210,299,509
2016,3,18,16,186,178,364
2016,3,18,17,172,165,337
2016,3,18,18,141,137,278
2016,3,18,19,102,97,199
2016,3,18,20,82,106,188
2016,3,18,21,64,73,137
2016,3,18,22,40,56,96
2016,3,18,23,28,51,79
2016,3,19,0,21,76,97
2016,3,19,1,23,32,55
2016,3,19,2,24,56,80
2016,3,19,3,19,21,40
2016,3,19,4,14,15,29
2016,3,19,5,31,19,50
2016,3,19,6,34,36,70
2016,3,19,7,37,34,71
2016,3,19,8,59,58,117
2016,3,19,9,118,72,190
2016,3,19,10,113,91,204
2016,3,19,11,180,110,290
2016,3,19,12,145,142,287
2016,3,19,13,131,147,278
2016,3,19,14,155,163,318
2016,3,19,15,117,127,244
2016,3,19,16,125,108,233
2016,3,19,17,129,114,243
2016,3,19,18,81,75,156
2016,3,19,19,72,73,145
2016,3,19,20,42,70,112
2016,3,19,21,46,51,97
2016,3,19,22,38,33,71
2016,3,19,23,33,52,85
2016,3,20,0,20,27,47
2016,3,20,1,25,45,70
2016,3,20,2,22,50,72
2016,3,20,3,17,53,70
2016,3,20,4,16,19,35
2016,3,20,5,19,19,38
2016,3,20,6,28,25,53
2016,3,20,7,33,21,54
2016,3,20,8,37,37,74
2016,3,20,9,94,59,153
2016,3,20,10,88,68,156
2016,3,20,11,104,100,204
2016,3,20,12,124,138,262
2016,3,20,13,165,128,293
2016,3,20,14,138,150,288
2016,3,20,15,104,205,309
2016,3,20,16,136,162,298
2016,3,20,17,97,96,193
2016,3,20,18,97,105,202
2016,3,20,19,144,123,267
2016,3,20,20,68,91,159
2016,3,20,21,33,55,88
2016,3,20,22,35,51,86
2016,3,20,23,16,25,41
2016,3,21,0,11,13,24
2016,3,21,1,8,11,19
2016,3,21,2,8,15,23
2016,3,21,3,7,11,18
2016,3,21,4,17,11,28
2016,3,21,5,85,41,126
2016,3,21,6,156,115,271
2016,3,21,7,206,114,320
2016,3,21,8,190,144,334
2016,3,21,9,169,121,290
2016,3,21,10,186,143,329
2016,3,21,11,267,195,462
2016,3,21,12,272,193,465
2016,3,21,13,262,210,472
2016,3,21,14,297,243,540
2016,3,21,15,162,204,366
2016,3,21,16,157,127,284
2016,3,21,17,132,114,246
2016,3,21,18,92,109,201
2016,3,21,19,86,78,164
2016,3,21,20,73,82,155
2016,3,21,21,46,49,95
2016,3,21,22,33,36,69
2016,3,21,23,21,22,43
2016,3,22,0,11,20,31
2016,3,22,1,6,9,15
2016,3,22,2,9,7,16
2016,3,22,3,2,8,10
2016,3,22,4,15,6,21
2016,3,22,5,90,45,135
2016,3,22,6,140,119,259
2016,3,22,7,153,104,257
2016,3,22,8,195,108,303
2016,3,22,9,184,126,310
2016,3,22,10,192,152,344
2016,3,22,11,205,152,357
2016,3,22,12,177,167,344
2016,3,22,13,177,227,404
2016,3,22,14,220,235,455
2016,3,22,15,161,188,349
2016,3,22,16,146,142,288
2016,3,22,17,121,120,241
2016,3,22,18,89,108,197
2016,3,22,19,92,100,192
2016,3,22,20,79,70,149
2016,3,22,21,48,61,109
2016,3,22,22,29,41,70
2016,3,22,23,26,25,51
2016,3,23,0,9,17,26
2016,3,23,1,14,34,48
2016,3,23,2,9,13,22
2016,3,23,3,6,21,27
2016,3,23,4,16,9,25
2016,3,23,5,75,39,114
2016,3,23,6,121,90,211
2016,3,23,7,140,75,215
2016,3,23,8,120,127,247
2016,3,23,9,132,125,257
2016,3,23,10,291,213,504
2016,3,23,11,374,244,618
2016,3,23,12,159,156,315
2016,3,23,13,130,138,268
2016,3,23,14,118,135,253
2016,3,23,15,98,122,220
2016,3,23,16,109,108,217
2016,3,23,17,95,103,198
2016,3,23,18,79,92,171
2016,3,23,19,80,86,166
2016,3,23,20,57,56,113
2016,3,23,21,42,44,86
2016,3,23,22,38,42,80
2016,3,23,23,27,36,63
2016,3,24,0,11,17,28
2016,3,24,1,13,22,35
2016,3,24,2,11,20,31
2016,3,24,3,8,14,22
2016,3,24,4,8,6,14
2016,3,24,5,19,13,32
2016,3,24,6,17,26,43
2016,3,24,7,24,12,36
2016,3,24,8,35,20,55
2016,3,24,9,55,27,82
2016,3,24,10,100,47,147
2016,3,24,11,102,94,196
2016,3,24,12,94,96,190
2016,3,24,13,104,116,220
2016,3,24,14,109,147,256
2016,3,24,15,88,113,201
2016,3,24,16,93,107,200
2016,3,24,17,69,97,166
2016,3,24,18,77,82,159
2016,3,24,19,71,68,139
2016,3,24,20,54,56,110
2016,3,24,21,30,45,75
2016,3,24,22,24,32,56
2016,3,24,23,29,33,62
2016,3,25,0,7,36,43
2016,3,25,1,8,19,27
2016,3,25,2,5,22,27
2016,3,25,3,10,15,25
2016,3,25,4,9,9,18
2016,3,25,5,10,8,18
2016,3,25,6,21,15,36
2016,3,25,7,27,17,44
2016,3,25,8,29,15,44
2016,3,25,9,58,41,99
2016,3,25,10,75,62,137
2016,3,25,11,107,69,176
2016,3,25,12,95,102,197
2016,3,25,13,114,126,240
2016,3,25,14,118,129,247
2016,3,25,15,90,124,214
2016,3,25,16,82,136,218
2016,3,25,17,76,99,175
2016,3,25,18,68,91,159
2016,3,25,19,67,86,153
2016,3,25,20,51,91,142
2016,3,25,21,40,44,84
2016,3,25,22,32,38,70
2016,3,25,23,31,48,79
2016,3,26,0,19,26,45
2016,3,26,1,9,18,27
2016,3,26,2,11,35,46
2016,3,26,3,8,19,27
2016,3,26,4,7,9,16
2016,3,26,5,19,13,32
2016,3,26,6,22,16,38
2016,3,26,7,33,21,54
2016,3,26,8,39,36,75
2016,3,26,9,83,71,154
2016,3,26,10,98,117,215
2016,3,26,11,115,136,251
2016,3,26,12,114,101,215
2016,3,26,13,111,115,226
2016,3,26,14,95,111,206
2016,3,26,15,88,115,203
2016,3,26,16,102,112,214
2016,3,26,17,88,67,155
2016,3,26,18,69,61,130
2016,3,26,19,69,70,139
2016,3,26,20,75,57,132
2016,3,26,21,38,49,87
2016,3,26,22,36,54,90
2016,3,26,23,38,55,93
2016,3,27,0,24,29,53
2016,3,27,1,24,40,64
2016,3,27,2,32,39,71
2016,3,27,3,13,31,44
2016,3,27,4,21,14,35
2016,3,27,5,24,18,42
2016,3,27,6,18,9,27
2016,3,27,7,18,20,38
2016,3,27,8,46,30,76
2016,3,27,9,70,43,113
2016,3,27,10,77,58,135
2016,3,27,11,72,95,167
2016,3,27,12,131,139,270
2016,3,27,13,100,97,197
2016,3,27,14,117,180,297
2016,3,27,15,92,99,191
2016,3,27,16,107,91,198
2016,3,27,17,104,98,202
2016,3,27,18,91,123,214
2016,3,27,19,76,81,157
2016,3,27,20,49,54,103
2016,3,27,21,42,59,101
2016,3,27,22,26,30,56
2016,3,27,23,11,15,26
2016,3,28,0,16,21,37
2016,3,28,1,7,14,21
2016,3,28,2,9,27,36
2016,3,28,3,9,8,17
2016,3,28,4,13,9,22
2016,3,28,5,25,12,37
2016,3,28,6,25,13,38
2016,3,28,7,36,32,68
2016,3,28,8,59,28,87
2016,3,28,9,79,60,139
2016,3,28,10,99,88,187
2016,3,28,11,110,108,218
2016,3,28,12,138,125,263
2016,3,28,13,130,159,289
2016,3,28,14,130,168,298
2016,3,28,15,122,127,249
2016,3,28,16,139,148,287
2016,3,28,17,125,144,269
2016,3,28,18,116,117,233
2016,3,28,19,67,78,145
2016,3,28,20,60,62,122
2016,3,28,21,38,56,94
2016,3,28,22,25,25,50
2016,3,28,23,17,7,24
2016,3,29,0,7,13,20
2016,3,29,1,4,6,10
2016,3,29,2,6,9,15
2016,3,29,3,18,12,30
2016,3,29,4,123,63,186
2016,3,29,5,196,145,341
2016,3,29,6,240,147,387
2016,3,29,7,253,147,400
2016,3,29,8,213,150,363
2016,3,29,9,203,170,373
2016,3,29,10,213,190,403
2016,3,29,11,220,210,430
2016,3,29,12,208,229,437
2016,3,29,13,226,283,509
2016,3,29,14,211,276,487
2016,3,29,15,163,172,335
2016,3,29,16,150,116,266
2016,3,29,17,105,133,238
2016,3,29,18,93,103,196
2016,3,29,19,70,85,155
2016,3,29,20,47,73,120
2016,3,29,21,39,49,88
2016,3,29,22,15,23,38
2016,3,29,23,12,13,25
2016,3,30,0,10,17,27
2016,3,30,1,6,19,25
2016,3,30,2,3,7,10
2016,3,30,3,19,10,29
2016,3,30,4,110,50,160
2016,3,30,5,196,141,337
2016,3,30,6,235,157,392
2016,3,30,7,241,126,367
2016,3,30,8,183,128,311
2016,3,30,9,191,170,361
2016,3,30,10,212,170,382
2016,3,30,11,186,187,373
2016,3,30,12,194,252,446
2016,3,30,13,236,267,503
2016,3,30,14,197,249,446
2016,3,30,15,184,180,364
2016,3,30,16,140,137,277
2016,3,30,17,135,142,277
2016,3,30,18,94,117,211
2016,3,30,19,91,103,194
2016,3,30,20,58,80,138
2016,3,30,21,45,40,85
2016,3,30,22,29,28,57
2016,3,30,23,19,20,39
2016,3,31,0,18,22,40
2016,3,31,1,10,8,18
2016,3,31,2,6,12,18
2016,3,31,3,23,18,41
2016,3,31,4,98,55,153
2016,3,31,5,194,139,333
2016,3,31,6,265,163,428
2016,3,31,7,242,134,376
2016,3,31,8,202,149,351
2016,3,31,9,205,163,368
2016,3,31,10,209,175,384
2016,3,31,11,166,209,375
2016,3,31,12,204,210,414
2016,3,31,13,231,276,507
2016,3,31,14,186,255,441
2016,3,31,15,107,131,238
2016,3,31,16,163,160,323
2016,3,31,17,124,140,264
2016,3,31,18,96,120,216
2016,3,31,19,93,104,197
2016,3,31,20,60,87,147
2016,3,31,21,34,52,86
2016,3,31,22,23,35,58
2016,3,31,23,11,13,24
2016,4,1,0,9,24,33
2016,4,1,1,12,24,36
2016,4,1,2,8,16,24
2016,4,1,3,22,10,32
2016,4,1,4,119,48,167
2016,4,1,5,194,134,328
2016,4,1,6,255,130,385
2016,4,1,7,238,163,401
2016,4,1,8,196,162,358
2016,4,1,9,231,176,407
2016,4,1,10,230,203,433
2016,4,1,11,218,200,418
2016,4,1,12,207,235,442
2016,4,1,13,240,277,517
2016,4,1,14,183,244,427
2016,4,1,15,147,181,328
2016,4,1,16,125,142,267
2016,4,1,17,125,131,256
2016,4,1,18,98,82,180
2016,4,1,19,68,72,140
2016,4,1,20,51,51,102
2016,4,1,21,43,66,109
2016,4,1,22,27,53,80
2016,4,1,23,17,36,53
2016,4,2,0,21,34,55
2016,4,2,1,21,41,62
2016,4,2,2,15,21,36
2016,4,2,3,13,6,19
2016,4,2,4,30,10,40
2016,4,2,5,42,37,79
2016,4,2,6,45,33,78
2016,4,2,7,63,51,114
2016,4,2,8,113,68,181
2016,4,2,9,116,100,216
2016,4,2,10,144,129,273
2016,4,2,11,179,157,336
2016,4,2,12,142,152,294
2016,4,2,13,159,186,345
2016,4,2,14,146,152,298
2016,4,2,15,133,163,296
2016,4,2,16,142,155,297
2016,4,2,17,101,107,208
2016,4,2,18,90,92,182
2016,4,2,19,60,65,125
2016,4,2,20,43,60,103
2016,4,2,21,45,65,110
2016,4,2,22,36,58,94
2016,4,2,23,26,39,65
2016,4,3,0,34,59,93
2016,4,3,1,38,55,93
2016,4,3,2,19,43,62
2016,4,3,3,16,14,30
2016,4,3,4,18,27,45
2016,4,3,5,19,20,39
2016,4,3,6,27,17,44
2016,4,3,7,28,32,60
2016,4,3,8,91,47,138
2016,4,3,9,103,86,189
2016,4,3,10,151,143,294
2016,4,3,11,156,178,334
2016,4,3,12,193,165,358
2016,4,3,13,156,209,365
2016,4,3,14,142,234,376
2016,4,3,15,160,202,362
2016,4,3,16,151,143,294
2016,4,3,17,154,126,280
2016,4,3,18,129,146,275
2016,4,3,19,95,119,214
2016,4,3,20,63,71,134
2016,4,3,21,44,33,77
2016,4,3,22,20,20,40
2016,4,3,23,12,14,26
2016,4,4,0,6,9,15
2016,4,4,1,9,9,18
2016,4,4,2,7,9,16
2016,4,4,3,18,10,28
2016,4,4,4,117,64,181
2016,4,4,5,222,152,374
2016,4,4,6,393,215,608
2016,4,4,7,272,172,444
2016,4,4,8,206,185,391
2016,4,4,9,215,192,407
2016,4,4,10,228,171,399
2016,4,4,11,207,217,424
2016,4,4,12,225,248,473
2016,4,4,13,275,324,599
2016,4,4,14,246,298,544
2016,4,4,15,179,196,375
2016,4,4,16,189,152,341
2016,4,4,17,148,150,298
2016,4,4,18,124,141,265
2016,4,4,19,94,129,223
2016,4,4,20,75,75,150
2016,4,4,21,35,35,70
2016,4,4,22,11,27,38
2016,4,4,23,7,5,12
2016,4,5,0,2,6,8
2016,4,5,1,9,11,20
2016,4,5,2,8,7,15
2016,4,5,3,22,13,35
2016,4,5,4,120,52,172
2016,4,5,5,249,169,418
2016,4,5,6,393,195,588
2016,4,5,7,252,185,437
2016,4,5,8,232,184,416
2016,4,5,9,223,175,398
2016,4,5,10,228,182,410
2016,4,5,11,218,201,419
2016,4,5,12,240,267,507
2016,4,5,13,267,316,583
2016,4,5,14,251,298,549
2016,4,5,15,215,211,426
2016,4,5,16,171,166,337
2016,4,5,17,155,160,315
2016,4,5,18,115,129,244
2016,4,5,19,105,121,226
2016,4,5,20,61,83,144
2016,4,5,21,46,38,84
2016,4,5,22,20,35,55
2016,4,5,23,13,16,29
2016,4,6,0,6,19,25
2016,4,6,1,7,11,18
2016,4,6,2,7,9,16
2016,4,6,3,22,9,31
2016,4,6,4,110,61,171
2016,4,6,5,257,178,435
2016,4,6,6,394,207,601
2016,4,6,7,270,167,437
2016,4,6,8,226,177,403
2016,4,6,9,210,181,391
2016,4,6,10,201,185,386
2016,4,6,11,217,193,410
2016,4,6,12,220,223,443
2016,4,6,13,285,375,660
2016,4,6,14,244,331,575
2016,4,6,15,212,241,453
2016,4,6,16,218,182,400
2016,4,6,17,159,196,355
2016,4,6,18,139,155,294
2016,4,6,19,62,88,150
2016,4,6,20,61,86,147
2016,4,6,21,48,43,91
2016,4,6,22,24,26,50
2016,4,6,23,8,17,25
2016,4,7,0,10,17,27
2016,4,7,1,7,10,17
2016,4,7,2,7,12,19
2016,4,7,3,17,9,26
2016,4,7,4,122,64,186
2016,4,7,5,244,200,444
2016,4,7,6,404,210,614
2016,4,7,7,263,150,413
2016,4,7,8,240,190,430
2016,4,7,9,218,187,405
2016,4,7,10,219,192,411
2016,4,7,11,227,249,476
2016,4,7,12,239,250,489
2016,4,7,13,255,334,589
2016,4,7,14,249,267,516
2016,4,7,15,210,222,432
2016,4,7,16,210,205,415
2016,4,7,17,149,190,339
2016,4,7,18,154,156,310
2016,4,7,19,93,119,212
2016,4,7,20,71,93,164
2016,4,7,21,36,45,81
2016,4,7,22,20,35,55
2016,4,7,23,10,27,37
2016,4,8,0,5,29,34
2016,4,8,1,7,20,27
2016,4,8,2,13,8,21
2016,4,8,3,20,10,30
2016,4,8,4,105,62,167
2016,4,8,5,262,173,435
2016,4,8,6,371,207,578
2016,4,8,7,250,138,388
2016,4,8,8,218,178,396
2016,4,8,9,222,196,418
2016,4,8,10,223,196,419
2016,4,8,11,255,226,481
2016,4,8,12,254,276,530
2016,4,8,13,301,330,631
2016,4,8,14,228,291,519
2016,4,8,15,207,210,417
2016,4,8,16,164,179,343
2016,4,8,17,127,154,281
2016,4,8,18,123,103,226
2016,4,8,19,71,106,177
2016,4,8,20,74,67,141
2016,4,8,21,51,58,109
2016,4,8,22,36,75,111
2016,4,8,23,22,51,73
2016,4,9,0,22,41,63
2016,4,9,1,20,46,66
2016,4,9,2,14,20,34
2016,4,9,3,13,13,26
2016,4,9,4,30,14,44
2016,4,9,5,42,33,75
2016,4,9,6,57,43,100
2016,4,9,7,82,50,132
2016,4,9,8,116,108,224
2016,4,9,9,137,140,277
2016,4,9,10,180,151,331
2016,4,9,11,169,167,336
2016,4,9,12,189,172,361
2016,4,9,13,171,167,338
2016,4,9,14,142,175,317
2016,4,9,15,148,140,288
2016,4,9,16,116,131,247
2016,4,9,17,115,132,247
2016,4,9,18,93,95,188
2016,4,9,19,80,76,156
2016,4,9,20,42,68,110
2016,4,9,21,58,54,112
2016,4,9,22,34,53,87
2016,4,9,23,34,58,92
2016,4,10,0,28,56,84
2016,4,10,1,26,59,85
2016,4,10,2,14,47,61
2016,4,10,3,10,22,32
2016,4,10,4,20,14,34
2016,4,10,5,17,21,38
2016,4,10,6,33,20,53
2016,4,10,7,54,36,90
2016,4,10,8,83,62,145
2016,4,10,9,120,91,211
2016,4,10,10,186,153,339
2016,4,10,11,137,181,318
2016,4,10,12,171,236,407
2016,4,10,13,175,193,368
2016,4,10,14,140,178,318
2016,4,10,15,193,174,367
2016,4,10,16,154,161,315
2016,4,10,17,165,143,308
2016,4,10,18,120,157,277
2016,4,10,19,90,123,213
2016,4,10,20,80,63,143
2016,4,10,21,33,41,74
2016,4,10,22,18,20,38
2016,4,10,23,11,14,25
2016,4,11,0,10,10,20
2016,4,11,1,6,9,15
2016,4,11,2,8,8,16
2016,4,11,3,12,17,29
2016,4,11,4,131,71,202
2016,4,11,5,242,182,424
2016,4,11,6,388,211,599
2016,4,11,7,284,177,461
2016,4,11,8,223,158,381
2016,4,11,9,195,172,367
2016,4,11,10,196,171,367
2016,4,11,11,250,222,472
2016,4,11,12,220,250,470
2016,4,11,13,257,333,590
2016,4,11,14,234,301,535
2016,4,11,15,224,204,428
2016,4,11,16,199,149,348
2016,4,11,17,144,160,304
2016,4,11,18,95,94,189
2016,4,11,19,127,123,250
2016,4,11,20,66,89,155
2016,4,11,21,44,41,85
2016,4,11,22,20,16,36
2016,4,11,23,6,11,17
2016,4,12,0,6,8,14
2016,4,12,1,6,7,13
2016,4,12,2,8,8,16
2016,4,12,3,25,11,36
2016,4,12,4,115,75,190
2016,4,12,5,260,207,467
2016,4,12,6,405,212,617
2016,4,12,7,277,162,439
2016,4,12,8,208,160,368
2016,4,12,9,208,188,396
2016,4,12,10,229,248,477
2016,4,12,11,239,226,465
2016,4,12,12,232,257,489
2016,4,12,13,285,343,628
2016,4,12,14,248,308,556
2016,4,12,15,202,230,432
2016,4,12,16,228,166,394
2016,4,12,17,161,167,328
2016,4,12,18,132,134,266
2016,4,12,19,95,121,216
2016,4,12,20,59,82,141
2016,4,12,21,36,65,101
2016,4,12,22,16,19,35
2016,4,12,23,11,14,25
2016,4,13,0,4,19,23
2016,4,13,1,10,8,18
2016,4,13,2,5,11,16
2016,4,13,3,14,13,27
2016,4,13,4,100,71,171
2016,4,13,5,265,182,447
2016,4,13,6,365,202,567
2016,4,13,7,273,176,449
2016,4,13,8,229,178,407
2016,4,13,9,225,364,589
2016,4,13,10,224,394,618
2016,4,13,11,208,227,435
2016,4,13,12,230,253,483
2016,4,13,13,270,331,601
2016,4,13,14,229,286,515
2016,4,13,15,271,222,493
2016,4,13,16,193,146,339
2016,4,13,17,169,165,334
2016,4,13,18,130,151,281
2016,4,13,19,92,140,232
2016,4,13,20,85,90,175
2016,4,13,21,36,42,78
2016,4,13,22,18,23,41
2016,4,13,23,13,19,32
2016,4,14,0,6,17,23
2016,4,14,1,12,36,48
2016,4,14,2,8,26,34
2016,4,14,3,23,34,57
2016,4,14,4,122,71,193
2016,4,14,5,267,193,460
2016,4,14,6,435,222,657
2016,4,14,7,302,191,493
2016,4,14,8,241,185,426
2016,4,14,9,230,180,410
2016,4,14,10,209,198,407
2016,4,14,11,221,239,460
2016,4,14,12,198,264,462
2016,4,14,13,304,311,615
2016,4,14,14,238,318,556
2016,4,14,15,213,240,453
2016,4,14,16,206,199,405
2016,4,14,17,161,157,318
2016,4,14,18,112,137,249
2016,4,14,19,84,126,210
2016,4,14,20,59,67,126
2016,4,14,21,39,50,89
2016,4,14,22,27,36,63
2016,4,14,23,23,32,55
2016,4,15,0,9,27,36
2016,4,15,1,13,25,38
2016,4,15,2,5,27,32
2016,4,15,3,22,9,31
2016,4,15,4,117,69,186
2016,4,15,5,255,176,431
2016,4,15,6,384,210,594
2016,4,15,7,244,150,394
2016,4,15,8,220,184,404
2016,4,15,9,247,218,465
2016,4,15,10,266,208,474
2016,4,15,11,265,207,472
2016,4,15,12,282,300,582
2016,4,15,13,311,383,694
2016,4,15,14,224,302,526
2016,4,15,15,175,174,349
2016,4,15,16,147,145,292
2016,4,15,17,136,168,304
2016,4,15,18,98,119,217
2016,4,15,19,103,119,222
2016,4,15,20,61,65,126
2016,4,15,21,49,56,105
2016,4,15,22,49,48,97
2016,4,15,23,30,41,71
2016,4,16,0,27,59,86
2016,4,16,1,20,39,59
2016,4,16,2,10,26,36
2016,4,16,3,13,13,26
2016,4,16,4,27,13,40
2016,4,16,5,37,27,64
2016,4,16,6,37,38,75
2016,4,16,7,90,73,163
2016,4,16,8,138,113,251
2016,4,16,9,149,150,299
2016,4,16,10,190,166,356
2016,4,16,11,174,169,343
2016,4,16,12,162,181,343
2016,4,16,13,179,173,352
2016,4,16,14,175,176,351
2016,4,16,15,141,168,309
2016,4,16,16,130,135,265
2016,4,16,17,124,102,226
2016,4,16,18,95,107,202
2016,4,16,19,86,87,173
2016,4,16,20,61,57,118
2016,4,16,21,50,87,137
2016,4,16,22,42,65,107
2016,4,16,23,42,57,99
2016,4,17,0,39,72,111
2016,4,17,1,33,55,88
2016,4,17,2,18,43,61
2016,4,17,3,13,17,30
2016,4,17,4,17,9,26
2016,4,17,5,23,12,35
2016,4,17,6,38,19,57
2016,4,17,7,63,44,107
2016,4,17,8,129,70,199
2016,4,17,9,155,121,276
2016,4,17,10,161,170,331
2016,4,17,11,176,185,361
2016,4,17,12,203,221,424
2016,4,17,13,200,193,393
2016,4,17,14,155,214,369
2016,4,17,15,171,162,333
2016,4,17,16,166,190,356
2016,4,17,17,128,136,264
2016,4,17,18,113,155,268
2016,4,17,19,90,98,188
2016,4,17,20,52,55,107
2016,4,17,21,49,47,96
2016,4,17,22,16,19,35
2016,4,17,23,10,11,21
2016,4,18,0,5,10,15
2016,4,18,1,8,7,15
2016,4,18,2,6,14,20
2016,4,18,3,24,9,33
2016,4,18,4,130,60,190
2016,4,18,5,270,178,448
2016,4,18,6,407,214,621
2016,4,18,7,282,166,448
2016,4,18,8,249,204,453
2016,4,18,9,207,161,368
2016,4,18,10,242,189,431
2016,4,18,11,202,205,407
2016,4,18,12,225,280,505
2016,4,18,13,296,347,643
2016,4,18,14,249,272,521
2016,4,18,15,211,204,415
2016,4,18,16,172,154,326
2016,4,18,17,143,170,313
2016,4,18,18,136,135,271
2016,4,18,19,108,129,237
2016,4,18,20,84,99,183
2016,4,18,21,35,33,68
2016,4,18,22,22,26,48
2016,4,18,23,6,7,13
2016,4,19,0,4,9,13
2016,4,19,1,7,6,13
2016,4,19,2,7,7,14
2016,4,19,3,20,11,31
2016,4,19,4,136,76,212
2016,4,19,5,271,185,456
2016,4,19,6,437,202,639
2016,4,19,7,308,196,504
2016,4,19,8,203,195,398
2016,4,19,9,223,175,398
2016,4,19,10,203,216,419
2016,4,19,11,259,217,476
2016,4,19,12,240,302,542
2016,4,19,13,283,318,601
2016,4,19,14,241,300,541
2016,4,19,15,240,207,447
2016,4,19,16,204,189,393
2016,4,19,17,161,188,349
2016,4,19,18,140,153,293
2016,4,19,19,116,128,244
2016,4,19,20,75,99,174
2016,4,19,21,42,45,87
2016,4,19,22,21,43,64
2016,4,19,23,19,23,42
2016,4,20,0,10,15,25
2016,4,20,1,14,17,31
2016,4,20,2,11,17,28
2016,4,20,3,20,9,29
2016,4,20,4,127,66,193
2016,4,20,5,270,167,437
2016,4,20,6,409,214,623
2016,4,20,7,256,160,416
2016,4,20,8,236,171,407
2016,4,20,9,228,180,408
2016,4,20,10,232,227,459
2016,4,20,11,235,221,456
2016,4,20,12,261,282,543
2016,4,20,13,292,334,626
2016,4,20,14,246,293,539
2016,4,20,15,245,229,474
2016,4,20,16,176,177,353
2016,4,20,17,173,171,344
2016,4,20,18,125,132,257
2016,4,20,19,96,147,243
2016,4,20,20,55,95,150
2016,4,20,21,23,27,50
2016,4,20,22,19,19,38
2016,4,20,23,11,17,28
2016,4,21,0,7,9,16
2016,4,21,1,6,6,12
2016,4,21,2,3,17,20
2016,4,21,3,26,9,35
2016,4,21,4,133,68,201
2016,4,21,5,258,173,431
2016,4,21,6,384,221,605
2016,4,21,7,280,153,433
2016,4,21,8,177,132,309
2016,4,21,9,227,180,407
2016,4,21,10,216,195,411
2016,4,21,11,215,224,439
2016,4,21,12,239,263,502
2016,4,21,13,294,323,617
2016,4,21,14,211,294,505
2016,4,21,15,230,216,446
2016,4,21,16,209,187,396
2016,4,21,17,161,183,344
2016,4,21,18,123,167,290
2016,4,21,19,104,138,242
2016,4,21,20,101,77,178
2016,4,21,21,40,118,158
2016,4,21,22,28,38,66
2016,4,21,23,20,22,42
2016,4,22,0,11,29,40
2016,4,22,1,14,23,37
2016,4,22,2,12,17,29
2016,4,22,3,21,14,35
2016,4,22,4,124,68,192
2016,4,22,5,243,191,434
2016,4,22,6,356,191,547
2016,4,22,7,274,194,468
2016,4,22,8,206,163,369
2016,4,22,9,250,204,454
2016,4,22,10,247,218,465
2016,4,22,11,253,242,495
2016,4,22,12,273,313,586
2016,4,22,13,297,328,625
2016,4,22,14,225,269,494
2016,4,22,15,165,170,335
2016,4,22,16,159,159,318
2016,4,22,17,137,155,292
2016,4,22,18,95,137,232
2016,4,22,19,83,92,175
2016,4,22,20,57,79,136
2016,4,22,21,53,62,115
2016,4,22,22,38,44,82
2016,4,22,23,21,43,64
2016,4,23,0,25,45,70
2016,4,23,1,22,40,62
2016,4,23,2,13,25,38
2016,4,23,3,11,11,22
2016,4,23,4,30,17,47
2016,4,23,5,31,25,56
2016,4,23,6,27,21,48
2016,4,23,7,66,67,133
2016,4,23,8,134,86,220
2016,4,23,9,158,103,261
2016,4,23,10,183,150,333
2016,4,23,11,175,146,321
2016,4,23,12,185,198,383
2016,4,23,13,133,189,322
2016,4,23,14,152,174,326
2016,4,23,15,166,204,370
2016,4,23,16,140,132,272
2016,4,23,17,116,139,255
2016,4,23,18,148,128,276
2016,4,23,19,72,76,148
2016,4,23,20,57,67,124
2016,4,23,21,32,54,86
2016,4,23,22,32,60,92
2016,4,23,23,34,60,94
2016,4,24,0,31,49,80
2016,4,24,1,28,52,80
2016,4,24,2,15,36,51
2016,4,24,3,16,16,32
2016,4,24,4,15,19,34
2016,4,24,5,17,20,37
2016,4,24,6,32,22,54
2016,4,24,7,59,43,102
2016,4,24,8,118,65,183
2016,4,24,9,148,116,264
2016,4,24,10,155,153,308
2016,4,24,11,175,177,352
2016,4,24,12,181,218,399
2016,4,24,13,189,214,403
2016,4,24,14,176,219,395
2016,4,24,15,167,187,354
2016,4,24,16,166,161,327
2016,4,24,17,182,189,371
2016,4,24,18,141,164,305
2016,4,24,19,100,122,222
2016,4,24,20,71,85,156
2016,4,24,21,51,39,90
2016,4,24,22,22,26,48
2016,4,24,23,10,13,23
2016,4,25,0,9,11,20
2016,4,25,1,7,8,15
2016,4,25,2,4,6,10
2016,4,25,3,20,11,31
2016,4,25,4,135,67,202
2016,4,25,5,265,170,435
2016,4,25,6,387,214,601
2016,4,25,7,288,183,471
2016,4,25,8,236,192,428
2016,4,25,9,172,172,344
2016,4,25,10,215,215,430
2016,4,25,11,211,222,433
2016,4,25,12,212,224,436
2016,4,25,13,253,307,560
2016,4,25,14,215,290,505
2016,4,25,15,200,182,382
2016,4,25,16,187,152,339
2016,4,25,17,150,178,328
2016,4,25,18,132,127,259
2016,4,25,19,105,130,235
2016,4,25,20,63,84,147
2016,4,25,21,39,42,81
2016,4,25,22,13,12,25
2016,4,25,23,9,13,22
2016,4,26,0,6,5,11
2016,4,26,1,5,8,13
2016,4,26,2,6,13,19
2016,4,26,3,19,11,30
2016,4,26,4,121,69,190
2016,4,26,5,241,168,409
2016,4,26,6,362,220,582
2016,4,26,7,292,170,462
2016,4,26,8,211,177,388
2016,4,26,9,224,190,414
2016,4,26,10,210,230,440
2016,4,26,11,229,195,424
2016,4,26,12,179,202,381
2016,4,26,13,261,322,583
2016,4,26,14,209,303,512
2016,4,26,15,169,188,357
2016,4,26,16,217,208,425
2016,4,26,17,164,153,317
2016,4,26,18,124,151,275
2016,4,26,19,113,117,230
2016,4,26,20,71,96,167
2016,4,26,21,40,42,82
2016,4,26,22,15,23,38
2016,4,26,23,16,28,44
2016,4,27,0,13,13,26
2016,4,27,1,7,14,21
2016,4,27,2,7,14,21
2016,4,27,3,22,12,34
2016,4,27,4,104,74,178
2016,4,27,5,280,168,448
2016,4,27,6,377,211,588
2016,4,27,7,262,157,419
2016,4,27,8,225,176,401
2016,4,27,9,228,200,428
2016,4,27,10,255,182,437
2016,4,27,11,222,243,465
2016,4,27,12,225,249,474
2016,4,27,13,278,364,642
2016,4,27,14,234,273,507
2016,4,27,15,223,197,420
2016,4,27,16,170,152,322
2016,4,27,17,165,147,312
2016,4,27,18,138,144,282
2016,4,27,19,100,132,232
2016,4,27,20,98,92,190
2016,4,27,21,41,60,101
2016,4,27,22,32,29,61
2016,4,27,23,11,11,22
2016,4,28,0,7,17,24
2016,4,28,1,9,20,29
2016,4,28,2,8,27,35
2016,4,28,3,12,27,39
2016,4,28,4,132,46,178
2016,4,28,5,274,172,446
2016,4,28,6,370,192,562
2016,4,28,7,232,176,408
2016,4,28,8,238,177,415
2016,4,28,9,213,185,398
2016,4,28,10,191,203,394
2016,4,28,11,226,242,468
2016,4,28,12,235,254,489
2016,4,28,13,259,315,574
2016,4,28,14,231,277,508
2016,4,28,15,227,190,417
2016,4,28,16,203,169,372
2016,4,28,17,150,170,320
2016,4,28,18,137,154,291
2016,4,28,19,115,126,241
2016,4,28,20,84,93,177
2016,4,28,21,40,67,107
2016,4,28,22,20,32,52
2016,4,28,23,16,23,39
2016,4,29,0,16,27,43
2016,4,29,1,13,23,36
2016,4,29,2,8,23,31
2016,4,29,3,20,12,32
2016,4,29,4,118,61,179
2016,4,29,5,246,163,409
2016,4,29,6,364,190,554
2016,4,29,7,262,165,427
2016,4,29,8,235,173,408
2016,4,29,9,254,221,475
2016,4,29,10,253,223,476
2016,4,29,11,260,241,501
2016,4,29,12,281,310,591
2016,4,29,13,276,344,620
2016,4,29,14,243,304,547
2016,4,29,15,199,183,382
2016,4,29,16,193,193,386
2016,4,29,17,152,165,317
2016,4,29,18,110,109,219
2016,4,29,19,81,108,189
2016,4,29,20,88,82,170
2016,4,29,21,64,67,131
2016,4,29,22,50,62,112
2016,4,29,23,26,84,110
2016,4,30,0,31,51,82
2016,4,30,1,19,33,52
2016,4,30,2,8,17,25
2016,4,30,3,13,13,26
2016,4,30,4,32,13,45
2016,4,30,5,37,33,70
2016,4,30,6,68,36,104
2016,4,30,7,153,58,211
2016,4,30,8,170,77,247
2016,4,30,9,169,98,267
2016,4,30,10,167,152,319
2016,4,30,11,179,153,332
2016,4,30,12,150,165,315
2016,4,30,13,166,163,329
2016,4,30,14,185,147,332
2016,4,30,15,165,192,357
2016,4,30,16,162,144,306
2016,4,30,17,134,141,275
2016,4,30,18,108,105,213
2016,4,30,19,95,99,194
2016,4,30,20,78,78,156
2016,4,30,21,76,82,158
2016,4,30,22,42,76,118
2016,4,30,23,34,59,93
2016,5,1,0,28,51,79
2016,5,1,1,35,70,105
2016,5,1,2,30,55,85
2016,5,1,3,10,25,35
2016,5,1,4,23,21,44
2016,5,1,5,26,21,47
2016,5,1,6,30,23,53
2016,5,1,7,52,36,88
2016,5,1,8,121,76,197
2016,5,1,9,110,107,217
2016,5,1,10,163,140,303
2016,5,1,11,171,156,327
2016,5,1,12,172,193,365
2016,5,1,13,182,173,355
2016,5,1,14,173,201,374
2016,5,1,15,178,183,361
2016,5,1,16,156,157,313
2016,5,1,17,145,124,269
2016,5,1,18,125,156,281
2016,5,1,19,86,102,188
2016,5,1,20,62,68,130
2016,5,1,21,34,48,82
2016,5,1,22,21,21,42
2016,5,1,23,9,16,25
2016,5,2,0,8,11,19
2016,5,2,1,5,14,19
2016,5,2,2,6,8,14
2016,5,2,3,21,18,39
2016,5,2,4,140,69,209
2016,5,2,5,261,168,429
2016,5,2,6,380,211,591
2016,5,2,7,291,176,467
2016,5,2,8,259,171,430
2016,5,2,9,200,159,359
2016,5,2,10,207,201,408
2016,5,2,11,218,226,444
2016,5,2,12,237,261,498
2016,5,2,13,270,349,619
2016,5,2,14,261,352,613
2016,5,2,15,229,222,451
2016,5,2,16,204,163,367
2016,5,2,17,128,151,279
2016,5,2,18,120,123,243
2016,5,2,19,90,132,222
2016,5,2,20,77,75,152
2016,5,2,21,32,38,70
2016,5,2,22,20,20,40
2016,5,2,23,10,17,27
2016,5,3,0,3,11,14
2016,5,3,1,11,10,21
2016,5,3,2,9,8,17
2016,5,3,3,14,14,28
2016,5,3,4,137,68,205
2016,5,3,5,260,195,455
2016,5,3,6,439,233,672
2016,5,3,7,288,161,449
2016,5,3,8,197,188,385
2016,5,3,9,236,181,417
2016,5,3,10,228,220,448
2016,5,3,11,228,220,448
2016,5,3,12,257,255,512
2016,5,3,13,258,316,574
2016,5,3,14,248,310,558
2016,5,3,15,235,217,452
2016,5,3,16,197,194,391
2016,5,3,17,140,186,326
2016,5,3,18,132,124,256
2016,5,3,19,98,124,222
2016,5,3,20,69,99,168
2016,5,3,21,48,42,90
2016,5,3,22,24,32,56
2016,5,3,23,14,23,37
2016,5,4,0,18,22,40
2016,5,4,1,10,14,24
2016,5,4,2,10,21,31
2016,5,4,3,18,12,30
2016,5,4,4,140,70,210
2016,5,4,5,253,189,442
2016,5,4,6,395,210,605
2016,5,4,7,266,170,436
2016,5,4,8,247,180,427
2016,5,4,9,228,198,426
2016,5,4,10,260,212,472
2016,5,4,11,243,223,466
2016,5,4,12,235,299,534
2016,5,4,13,282,324,606
2016,5,4,14,255,329,584
2016,5,4,15,209,240,449
2016,5,4,16,196,169,365
2016,5,4,17,144,149,293
2016,5,4,18,133,150,283
2016,5,4,19,89,102,191
2016,5,4,20,64,94,158
2016,5,4,21,43,61,104
2016,5,4,22,33,62,95
2016,5,4,23,15,29,44
2016,5,5,0,17,23,40
2016,5,5,1,16,36,52
2016,5,5,2,15,24,39
2016,5,5,3,11,11,22
2016,5,5,4,17,10,27
2016,5,5,5,27,25,52
2016,5,5,6,49,34,83
2016,5,5,7,84,65,149
2016,5,5,8,100,71,171
2016,5,5,9,117,98,215
2016,5,5,10,149,114,263
2016,5,5,11,175,149,324
2016,5,5,12,160,180,340
2016,5,5,13,134,152,286
2016,5,5,14,144,192,336
2016,5,5,15,147,164,311
2016,5,5,16,153,141,294
2016,5,5,17,123,170,293
2016,5,5,18,147,168,315
2016,5,5,19,81,104,185
2016,5,5,20,76,80,156
2016,5,5,21,42,63,105
2016,5,5,22,23,35,58
2016,5,5,23,11,44,55
2016,5,6,0,7,40,47
2016,5,6,1,7,20,27
2016,5,6,2,10,14,24
2016,5,6,3,17,17,34
2016,5,6,4,87,51,138
2016,5,6,5,150,121,271
2016,5,6,6,216,124,340
2016,5,6,7,202,145,347
2016,5,6,8,215,159,374
2016,5,6,9,206,176,382
2016,5,6,10,226,198,424
2016,5,6,11,226,196,422
2016,5,6,12,243,228,471
2016,5,6,13,209,273,482
2016,5,6,14,180,261,441
2016,5,6,15,163,158,321
2016,5,6,16,125,151,276
2016,5,6,17,128,126,254
2016,5,6,18,86,113,199
2016,5,6,19,75,103,178
2016,5,6,20,60,89,149
2016,5,6,21,42,57,99
2016,5,6,22,35,47,82
2016,5,6,23,20,35,55
2016,5,7,0,20,37,57
2016,5,7,1,14,43,57
2016,5,7,2,12,27,39
2016,5,7,3,16,18,34
2016,5,7,4,24,14,38
2016,5,7,5,41,32,73
2016,5,7,6,48,36,84
2016,5,7,7,74,63,137
2016,5,7,8,115,104,219
2016,5,7,9,124,108,232
2016,5,7,10,151,132,283
2016,5,7,11,140,146,286
2016,5,7,12,160,135,295
2016,5,7,13,118,163,281
2016,5,7,14,145,139,284
2016,5,7,15,137,160,297
2016,5,7,16,116,132,248
2016,5,7,17,93,139,232
2016,5,7,18,84,102,186
2016,5,7,19,84,80,164
2016,5,7,20,95,85,180
2016,5,7,21,52,82,134
2016,5,7,22,38,64,102
2016,5,7,23,31,52,83
2016,5,8,0,25,48,73
2016,5,8,1,23,41,64
2016,5,8,2,24,40,64
2016,5,8,3,14,23,37
2016,5,8,4,19,20,39
2016,5,8,5,22,13,35
2016,5,8,6,36,25,61
2016,5,8,7,58,51,109
2016,5,8,8,113,97,210
2016,5,8,9,137,119,256
2016,5,8,10,136,132,268
2016,5,8,11,137,158,295
2016,5,8,12,175,175,350
2016,5,8,13,155,157,312
2016,5,8,14,151,213,364
2016,5,8,15,183,165,348
2016,5,8,16,134,163,297
2016,5,8,17,162,178,340
2016,5,8,18,130,166,296
2016,5,8,19,136,128,264
2016,5,8,20,79,82,161
2016,5,8,21,44,56,100
2016,5,8,22,20,29,49
2016,5,8,23,12,18,30
2016,5,9,0,8,12,20
2016,5,9,1,9,17,26
2016,5,9,2,8,5,13
2016,5,9,3,13,7,20
2016,5,9,4,143,72,215
2016,5,9,5,266,163,429
2016,5,9,6,366,230,596
2016,5,9,7,291,173,464
2016,5,9,8,229,184,413
2016,5,9,9,218,178,396
2016,5,9,10,219,204,423
2016,5,9,11,200,224,424
2016,5,9,12,214,254,468
2016,5,9,13,232,351,583
2016,5,9,14,225,289,514
2016,5,9,15,212,180,392
2016,5,9,16,171,184,355
2016,5,9,17,128,155,283
2016,5,9,18,129,143,272
2016,5,9,19,96,121,217
2016,5,9,20,103,110,213
2016,5,9,21,55,55,110
2016,5,9,22,25,25,50
2016,5,9,23,17,16,33
2016,5,10,0,11,13,24
2016,5,10,1,15,18,33
2016,5,10,2,11,12,23
2016,5,10,3,21,17,38
2016,5,10,4,127,57,184
2016,5,10,5,259,176,435
2016,5,10,6,351,206,557
2016,5,10,7,275,169,444
2016,5,10,8,221,180,401
2016,5,10,9,213,170,383
2016,5,10,10,231,223,454
2016,5,10,11,226,224,450
2016,5,10,12,223,255,478
2016,5,10,13,265,334,599
2016,5,10,14,236,321,557
2016,5,10,15,196,204,400
2016,5,10,16,198,200,398
2016,5,10,17,135,172,307
2016,5,10,18,136,156,292
2016,5,10,19,110,115,225
2016,5,10,20,79,82,161
2016,5,10,21,45,49,94
2016,5,10,22,16,20,36
2016,5,10,23,8,21,29
2016,5,11,0,8,14,22
2016,5,11,1,6,8,14
2016,5,11,2,6,12,18
2016,5,11,3,14,12,26
2016,5,11,4,122,69,191
2016,5,11,5,255,172,427
2016,5,11,6,337,271,608
2016,5,11,7,275,175,450
2016,5,11,8,246,187,433
2016,5,11,9,229,187,416
2016,5,11,10,203,214,417
2016,5,11,11,220,231,451
2016,5,11,12,232,288,520
2016,5,11,13,279,352,631
2016,5,11,14,225,275,500
2016,5,11,15,195,188,383
2016,5,11,16,198,157,355
2016,5,11,17,146,168,314
2016,5,11,18,122,146,268
2016,5,11,19,119,127,246
2016,5,11,20,72,94,166
2016,5,11,21,40,49,89
2016,5,11,22,16,24,40
2016,5,11,23,9,13,22
2016,5,12,0,5,8,13
2016,5,12,1,8,14,22
2016,5,12,2,7,14,21
2016,5,12,3,20,16,36
2016,5,12,4,124,60,184
2016,5,12,5,241,170,411
2016,5,12,6,358,223,581
2016,5,12,7,283,186,469
2016,5,12,8,251,189,440
2016,5,12,9,225,178,403
2016,5,12,10,230,200,430
2016,5,12,11,214,220,434
2016,5,12,12,255,295,550
2016,5,12,13,282,321,603
2016,5,12,14,257,317,574
2016,5,12,15,206,199,405
2016,5,12,16,189,157,346
2016,5,12,17,161,163,324
2016,5,12,18,139,141,280
2016,5,12,19,131,132,263
2016,5,12,20,74,86,160
2016,5,12,21,49,52,101
2016,5,12,22,22,36,58
2016,5,12,23,15,36,51
2016,5,13,0,20,32,52
2016,5,13,1,15,25,40
2016,5,13,2,10,14,24
2016,5,13,3,15,13,28
2016,5,13,4,144,70,214
2016,5,13,5,241,152,393
2016,5,13,6,373,211,584
2016,5,13,7,273,185,458
2016,5,13,8,235,164,399
2016,5,13,9,269,227,496
2016,5,13,10,278,213,491
2016,5,13,11,277,250,527
2016,5,13,12,269,322,591
2016,5,13,13,291,353,644
2016,5,13,14,218,288,506
2016,5,13,15,176,202,378
2016,5,13,16,157,150,307
2016,5,13,17,154,137,291
2016,5,13,18,112,129,241
2016,5,13,19,95,104,199
2016,5,13,20,69,77,146
2016,5,13,21,50,59,109
2016,5,13,22,58,62,120
2016,5,13,23,25,36,61
2016,5,14,0,24,41,65
2016,5,14,1,22,26,48
2016,5,14,2,12,13,25
2016,5,14,3,12,10,22
2016,5,14,4,33,18,51
2016,5,14,5,34,32,66
2016,5,14,6,41,40,81
2016,5,14,7,59,53,112
2016,5,14,8,129,99,228
2016,5,14,9,147,125,272
2016,5,14,10,176,164,340
2016,5,14,11,171,172,343
2016,5,14,12,169,183,352
2016,5,14,13,112,110,222
2016,5,14,14,156,177,333
2016,5,14,15,117,134,251
2016,5,14,16,136,145,281
2016,5,14,17,115,126,241
2016,5,14,18,90,125,215
2016,5,14,19,87,81,168
2016,5,14,20,53,64,117
2016,5,14,21,37,40,77
2016,5,14,22,55,53,108
2016,5,14,23,44,60,104
2016,5,15,0,33,54,87
2016,5,15,1,19,53,72
2016,5,15,2,22,36,58
2016,5,15,3,14,17,31
2016,5,15,4,19,9,28
2016,5,15,5,16,16,32
2016,5,15,6,26,8,34
2016,5,15,7,35,43,78
2016,5,15,8,89,76,165
2016,5,15,9,119,76,195
2016,5,15,10,134,137,271
2016,5,15,11,147,143,290
2016,5,15,12,150,164,314
2016,5,15,13,154,182,336
2016,5,15,14,126,162,288
2016,5,15,15,162,142,304
2016,5,15,16,158,170,328
2016,5,15,17,127,139,266
2016,5,15,18,110,144,254
2016,5,15,19,97,107,204
2016,5,15,20,65,82,147
2016,5,15,21,47,53,100
2016,5,15,22,32,44,76
2016,5,15,23,18,30,48
2016,5,16,0,18,21,39
2016,5,16,1,18,24,42
2016,5,16,2,14,21,35
2016,5,16,3,4,8,12
2016,5,16,4,20,10,30
2016,5,16,5,18,14,32
2016,5,16,6,35,24,59
2016,5,16,7,66,38,104
2016,5,16,8,80,80,160
2016,5,16,9,118,98,216
2016,5,16,10,126,120,246
2016,5,16,11,149,145,294
2016,5,16,12,183,164,347
2016,5,16,13,187,189,376
2016,5,16,14,172,204,376
2016,5,16,15,189,223,412
2016,5,16,16,168,154,322
2016,5,16,17,157,166,323
2016,5,16,18,222,165,387
2016,5,16,19,142,149,291
2016,5,16,20,73,101,174
2016,5,16,21,84,74,158
2016,5,16,22,39,62,101
2016,5,16,23,34,41,75
2016,5,17,0,28,48,76
2016,5,17,1,23,44,67
2016,5,17,2,28,50,78
2016,5,17,3,18,11,29
2016,5,17,4,58,35,93
2016,5,17,5,88,60,148
2016,5,17,6,147,68,215
2016,5,17,7,294,72,366
2016,5,17,8,503,92,595
2016,5,17,9,288,70,358
2016,5,17,10,159,212,371
2016,5,17,11,149,442,591
2016,5,17,12,133,244,377
2016,5,17,13,122,187,309
2016,5,17,14,127,169,296
2016,5,17,15,139,151,290
2016,5,17,16,126,127,253
2016,5,17,17,106,151,257
2016,5,17,18,121,119,240
2016,5,17,19,85,81,166
2016,5,17,20,98,79,177
2016,5,17,21,49,128,177
2016,5,17,22,45,70,115
2016,5,17,23,32,51,83
2016,5,18,0,22,54,76
2016,5,18,1,21,51,72
2016,5,18,2,12,25,37
2016,5,18,3,19,20,39
2016,5,18,4,132,64,196
2016,5,18,5,222,172,394
2016,5,18,6,355,179,534
2016,5,18,7,247,159,406
2016,5,18,8,226,185,411
2016,5,18,9,233,202,435
2016,5,18,10,220,175,395
2016,5,18,11,217,208,425
2016,5,18,12,223,235,458
2016,5,18,13,242,344,586
2016,5,18,14,235,296,531
2016,5,18,15,200,192,392
2016,5,18,16,172,169,341
2016,5,18,17,150,156,306
2016,5,18,18,136,130,266
2016,5,18,19,109,101,210
2016,5,18,20,88,71,159
2016,5,18,21,47,44,91
2016,5,18,22,23,23,46
2016,5,18,23,11,14,25
2016,5,19,0,9,7,16
2016,5,19,1,9,7,16
2016,5,19,2,10,11,21
2016,5,19,3,19,19,38
2016,5,19,4,109,63,172
2016,5,19,5,238,170,408
2016,5,19,6,353,237,590
2016,5,19,7,295,164,459
2016,5,19,8,194,175,369
2016,5,19,9,263,183,446
2016,5,19,10,223,205,428
2016,5,19,11,252,260,512
2016,5,19,12,236,288,524
2016,5,19,13,305,365,670
2016,5,19,14,240,308,548
2016,5,19,15,204,194,398
2016,5,19,16,186,168,354
2016,5,19,17,128,162,290
2016,5,19,18,128,129,257
2016,5,19,19,87,124,211
2016,5,19,20,83,89,172
2016,5,19,21,45,59,104
2016,5,19,22,18,27,45
2016,5,19,23,12,19,31
2016,5,20,0,8,15,23
2016,5,20,1,9,17,26
2016,5,20,2,6,14,20
2016,5,20,3,21,18,39
2016,5,20,4,132,62,194
2016,5,20,5,247,174,421
2016,5,20,6,356,226,582
2016,5,20,7,266,153,419
2016,5,20,8,263,198,461
2016,5,20,9,220,227,447
2016,5,20,10,222,241,463
2016,5,20,11,233,248,481
2016,5,20,12,291,274,565
2016,5,20,13,285,362,647
2016,5,20,14,220,317,537
2016,5,20,15,182,193,375
2016,5,20,16,144,157,301
2016,5,20,17,145,143,288
2016,5,20,18,115,116,231
2016,5,20,19,93,124,217
2016,5,20,20,62,71,133
2016,5,20,21,47,65,112
2016,5,20,22,27,44,71
2016,5,20,23,8,18,26
2016,5,21,0,21,33,54
2016,5,21,1,17,36,53
2016,5,21,2,9,28,37
2016,5,21,3,5,8,13
2016,5,21,4,32,19,51
2016,5,21,5,40,28,68
2016,5,21,6,48,39,87
2016,5,21,7,79,69,148
2016,5,21,8,100,78,178
2016,5,21,9,161,140,301
2016,5,21,10,176,131,307
2016,5,21,11,202,149,351
2016,5,21,12,156,192,348
2016,5,21,13,194,189,383
2016,5,21,14,134,194,328
2016,5,21,15,143,171,314
2016,5,21,16,147,173,320
2016,5,21,17,124,107,231
2016,5,21,18,100,98,198
2016,5,21,19,66,89,155
2016,5,21,20,59,85,144
2016,5,21,21,42,57,99
2016,5,21,22,46,64,110
2016,5,21,23,40,48,88
2016,5,22,0,19,48,67
2016,5,22,1,28,56,84
2016,5,22,2,22,30,52
2016,5,22,3,6,23,29
2016,5,22,4,17,16,33
2016,5,22,5,26,18,44
2016,5,22,6,31,15,46
2016,5,22,7,42,31,73
2016,5,22,8,124,68,192
2016,5,22,9,125,65,190
2016,5,22,10,145,119,264
2016,5,22,11,202,193,395
2016,5,22,12,184,199,383
2016,5,22,13,168,205,373
2016,5,22,14,146,234,380
2016,5,22,15,175,200,375
2016,5,22,16,110,112,222
2016,5,22,17,131,137,268
2016,5,22,18,138,167,305
2016,5,22,19,90,135,225
2016,5,22,20,74,87,161
2016,5,22,21,41,53,94
2016,5,22,22,18,15,33
2016,5,22,23,15,18,33
2016,5,23,0,5,9,14
2016,5,23,1,8,10,18
2016,5,23,2,5,13,18
2016,5,23,3,20,14,34
2016,5,23,4,151,63,214
2016,5,23,5,255,182,437
2016,5,23,6,417,220,637
2016,5,23,7,287,194,481
2016,5,23,8,218,177,395
2016,5,23,9,240,192,432
2016,5,23,10,252,214,466
2016,5,23,11,218,225,443
2016,5,23,12,210,280,490
2016,5,23,13,289,344,633
2016,5,23,14,219,297,516
2016,5,23,15,171,204,375
2016,5,23,16,174,158,332
2016,5,23,17,150,196,346
2016,5,23,18,134,144,278
2016,5,23,19,99,122,221
2016,5,23,20,95,96,191
2016,5,23,21,42,41,83
2016,5,23,22,15,25,40
2016,5,23,23,10,16,26
2016,5,24,0,9,9,18
2016,5,24,1,11,6,17
2016,5,24,2,6,10,16
2016,5,24,3,22,13,35
2016,5,24,4,131,64,195
2016,5,24,5,283,187,470
2016,5,24,6,417,211,628
2016,5,24,7,267,170,437
2016,5,24,8,236,208,444
2016,5,24,9,211,207,418
2016,5,24,10,221,222,443
2016,5,24,11,201,236,437
2016,5,24,12,212,232,444
2016,5,24,13,265,357,622
2016,5,24,14,222,279,501
2016,5,24,15,183,194,377
2016,5,24,16,159,183,342
2016,5,24,17,168,170,338
2016,5,24,18,110,142,252
2016,5,24,19,108,113,221
2016,5,24,20,96,101,197
2016,5,24,21,44,56,100
2016,5,24,22,20,31,51
2016,5,24,23,20,21,41
2016,5,25,0,6,18,24
2016,5,25,1,10,14,24
2016,5,25,2,5,10,15
2016,5,25,3,19,15,34
2016,5,25,4,129,69,198
2016,5,25,5,260,191,451
2016,5,25,6,367,217,584
2016,5,25,7,246,184,430
2016,5,25,8,233,180,413
2016,5,25,9,231,193,424
2016,5,25,10,238,235,473
2016,5,25,11,214,219,433
2016,5,25,12,222,259,481
2016,5,25,13,288,361,649
2016,5,25,14,236,283,519
2016,5,25,15,200,205,405
2016,5,25,16,176,177,353
2016,5,25,17,164,171,335
2016,5,25,18,152,154,306
2016,5,25,19,111,147,258
2016,5,25,20,94,109,203
2016,5,25,21,44,82,126
2016,5,25,22,21,32,53
2016,5,25,23,14,24,38
2016,5,26,0,15,28,43
2016,5,26,1,16,21,37
2016,5,26,2,8,12,20
2016,5,26,3,17,13,30
2016,5,26,4,133,56,189
2016,5,26,5,237,179,416
2016,5,26,6,364,196,560
2016,5,26,7,265,178,443
2016,5,26,8,198,172,370
2016,5,26,9,221,189,410
2016,5,26,10,235,223,458
2016,5,26,11,234,217,451
2016,5,26,12,200,249,449
2016,5,26,13,281,355,636
2016,5,26,14,241,243,484
2016,5,26,15,191,198,389
2016,5,26,16,172,188,360
2016,5,26,17,158,178,336
2016,5,26,18,141,153,294
2016,5,26,19,115,125,240
2016,5,26,20,81,113,194
2016,5,26,21,47,69,116
2016,5,26,22,22,38,60
2016,5,26,23,15,29,44
2016,5,27,0,7,33,40
2016,5,27,1,15,22,37
2016,5,27,2,9,16,25
2016,5,27,3,20,14,34
2016,5,27,4,131,62,193
2016,5,27,5,244,182,426
2016,5,27,6,356,234,590
2016,5,27,7,271,184,455
2016,5,27,8,244,207,451
2016,5,27,9,247,223,470
2016,5,27,10,205,212,417
2016,5,27,11,247,246,493
2016,5,27,12,256,304,560
2016,5,27,13,311,331,642
2016,5,27,14,212,280,492
2016,5,27,15,174,209,383
2016,5,27,16,143,147,290
2016,5,27,17,139,148,287
2016,5,27,18,118,125,243
2016,5,27,19,92,106,198
2016,5,27,20,90,96,186
2016,5,27,21,42,65,107
2016,5,27,22,52,51,103
2016,5,27,23,25,100,125
2016,5,28,0,19,133,152
2016,5,28,1,18,47,65
2016,5,28,2,13,27,40
2016,5,28,3,7,13,20
2016,5,28,4,31,25,56
2016,5,28,5,32,30,62
2016,5,28,6,40,40,80
2016,5,28,7,65,56,121
2016,5,28,8,139,93,232
2016,5,28,9,146,129,275
2016,5,28,10,170,168,338
2016,5,28,11,181,161,342
2016,5,28,12,210,190,400
2016,5,28,13,148,189,337
2016,5,28,14,132,170,302
2016,5,28,15,151,176,327
2016,5,28,16,127,144,271
2016,5,28,17,126,130,256
2016,5,28,18,96,99,195
2016,5,28,19,76,87,163
2016,5,28,20,50,58,108
2016,5,28,21,57,72,129
2016,5,28,22,44,74,118
2016,5,28,23,47,56,103
2016,5,29,0,30,70,100
2016,5,29,1,27,64,91
2016,5,29,2,22,46,68
2016,5,29,3,14,12,26
2016,5,29,4,32,15,47
2016,5,29,5,30,17,47
2016,5,29,6,54,27,81
2016,5,29,7,54,43,97
2016,5,29,8,84,63,147
2016,5,29,9,130,100,230
2016,5,29,10,139,126,265
2016,5,29,11,165,162,327
2016,5,29,12,162,165,327
2016,5,29,13,159,173,332
2016,5,29,14,165,212,377
2016,5,29,15,179,202,381
2016,5,29,16,176,144,320
2016,5,29,17,152,166,318
2016,5,29,18,177,192,369
2016,5,29,19,115,129,244
2016,5,29,20,74,89,163
2016,5,29,21,44,76,120
2016,5,29,22,24,36,60
2016,5,29,23,9,20,29
2016,5,30,0,6,10,16
2016,5,30,1,4,6,10
2016,5,30,2,6,10,16
2016,5,30,3,12,12,24
2016,5,30,4,136,70,206
2016,5,30,5,244,171,415
2016,5,30,6,368,226,594
2016,5,30,7,282,165,447
2016,5,30,8,254,178,432
2016,5,30,9,224,205,429
2016,5,30,10,243,224,467
2016,5,30,11,233,216,449
2016,5,30,12,242,279,521
2016,5,30,13,274,356,630
2016,5,30,14,242,296,538
2016,5,30,15,221,218,439
2016,5,30,16,175,163,338
2016,5,30,17,133,162,295
2016,5,30,18,143,133,276
2016,5,30,19,92,111,203
2016,5,30,20,60,79,139
2016,5,30,21,30,46,76
2016,5,30,22,22,36,58
2016,5,30,23,8,20,28
2016,5,31,0,7,13,20
2016,5,31,1,13,13,26
2016,5,31,2,6,11,17
2016,5,31,3,20,13,33
2016,5,31,4,147,72,219
2016,5,31,5,242,186,428
2016,5,31,6,425,209,634
2016,5,31,7,279,155,434
2016,5,31,8,229,196,425
2016,5,31,9,245,191,436
2016,5,31,10,252,231,483
2016,5,31,11,208,248,456
2016,5,31,12,257,259,516
2016,5,31,13,258,348,606
2016,5,31,14,238,404,642
2016,5,31,15,192,214,406
2016,5,31,16,164,176,340
2016,5,31,17,139,186,325
2016,5,31,18,129,129,258
2016,5,31,19,117,124,241
2016,5,31,20,81,114,195
2016,5,31,21,58,55,113
2016,5,31,22,26,40,66
2016,5,31,23,16,30,46
2016,6,1,0,9,16,25
2016,6,1,1,11,16,27
2016,6,1,2,7,12,19
2016,6,1,3,19,15,34
2016,6,1,4,125,71,196
2016,6,1,5,239,159,398
2016,6,1,6,368,226,594
2016,6,1,7,297,183,480
2016,6,1,8,269,183,452
2016,6,1,9,215,178,393
2016,6,1,10,217,194,411
2016,6,1,11,227,236,463
2016,6,1,12,247,275,522
2016,6,1,13,252,364,616
2016,6,1,14,232,293,525
2016,6,1,15,222,212,434
2016,6,1,16,199,174,373
2016,6,1,17,152,155,307
2016,6,1,18,127,166,293
2016,6,1,19,95,128,223
2016,6,1,20,63,83,146
2016,6,1,21,46,52,98
2016,6,1,22,25,32,57
2016,6,1,23,11,21,32
2016,6,2,0,7,14,21
2016,6,2,1,9,13,22
2016,6,2,2,8,8,16
2016,6,2,3,18,15,33
2016,6,2,4,130,57,187
2016,6,2,5,233,173,406
2016,6,2,6,427,214,641
2016,6,2,7,311,182,493
2016,6,2,8,244,200,444
2016,6,2,9,232,193,425
2016,6,2,10,253,215,468
2016,6,2,11,215,240,455
2016,6,2,12,237,279,516
2016,6,2,13,263,354,617
2016,6,2,14,243,296,539
2016,6,2,15,226,209,435
2016,6,2,16,185,174,359
2016,6,2,17,147,189,336
2016,6,2,18,131,173,304
2016,6,2,19,102,124,226
2016,6,2,20,90,105,195
2016,6,2,21,39,66,105
2016,6,2,22,30,37,67
2016,6,2,23,18,46,64
2016,6,3,0,18,23,41
2016,6,3,1,12,19,31
2016,6,3,2,11,20,31
2016,6,3,3,26,13,39
2016,6,3,4,117,71,188
2016,6,3,5,235,163,398
2016,6,3,6,334,242,576
2016,6,3,7,242,194,436
2016,6,3,8,246,187,433
2016,6,3,9,249,218,467
2016,6,3,10,233,250,483
2016,6,3,11,218,259,477
2016,6,3,12,250,293,543
2016,6,3,13,288,372,660
2016,6,3,14,203,252,455
2016,6,3,15,176,211,387
2016,6,3,16,132,153,285
2016,6,3,17,151,163,314
2016,6,3,18,124,120,244
2016,6,3,19,110,95,205
2016,6,3,20,105,121,226
2016,6,3,21,61,83,144
2016,6,3,22,69,73,142
2016,6,3,23,37,60,97
2016,6,4,0,26,60,86
2016,6,4,1,31,56,87
2016,6,4,2,21,28,49
2016,6,4,3,27,16,43
2016,6,4,4,42,100,142
2016,6,4,5,38,35,73
2016,6,4,6,59,61,120
2016,6,4,7,67,68,135
2016,6,4,8,111,112,223
2016,6,4,9,147,132,279
2016,6,4,10,157,138,295
2016,6,4,11,151,154,305
2016,6,4,12,143,164,307
2016,6,4,13,159,164,323
2016,6,4,14,137,149,286
2016,6,4,15,141,147,288
2016,6,4,16,167,141,308
2016,6,4,17,119,129,248
2016,6,4,18,101,127,228
2016,6,4,19,88,89,177
2016,6,4,20,93,82,175
2016,6,4,21,68,70,138
2016,6,4,22,56,70,126
2016,6,4,23,30,54,84
2016,6,5,0,30,53,83
2016,6,5,1,31,69,100
2016,6,5,2,22,44,66
2016,6,5,3,11,20,31
2016,6,5,4,13,15,28
2016,6,5,5,21,23,44
2016,6,5,6,48,30,78
2016,6,5,7,46,48,94
2016,6,5,8,111,59,170
2016,6,5,9,163,116,279
2016,6,5,10,155,143,298
2016,6,5,11,158,190,348
2016,6,5,12,175,190,365
2016,6,5,13,145,220,365
2016,6,5,14,159,223,382
2016,6,5,15,172,181,353
2016,6,5,16,162,180,342
2016,6,5,17,198,184,382
2016,6,5,18,144,221,365
2016,6,5,19,141,138,279
2016,6,5,20,94,113,207
2016,6,5,21,49,71,120
2016,6,5,22,27,31,58
2016,6,5,23,10,18,28
2016,6,6,0,10,16,26
2016,6,6,1,6,10,16
2016,6,6,2,10,12,22
2016,6,6,3,16,6,22
2016,6,6,4,138,64,202
2016,6,6,5,233,178,411
2016,6,6,6,405,215,620
2016,6,6,7,286,200,486
2016,6,6,8,245,170,415
2016,6,6,9,244,197,441
2016,6,6,10,208,234,442
2016,6,6,11,221,234,455
2016,6,6,12,238,269,507
2016,6,6,13,261,347,608
2016,6,6,14,242,264,506
2016,6,6,15,186,217,403
2016,6,6,16,183,181,364
2016,6,6,17,169,146,315
2016,6,6,18,130,155,285
2016,6,6,19,103,122,225
2016,6,6,20,69,103,172
2016,6,6,21,44,51,95
2016,6,6,22,27,24,51
2016,6,6,23,12,24,36
2016,6,7,0,6,13,19
2016,6,7,1,8,19,27
2016,6,7,2,8,10,18
2016,6,7,3,23,12,35
2016,6,7,4,141,68,209
2016,6,7,5,249,172,421
2016,6,7,6,358,210,568
2016,6,7,7,283,177,460
2016,6,7,8,244,185,429
2016,6,7,9,222,195,417
2016,6,7,10,223,208,431
2016,6,7,11,236,205,441
2016,6,7,12,260,257,517
2016,6,7,13,271,362,633
2016,6,7,14,197,286,483
2016,6,7,15,192,199,391
2016,6,7,16,169,169,338
2016,6,7,17,137,160,297
2016,6,7,18,135,115,250
2016,6,7,19,108,122,230
2016,6,7,20,69,103,172
2016,6,7,21,39,58,97
2016,6,7,22,21,20,41
2016,6,7,23,17,24,41
2016,6,8,0,14,20,34
2016,6,8,1,11,18,29
2016,6,8,2,6,12,18
2016,6,8,3,15,14,29
2016,6,8,4,136,74,210
2016,6,8,5,245,182,427
2016,6,8,6,360,207,567
2016,6,8,7,273,217,490
2016,6,8,8,222,176,398
2016,6,8,9,219,186,405
2016,6,8,10,240,232,472
2016,6,8,11,231,206,437
2016,6,8,12,247,252,499
2016,6,8,13,283,384,667
2016,6,8,14,237,290,527
2016,6,8,15,200,193,393
2016,6,8,16,168,149,317
2016,6,8,17,138,134,272
2016,6,8,18,139,159,298
2016,6,8,19,98,129,227
2016,6,8,20,77,104,181
2016,6,8,21,48,42,90
2016,6,8,22,44,35,79
2016,6,8,23,17,68,85
2016,6,9,0,16,23,39
2016,6,9,1,11,20,31
2016,6,9,2,7,15,22
2016,6,9,3,14,15,29
2016,6,9,4,146,62,208
2016,6,9,5,213,170,383
2016,6,9,6,385,201,586
2016,6,9,7,270,174,444
2016,6,9,8,241,195,436
2016,6,9,9,242,182,424
2016,6,9,10,239,230,469
2016,6,9,11,250,232,482
2016,6,9,12,244,245,489
2016,6,9,13,242,354,596
2016,6,9,14,227,280,507
2016,6,9,15,204,198,402
2016,6,9,16,143,177,320
2016,6,9,17,164,168,332
2016,6,9,18,126,125,251
2016,6,9,19,109,131,240
2016,6,9,20,77,100,177
2016,6,9,21,54,52,106
2016,6,9,22,26,32,58
2016,6,9,23,11,34,45
2016,6,10,0,24,17,41
2016,6,10,1,13,27,40
2016,6,10,2,10,22,32
2016,6,10,3,24,12,36
2016,6,10,4,128,62,190
2016,6,10,5,211,185,396
2016,6,10,6,361,205,566
2016,6,10,7,276,189,465
2016,6,10,8,241,193,434
2016,6,10,9,228,201,429
2016,6,10,10,244,191,435
2016,6,10,11,266,243,509
2016,6,10,12,267,295,562
2016,6,10,13,269,367,636
2016,6,10,14,214,278,492
2016,6,10,15,178,206,384
2016,6,10,16,151,130,281
2016,6,10,17,126,137,263
2016,6,10,18,133,121,254
2016,6,10,19,94,92,186
2016,6,10,20,76,95,171
2016,6,10,21,63,81,144
2016,6,10,22,36,55,91
2016,6,10,23,32,54,86
2016,6,11,0,33,46,79
2016,6,11,1,28,39,67
2016,6,11,2,21,34,55
2016,6,11,3,8,5,13
2016,6,11,4,29,21,50
2016,6,11,5,37,24,61
2016,6,11,6,49,36,85
2016,6,11,7,68,61,129
2016,6,11,8,165,95,260
2016,6,11,9,166,109,275
2016,6,11,10,178,141,319
2016,6,11,11,191,210,401
2016,6,11,12,168,173,341
2016,6,11,13,162,180,342
2016,6,11,14,148,165,313
2016,6,11,15,135,154,289
2016,6,11,16,108,123,231
2016,6,11,17,108,118,226
2016,6,11,18,85,93,178
2016,6,11,19,60,76,136
2016,6,11,20,61,77,138
2016,6,11,21,54,58,112
2016,6,11,22,55,64,119
2016,6,11,23,31,44,75
2016,6,12,0,28,47,75
2016,6,12,1,28,60,88
2016,6,12,2,15,50,65
2016,6,12,3,22,19,41
2016,6,12,4,26,15,41
2016,6,12,5,16,14,30
2016,6,12,6,32,22,54
2016,6,12,7,56,39,95
2016,6,12,8,78,61,139
2016,6,12,9,120,83,203
2016,6,12,10,153,100,253
2016,6,12,11,128,168,296
2016,6,12,12,170,182,352
2016,6,12,13,165,179,344
2016,6,12,14,155,164,319
2016,6,12,15,164,176,340
2016,6,12,16,145,131,276
2016,6,12,17,183,139,322
2016,6,12,18,138,137,275
2016,6,12,19,98,138,236
2016,6,12,20,66,93,159
2016,6,12,21,52,66,118
2016,6,12,22,30,31,61
2016,6,12,23,16,20,36
2016,6,13,0,10,19,29
2016,6,13,1,9,13,22
2016,6,13,2,8,14,22
2016,6,13,3,18,15,33
2016,6,13,4,151,74,225
2016,6,13,5,244,176,420
2016,6,13,6,391,216,607
2016,6,13,7,273,172,445
2016,6,13,8,246,186,432
2016,6,13,9,235,208,443
2016,6,13,10,247,237,484
2016,6,13,11,244,248,492
2016,6,13,12,227,293,520
2016,6,13,13,261,343,604
2016,6,13,14,232,308,540
2016,6,13,15,178,201,379
2016,6,13,16,153,165,318
2016,6,13,17,125,131,256
2016,6,13,18,101,124,225
2016,6,13,19,85,108,193
2016,6,13,20,78,88,166
2016,6,13,21,77,72,149
2016,6,13,22,34,43,77
2016,6,13,23,25,23,48
2016,6,14,0,12,17,29
2016,6,14,1,12,15,27
2016,6,14,2,10,18,28
2016,6,14,3,22,18,40
2016,6,14,4,153,68,221
2016,6,14,5,247,196,443
2016,6,14,6,389,205,594
2016,6,14,7,292,199,491
2016,6,14,8,227,178,405
2016,6,14,9,244,184,428
2016,6,14,10,251,251,502
2016,6,14,11,238,235,473
2016,6,14,12,234,295,529
2016,6,14,13,300,354,654
2016,6,14,14,223,293,516
2016,6,14,15,186,183,369
2016,6,14,16,156,153,309
2016,6,14,17,154,168,322
2016,6,14,18,139,140,279
2016,6,14,19,109,114,223
2016,6,14,20,67,102,169
2016,6,14,21,50,80,130
2016,6,14,22,23,33,56
2016,6,14,23,14,24,38
2016,6,15,0,11,19,30
2016,6,15,1,7,15,22
2016,6,15,2,9,16,25
2016,6,15,3,22,13,35
2016,6,15,4,141,71,212
2016,6,15,5,248,176,424
2016,6,15,6,366,205,571
2016,6,15,7,259,192,451
2016,6,15,8,227,168,395
2016,6,15,9,224,193,417
2016,6,15,10,259,212,471
2016,6,15,11,240,245,485
2016,6,15,12,259,283,542
2016,6,15,13,305,365,670
2016,6,15,14,214,261,475
2016,6,15,15,216,193,409
2016,6,15,16,171,177,348
2016,6,15,17,129,167,296
2016,6,15,18,117,140,257
2016,6,15,19,96,129,225
2016,6,15,20,73,228,301
2016,6,15,21,49,67,116
2016,6,15,22,23,33,56
2016,6,15,23,28,34,62
2016,6,16,0,21,32,53
2016,6,16,1,9,16,25
2016,6,16,2,9,14,23
2016,6,16,3,23,14,37
2016,6,16,4,136,61,197
2016,6,16,5,232,153,385
2016,6,16,6,337,199,536
2016,6,16,7,280,197,477
2016,6,16,8,288,206,494
2016,6,16,9,229,199,428
2016,6,16,10,248,232,480
2016,6,16,11,231,230,461
2016,6,16,12,246,276,522
2016,6,16,13,282,328,610
2016,6,16,14,214,296,510
2016,6,16,15,174,198,372
2016,6,16,16,175,142,317
2016,6,16,17,120,152,272
2016,6,16,18,128,121,249
2016,6,16,19,106,110,216
2016,6,16,20,82,313,395
2016,6,16,21,56,325,381
2016,6,16,22,44,152,196
2016,6,16,23,14,107,121
2016,6,17,0,21,86,107
2016,6,17,1,12,64,76
2016,6,17,2,13,49,62
2016,6,17,3,26,19,45
2016,6,17,4,135,61,196
2016,6,17,5,236,159,395
2016,6,17,6,353,199,552
2016,6,17,7,263,198,461
2016,6,17,8,232,211,443
2016,6,17,9,262,227,489
2016,6,17,10,261,234,495
2016,6,17,11,215,241,456
2016,6,17,12,257,349,606
2016,6,17,13,252,341,593
2016,6,17,14,193,279,472
2016,6,17,15,126,175,301
2016,6,17,16,160,150,310
2016,6,17,17,125,139,264
2016,6,17,18,103,109,212
2016,6,17,19,60,89,149
2016,6,17,20,54,78,132
2016,6,17,21,52,69,121
2016,6,17,22,39,56,95
2016,6,17,23,37,44,81
2016,6,18,0,23,34,57
2016,6,18,1,22,43,65
2016,6,18,2,18,34,52
2016,6,18,3,12,16,28
2016,6,18,4,29,21,50
2016,6,18,5,40,24,64
2016,6,18,6,49,31,80
2016,6,18,7,75,53,128
2016,6,18,8,114,80,194
2016,6,18,9,166,128,294
2016,6,18,10,179,121,300
2016,6,18,11,165,162,327
2016,6,18,12,171,172,343
2016,6,18,13,142,133,275
2016,6,18,14,177,157,334
2016,6,18,15,126,150,276
2016,6,18,16,124,128,252
2016,6,18,17,101,114,215
2016,6,18,18,95,81,176
2016,6,18,19,77,96,173
2016,6,18,20,49,68,117
2016,6,18,21,61,67,128
2016,6,18,22,49,63,112
2016,6,18,23,38,56,94
2016,6,19,0,48,54,102
2016,6,19,1,31,57,88
2016,6,19,2,18,36,54
2016,6,19,3,17,33,50
2016,6,19,4,16,14,30
2016,6,19,5,22,14,36
2016,6,19,6,31,17,48
2016,6,19,7,47,52,99
2016,6,19,8,94,58,152
2016,6,19,9,126,92,218
2016,6,19,10,152,133,285
2016,6,19,11,152,164,316
2016,6,19,12,169,182,351
2016,6,19,13,186,183,369
2016,6,19,14,136,202,338
2016,6,19,15,154,165,319
2016,6,19,16,172,173,345
2016,6,19,17,153,130,283
2016,6,19,18,149,156,305
2016,6,19,19,97,137,234
2016,6,19,20,72,91,163
2016,6,19,21,56,72,128
2016,6,19,22,35,44,79
2016,6,19,23,15,29,44
2016,6,20,0,7,15,22
2016,6,20,1,6,14,20
2016,6,20,2,10,16,26
2016,6,20,3,17,14,31
2016,6,20,4,152,65,217
2016,6,20,5,256,190,446
2016,6,20,6,363,205,568
2016,6,20,7,307,192,499
2016,6,20,8,244,175,419
2016,6,20,9,243,184,427
2016,6,20,10,230,213,443
2016,6,20,11,248,230,478
2016,6,20,12,267,295,562
2016,6,20,13,288,362,650
2016,6,20,14,298,300,598
2016,6,20,15,201,200,401
2016,6,20,16,175,176,351
2016,6,20,17,142,149,291
2016,6,20,18,138,121,259
2016,6,20,19,82,86,168
2016,6,20,20,49,216,265
2016,6,20,21,46,192,238
2016,6,20,22,26,71,97
2016,6,20,23,24,48,72
2016,6,21,0,12,28,40
2016,6,21,1,6,22,28
2016,6,21,2,11,33,44
2016,6,21,3,20,33,53
2016,6,21,4,155,71,226
2016,6,21,5,239,171,410
2016,6,21,6,355,190,545
2016,6,21,7,318,198,516
2016,6,21,8,245,191,436
2016,6,21,9,225,203,428
2016,6,21,10,249,199,448
2016,6,21,11,244,222,466
2016,6,21,12,231,290,521
2016,6,21,13,277,322,599
2016,6,21,14,246,266,512
2016,6,21,15,178,187,365
2016,6,21,16,168,169,337
2016,6,21,17,121,152,273
2016,6,21,18,129,130,259
2016,6,21,19,107,115,222
2016,6,21,20,88,83,171
2016,6,21,21,74,59,133
2016,6,21,22,39,35,74
2016,6,21,23,26,28,54
2016,6,22,0,17,44,61
2016,6,22,1,10,26,36
2016,6,22,2,9,16,25
2016,6,22,3,25,20,45
2016,6,22,4,136,63,199
2016,6,22,5,226,149,375
2016,6,22,6,326,163,489
2016,6,22,7,278,170,448
2016,6,22,8,251,183,434
2016,6,22,9,227,177,404
2016,6,22,10,237,227,464
2016,6,22,11,262,192,454
2016,6,22,12,274,284,558
2016,6,22,13,223,328,551
2016,6,22,14,219,248,467
2016,6,22,15,197,188,385
2016,6,22,16,199,167,366
2016,6,22,17,145,163,308
2016,6,22,18,137,135,272
2016,6,22,19,107,103,210
2016,6,22,20,78,75,153
2016,6,22,21,53,71,124
2016,6,22,22,28,32,60
2016,6,22,23,17,35,52
2016,6,23,0,14,26,40
2016,6,23,1,13,23,36
2016,6,23,2,5,17,22
2016,6,23,3,16,14,30
2016,6,23,4,137,58,195
2016,6,23,5,205,165,370
2016,6,23,6,327,184,511
2016,6,23,7,280,158,438
2016,6,23,8,215,166,381
2016,6,23,9,228,195,423
2016,6,23,10,236,195,431
2016,6,23,11,273,217,490
2016,6,23,12,239,238,477
2016,6,23,13,251,361,612
2016,6,23,14,200,275,475
2016,6,23,15,198,168,366
2016,6,23,16,170,150,320
2016,6,23,17,119,134,253
2016,6,23,18,112,119,231
2016,6,23,19,107,111,218
2016,6,23,20,90,89,179
2016,6,23,21,79,62,141
2016,6,23,22,34,31,65
2016,6,23,23,29,30,59
2016,6,24,0,20,21,41
2016,6,24,1,11,19,30
2016,6,24,2,9,21,30
2016,6,24,3,22,12,34
2016,6,24,4,130,57,187
2016,6,24,5,213,142,355
2016,6,24,6,326,169,495
2016,6,24,7,263,160,423
2016,6,24,8,223,170,393
2016,6,24,9,256,200,456
2016,6,24,10,237,202,439
2016,6,24,11,246,239,485
2016,6,24,12,231,269,500
2016,6,24,13,301,352,653
2016,6,24,14,249,282,531
2016,6,24,15,201,171,372
2016,6,24,16,186,151,337
2016,6,24,17,115,124,239
2016,6,24,18,97,111,208
2016,6,24,19,79,88,167
2016,6,24,20,65,96,161
2016,6,24,21,52,87,139
2016,6,24,22,52,62,114
2016,6,24,23,25,43,68
2016,6,25,0,19,30,49
2016,6,25,1,24,33,57
2016,6,25,2,13,28,41
2016,6,25,3,14,16,30
2016,6,25,4,21,14,35
2016,6,25,5,44,27,71
2016,6,25,6,46,47,93
2016,6,25,7,69,58,127
2016,6,25,8,131,75,206
2016,6,25,9,171,140,311
2016,6,25,10,181,148,329
2016,6,25,11,227,174,401
2016,6,25,12,194,204,398
2016,6,25,13,151,167,318
2016,6,25,14,114,156,270
2016,6,25,15,130,126,256
2016,6,25,16,136,135,271
2016,6,25,17,92,108,200
2016,6,25,18,90,93,183
2016,6,25,19,60,84,144
2016,6,25,20,45,53,98
2016,6,25,21,52,58,110
2016,6,25,22,42,73,115
2016,6,25,23,26,60,86
2016,6,26,0,41,42,83
2016,6,26,1,34,60,94
2016,6,26,2,13,28,41
2016,6,26,3,12,7,19
2016,6,26,4,11,10,21
2016,6,26,5,18,17,35
2016,6,26,6,37,17,54
2016,6,26,7,37,32,69
2016,6,26,8,86,58,144
2016,6,26,9,111,81,192
2016,6,26,10,164,129,293
2016,6,26,11,149,161,310
2016,6,26,12,204,180,384
2016,6,26,13,146,186,332
2016,6,26,14,129,174,303
2016,6,26,15,157,165,322
2016,6,26,16,150,144,294
2016,6,26,17,140,148,288
2016,6,26,18,127,148,275
2016,6,26,19,88,122,210
2016,6,26,20,39,71,110
2016,6,26,21,51,55,106
2016,6,26,22,38,32,70
2016,6,26,23,20,15,35
2016,6,27,0,8,12,20
2016,6,27,1,5,11,16
2016,6,27,2,2,14,16
2016,6,27,3,16,14,30
2016,6,27,4,142,58,200
2016,6,27,5,226,158,384
2016,6,27,6,297,177,474
2016,6,27,7,307,174,481
2016,6,27,8,220,175,395
2016,6,27,9,232,160,392
2016,6,27,10,211,192,403
2016,6,27,11,240,208,448
2016,6,27,12,233,261,494
2016,6,27,13,256,320,576
2016,6,27,14,198,255,453
2016,6,27,15,166,191,357
2016,6,27,16,133,142,275
2016,6,27,17,116,114,230
2016,6,27,18,111,106,217
2016,6,27,19,69,79,148
2016,6,27,20,60,64,124
2016,6,27,21,42,59,101
2016,6,27,22,45,38,83
2016,6,27,23,17,21,38
2016,6,28,0,18,19,37
2016,6,28,1,5,13,18
2016,6,28,2,8,10,18
2016,6,28,3,13,10,23
2016,6,28,4,134,60,194
2016,6,28,5,206,146,352
2016,6,28,6,316,172,488
2016,6,28,7,254,170,424
2016,6,28,8,253,179,432
2016,6,28,9,224,192,416
2016,6,28,10,231,181,412
2016,6,28,11,245,239,484
2016,6,28,12,255,245,500
2016,6,28,13,291,339,630
2016,6,28,14,259,429,688
2016,6,28,15,173,197,370
2016,6,28,16,174,147,321
2016,6,28,17,157,146,303
2016,6,28,18,146,127,273
2016,6,28,19,119,114,233
2016,6,28,20,73,89,162
2016,6,28,21,35,45,80
2016,6,28,22,22,24,46
2016,6,28,23,18,30,48
2016,6,29,0,14,16,30
2016,6,29,1,7,9,16
2016,6,29,2,14,19,33
2016,6,29,3,16,9,25
2016,6,29,4,128,65,193
2016,6,29,5,209,148,357
2016,6,29,6,316,156,472
2016,6,29,7,236,180,416
2016,6,29,8,256,185,441
2016,6,29,9,216,163,379
2016,6,29,10,263,239,502
2016,6,29,11,231,210,441
2016,6,29,12,222,260,482
2016,6,29,13,236,281,517
2016,6,29,14,210,262,472
2016,6,29,15,203,213,416
2016,6,29,16,165,154,319
2016,6,29,17,132,119,251
2016,6,29,18,123,110,233
2016,6,29,19,88,104,192
2016,6,29,20,68,67,135
2016,6,29,21,43,56,99
2016,6,29,22,32,28,60
2016,6,29,23,23,30,53
2016,6,30,0,11,22,33
2016,6,30,1,5,12,17
2016,6,30,2,9,19,28
2016,6,30,3,16,12,28
2016,6,30,4,123,63,186
2016,6,30,5,217,152,369
2016,6,30,6,317,177,494
2016,6,30,7,292,162,454
2016,6,30,8,232,162,394
2016,6,30,9,243,209,452
2016,6,30,10,222,176,398
2016,6,30,11,245,219,464
2016,6,30,12,234,271,505
2016,6,30,13,277,329,606
2016,6,30,14,227,287,514
2016,6,30,15,204,226,430
2016,6,30,16,172,185,357
2016,6,30,17,145,140,285
2016,6,30,18,163,131,294
2016,6,30,19,102,102,204
2016,6,30,20,55,79,134
2016,6,30,21,42,72,114
2016,6,30,22,40,56,96
2016,6,30,23,24,36,60
2016,7,1,0,10,17,27
2016,7,1,1,11,14,25
2016,7,1,2,7,18,25
2016,7,1,3,15,15,30
2016,7,1,4,132,59,191
2016,7,1,5,189,115,304
2016,7,1,6,268,161,429
2016,7,1,7,268,157,425
2016,7,1,8,235,180,415
2016,7,1,9,234,216,450
2016,7,1,10,247,220,467
2016,7,1,11,252,233,485
2016,7,1,12,245,271,516
2016,7,1,13,252,316,568
2016,7,1,14,180,225,405
2016,7,1,15,152,182,334
2016,7,1,16,117,148,265
2016,7,1,17,113,107,220
2016,7,1,18,96,106,202
2016,7,1,19,73,68,141
2016,7,1,20,51,55,106
2016,7,1,21,43,49,92
2016,7,1,22,35,41,76
2016,7,1,23,30,31,61
2016,7,2,0,18,24,42
2016,7,2,1,14,25,39
2016,7,2,2,15,27,42
2016,7,2,3,11,18,29
2016,7,2,4,27,24,51
2016,7,2,5,46,26,72
2016,7,2,6,42,30,72
2016,7,2,7,61,54,115
2016,7,2,8,102,86,188
2016,7,2,9,179,101,280
2016,7,2,10,148,119,267
2016,7,2,11,155,156,311
2016,7,2,12,161,184,345
2016,7,2,13,139,171,310
2016,7,2,14,133,140,273
2016,7,2,15,113,146,259
2016,7,2,16,116,126,242
2016,7,2,17,93,100,193
2016,7,2,18,100,92,192
2016,7,2,19,65,72,137
2016,7,2,20,44,53,97
2016,7,2,21,36,46,82
2016,7,2,22,59,64,123
2016,7,2,23,30,54,84
2016,7,3,0,38,47,85
2016,7,3,1,19,41,60
2016,7,3,2,10,30,40
2016,7,3,3,15,18,33
2016,7,3,4,17,14,31
2016,7,3,5,22,19,41
2016,7,3,6,26,20,46
2016,7,3,7,30,34,64
2016,7,3,8,69,42,111
2016,7,3,9,94,73,167
2016,7,3,10,132,102,234
2016,7,3,11,135,134,269
2016,7,3,12,178,148,326
2016,7,3,13,174,199,373
2016,7,3,14,132,180,312
2016,7,3,15,153,135,288
2016,7,3,16,123,128,251
2016,7,3,17,142,120,262
2016,7,3,18,132,145,277
2016,7,3,19,69,97,166
2016,7,3,20,64,65,129
2016,7,3,21,45,63,108
2016,7,3,22,32,37,69
2016,7,3,23,20,22,42
2016,7,4,0,11,15,26
2016,7,4,1,6,12,18
2016,7,4,2,5,14,19
2016,7,4,3,17,11,28
2016,7,4,4,129,52,181
2016,7,4,5,192,135,327
2016,7,4,6,233,141,374
2016,7,4,7,239,144,383
2016,7,4,8,195,152,347
2016,7,4,9,236,165,401
2016,7,4,10,208,190,398
2016,7,4,11,208,187,395
2016,7,4,12,232,214,446
2016,7,4,13,237,291,528
2016,7,4,14,177,248,425
2016,7,4,15,174,157,331
2016,7,4,16,135,124,259
2016,7,4,17,96,141,237
2016,7,4,18,118,88,206
2016,7,4,19,85,92,177
2016,7,4,20,67,86,153
2016,7,4,21,43,47,90
2016,7,4,22,34,28,62
2016,7,4,23,21,23,44
2016,7,5,0,13,11,24
2016,7,5,1,10,21,31
2016,7,5,2,6,11,17
2016,7,5,3,15,15,30
2016,7,5,4,111,50,161
2016,7,5,5,176,128,304
2016,7,5,6,241,138,379
2016,7,5,7,233,138,371
2016,7,5,8,211,146,357
2016,7,5,9,226,180,406
2016,7,5,10,212,202,414
2016,7,5,11,234,202,436
2016,7,5,12,198,239,437
2016,7,5,13,225,261,486
2016,7,5,14,190,222,412
2016,7,5,15,150,152,302
2016,7,5,16,156,131,287
2016,7,5,17,114,131,245
2016,7,5,18,108,111,219
2016,7,5,19,106,94,200
2016,7,5,20,55,86,141
2016,7,5,21,41,68,109
2016,7,5,22,32,32,64
2016,7,5,23,24,27,51
2016,7,6,0,16,18,34
2016,7,6,1,11,21,32
2016,7,6,2,2,10,12
2016,7,6,3,16,14,30
2016,7,6,4,110,49,159
2016,7,6,5,181,121,302
2016,7,6,6,246,152,398
2016,7,6,7,225,132,357
2016,7,6,8,216,156,372
2016,7,6,9,236,204,440
2016,7,6,10,210,186,396
2016,7,6,11,241,217,458
2016,7,6,12,207,243,450
2016,7,6,13,216,270,486
2016,7,6,14,180,198,378
2016,7,6,15,169,167,336
2016,7,6,16,160,155,315
2016,7,6,17,117,127,244
2016,7,6,18,105,88,193
2016,7,6,19,74,81,155
2016,7,6,20,54,62,116
2016,7,6,21,58,62,120
2016,7,6,22,36,33,69
2016,7,6,23,22,20,42
2016,7,7,0,12,26,38
2016,7,7,1,3,16,19
2016,7,7,2,2,18,20
2016,7,7,3,14,9,23
2016,7,7,4,120,53,173
2016,7,7,5,172,117,289
2016,7,7,6,211,132,343
2016,7,7,7,223,133,356
2016,7,7,8,195,164,359
2016,7,7,9,198,169,367
2016,7,7,10,220,178,398
2016,7,7,11,202,158,360
2016,7,7,12,195,228,423
2016,7,7,13,215,236,451
2016,7,7,14,183,217,400
2016,7,7,15,153,157,310
2016,7,7,16,142,125,267
2016,7,7,17,121,124,245
2016,7,7,18,105,105,210
2016,7,7,19,68,69,137
2016,7,7,20,44,49,93
2016,7,7,21,43,71,114
2016,7,7,22,23,32,55
2016,7,7,23,12,25,37
2016,7,8,0,11,23,34
2016,7,8,1,7,19,26
2016,7,8,2,8,14,22
2016,7,8,3,15,8,23
2016,7,8,4,104,44,148
2016,7,8,5,164,124,288
2016,7,8,6,211,131,342
2016,7,8,7,177,128,305
2016,7,8,8,178,145,323
2016,7,8,9,204,160,364
2016,7,8,10,224,195,419
2016,7,8,11,182,195,377
2016,7,8,12,196,225,421
2016,7,8,13,199,257,456
2016,7,8,14,176,180,356
2016,7,8,15,137,137,274
2016,7,8,16,111,124,235
2016,7,8,17,97,99,196
2016,7,8,18,83,78,161
2016,7,8,19,76,88,164
2016,7,8,20,58,56,114
2016,7,8,21,36,47,83
2016,7,8,22,33,44,77
2016,7,8,23,17,29,46
2016,7,9,0,15,28,43
2016,7,9,1,11,31,42
2016,7,9,2,8,23,31
2016,7,9,3,15,11,26
2016,7,9,4,16,14,30
2016,7,9,5,28,29,57
2016,7,9,6,39,30,69
2016,7,9,7,51,39,90
2016,7,9,8,107,65,172
2016,7,9,9,127,88,215
2016,7,9,10,126,104,230
2016,7,9,11,123,114,237
2016,7,9,12,136,138,274
2016,7,9,13,115,154,269
2016,7,9,14,101,137,238
2016,7,9,15,127,138,265
2016,7,9,16,99,83,182
2016,7,9,17,85,78,163
2016,7,9,18,95,81,176
2016,7,9,19,57,80,137
2016,7,9,20,57,57,114
2016,7,9,21,38,56,94
2016,7,9,22,33,42,75
2016,7,9,23,26,48,74
2016,7,10,0,24,46,70
2016,7,10,1,26,42,68
2016,7,10,2,15,35,50
2016,7,10,3,23,12,35
2016,7,10,4,16,17,33
2016,7,10,5,17,21,38
2016,7,10,6,28,17,45
2016,7,10,7,26,31,57
2016,7,10,8,62,43,105
2016,7,10,9,87,69,156
2016,7,10,10,106,89,195
2016,7,10,11,123,110,233
2016,7,10,12,139,156,295
2016,7,10,13,131,131,262
2016,7,10,14,111,144,255
2016,7,10,15,115,137,252
2016,7,10,16,135,114,249
2016,7,10,17,123,133,256
2016,7,10,18,132,132,264
2016,7,10,19,62,54,116
2016,7,10,20,56,53,109
2016,7,10,21,42,51,93
2016,7,10,22,36,52,88
2016,7,10,23,15,26,41
2016,7,11,0,9,18,27
2016,7,11,1,9,14,23
2016,7,11,2,6,11,17
2016,7,11,3,11,13,24
2016,7,11,4,85,39,124
2016,7,11,5,137,105,242
2016,7,11,6,175,95,270
2016,7,11,7,161,120,281
2016,7,11,8,166,133,299
2016,7,11,9,193,149,342
2016,7,11,10,204,170,374
2016,7,11,11,211,218,429
2016,7,11,12,213,214,427
2016,7,11,13,186,248,434
2016,7,11,14,151,181,332
2016,7,11,15,131,144,275
2016,7,11,16,128,117,245
2016,7,11,17,117,106,223
2016,7,11,18,83,89,172
2016,7,11,19,59,69,128
2016,7,11,20,67,70,137
2016,7,11,21,34,45,79
2016,7,11,22,31,25,56
2016,7,11,23,23,16,39
2016,7,12,0,8,15,23
2016,7,12,1,6,11,17
2016,7,12,2,8,9,17
2016,7,12,3,15,9,24
2016,7,12,4,89,37,126
2016,7,12,5,127,85,212
2016,7,12,6,170,123,293
2016,7,12,7,163,120,283
2016,7,12,8,190,134,324
2016,7,12,9,206,146,352
2016,7,12,10,189,144,333
2016,7,12,11,199,207,406
2016,7,12,12,213,223,436
2016,7,12,13,171,250,421
2016,7,12,14,137,187,324
2016,7,12,15,149,149,298
2016,7,12,16,163,123,286
2016,7,12,17,110,111,221
2016,7,12,18,92,102,194
2016,7,12,19,68,81,149
2016,7,12,20,54,68,122
2016,7,12,21,33,38,71
2016,7,12,22,14,27,41
2016,7,12,23,15,20,35
2016,7,13,0,10,18,28
2016,7,13,1,9,15,24
2016,7,13,2,9,12,21
2016,7,13,3,14,14,28
2016,7,13,4,74,38,112
2016,7,13,5,125,83,208
2016,7,13,6,140,96,236
2016,7,13,7,160,113,273
2016,7,13,8,132,115,247
2016,7,13,9,198,121,319
2016,7,13,10,186,133,319
2016,7,13,11,186,158,344
2016,7,13,12,200,212,412
2016,7,13,13,177,203,380
2016,7,13,14,156,184,340
2016,7,13,15,146,154,300
2016,7,13,16,144,111,255
2016,7,13,17,100,110,210
2016,7,13,18,99,144,243
2016,7,13,19,83,100,183
2016,7,13,20,50,65,115
2016,7,13,21,40,40,80
2016,7,13,22,27,28,55
2016,7,13,23,19,24,43
2016,7,14,0,10,24,34
2016,7,14,1,9,18,27
2016,7,14,2,5,11,16
2016,7,14,3,7,12,19
2016,7,14,4,83,21,104
2016,7,14,5,135,99,234
2016,7,14,6,139,97,236
2016,7,14,7,129,104,233
2016,7,14,8,150,118,268
2016,7,14,9,144,127,271
2016,7,14,10,198,163,361
2016,7,14,11,214,178,392
2016,7,14,12,184,203,387
2016,7,14,13,182,227,409
2016,7,14,14,143,193,336
2016,7,14,15,137,145,282
2016,7,14,16,107,121,228
2016,7,14,17,112,108,220
2016,7,14,18,103,89,192
2016,7,14,19,71,71,142
2016,7,14,20,46,61,107
2016,7,14,21,49,51,100
2016,7,14,22,21,31,52
2016,7,14,23,23,22,45
2016,7,15,0,16,8,24
2016,7,15,1,12,15,27
2016,7,15,2,18,12,30
2016,7,15,3,13,20,33
2016,7,15,4,69,32,101
2016,7,15,5,115,78,193
2016,7,15,6,161,82,243
2016,7,15,7,141,94,235
2016,7,15,8,174,136,310
2016,7,15,9,183,130,313
2016,7,15,10,201,163,364
2016,7,15,11,184,168,352
2016,7,15,12,179,183,362
2016,7,15,13,200,213,413
2016,7,15,14,154,169,323
2016,7,15,15,147,146,293
2016,7,15,16,115,139,254
2016,7,15,17,105,109,214
2016,7,15,18,91,102,193
2016,7,15,19,81,74,155
2016,7,15,20,62,71,133
2016,7,15,21,45,61,106
2016,7,15,22,38,36,74
2016,7,15,23,26,29,55
2016,7,16,0,25,38,63
2016,7,16,1,7,41,48
2016,7,16,2,6,16,22
2016,7,16,3,12,9,21
2016,7,16,4,8,12,20
2016,7,16,5,38,22,60
2016,7,16,6,40,42,82
2016,7,16,7,44,31,75
2016,7,16,8,82,79,161
2016,7,16,9,125,72,197
2016,7,16,10,139,90,229
2016,7,16,11,126,140,266
2016,7,16,12,137,145,282
2016,7,16,13,106,135,241
2016,7,16,14,118,120,238
2016,7,16,15,114,99,213
2016,7,16,16,103,87,190
2016,7,16,17,96,90,186
2016,7,16,18,76,67,143
2016,7,16,19,56,66,122
2016,7,16,20,51,62,113
2016,7,16,21,47,50,97
2016,7,16,22,49,42,91
2016,7,16,23,14,36,50
2016,7,17,0,24,41,65
2016,7,17,1,35,45,80
2016,7,17,2,16,23,39
2016,7,17,3,10,14,24
2016,7,17,4,15,15,30
2016,7,17,5,24,19,43
2016,7,17,6,20,10,30
2016,7,17,7,40,28,68
2016,7,17,8,44,40,84
2016,7,17,9,110,69,179
2016,7,17,10,117,91,208
2016,7,17,11,116,106,222
2016,7,17,12,154,136,290
2016,7,17,13,127,154,281
2016,7,17,14,121,171,292
2016,7,17,15,131,130,261
2016,7,17,16,112,135,247
2016,7,17,17,121,110,231
2016,7,17,18,100,128,228
2016,7,17,19,79,90,169
2016,7,17,20,49,71,120
2016,7,17,21,33,49,82
2016,7,17,22,26,31,57
2016,7,17,23,17,27,44
2016,7,18,0,11,14,25
2016,7,18,1,2,15,17
2016,7,18,2,7,13,20
2016,7,18,3,10,13,23
2016,7,18,4,74,38,112
2016,7,18,5,109,83,192
2016,7,18,6,144,91,235
2016,7,18,7,137,104,241
2016,7,18,8,136,103,239
2016,7,18,9,184,117,301
2016,7,18,10,157,119,276
2016,7,18,11,160,135,295
2016,7,18,12,176,173,349
2016,7,18,13,178,224,402
2016,7,18,14,136,175,311
2016,7,18,15,130,143,273
2016,7,18,16,133,118,251
2016,7,18,17,106,115,221
2016,7,18,18,105,96,201
2016,7,18,19,72,101,173
2016,7,18,20,71,74,145
2016,7,18,21,47,50,97
2016,7,18,22,31,34,65
2016,7,18,23,18,24,42
2016,7,19,0,15,14,29
2016,7,19,1,6,9,15
2016,7,19,2,6,7,13
2016,7,19,3,12,6,18
2016,7,19,4,62,33,95
2016,7,19,5,103,79,182
2016,7,19,6,129,82,211
2016,7,19,7,144,107,251
2016,7,19,8,152,119,271
2016,7,19,9,151,122,273
2016,7,19,10,197,159,356
2016,7,19,11,172,148,320
2016,7,19,12,174,190,364
2016,7,19,13,198,201,399
2016,7,19,14,158,189,347
2016,7,19,15,149,163,312
2016,7,19,16,121,136,257
2016,7,19,17,109,118,227
2016,7,19,18,79,97,176
2016,7,19,19,83,91,174
2016,7,19,20,65,70,135
2016,7,19,21,40,43,83
2016,7,19,22,26,32,58
2016,7,19,23,18,18,36
2016,7,20,0,9,17,26
2016,7,20,1,8,20,28
2016,7,20,2,9,12,21
2016,7,20,3,13,12,25
2016,7,20,4,58,33,91
2016,7,20,5,113,96,209
2016,7,20,6,133,85,218
2016,7,20,7,123,104,227
2016,7,20,8,138,131,269
2016,7,20,9,142,136,278
2016,7,20,10,192,140,332
2016,7,20,11,159,153,312
2016,7,20,12,160,197,357
2016,7,20,13,168,201,369
2016,7,20,14,141,156,297
2016,7,20,15,131,127,258
2016,7,20,16,107,110,217
2016,7,20,17,105,105,210
2016,7,20,18,97,86,183
2016,7,20,19,94,97,191
2016,7,20,20,66,85,151
2016,7,20,21,59,51,110
2016,7,20,22,27,33,60
2016,7,20,23,26,25,51
2016,7,21,0,12,20,32
2016,7,21,1,12,11,23
2016,7,21,2,9,19,28
2016,7,21,3,15,15,30
2016,7,21,4,61,36,97
2016,7,21,5,99,77,176
2016,7,21,6,119,74,193
2016,7,21,7,134,89,223
2016,7,21,8,144,113,257
2016,7,21,9,164,115,279
2016,7,21,10,162,134,296
2016,7,21,11,164,139,303
2016,7,21,12,166,180,346
2016,7,21,13,150,185,335
2016,7,21,14,155,165,320
2016,7,21,15,129,147,276
2016,7,21,16,149,133,282
2016,7,21,17,110,116,226
2016,7,21,18,89,105,194
2016,7,21,19,67,71,138
2016,7,21,20,58,54,112
2016,7,21,21,35,57,92
2016,7,21,22,23,29,52
2016,7,21,23,24,25,49
2016,7,22,0,16,25,41
2016,7,22,1,5,25,30
2016,7,22,2,7,10,17
2016,7,22,3,12,11,23
2016,7,22,4,78,39,117
2016,7,22,5,114,87,201
2016,7,22,6,126,87,213
2016,7,22,7,123,105,228
2016,7,22,8,136,115,251
2016,7,22,9,161,120,281
2016,7,22,10,180,136,316
2016,7,22,11,168,170,338
2016,7,22,12,194,178,372
2016,7,22,13,179,216,395
2016,7,22,14,147,187,334
2016,7,22,15,121,142,263
2016,7,22,16,124,141,265
2016,7,22,17,96,96,192
2016,7,22,18,82,72,154
2016,7,22,19,111,91,202
2016,7,22,20,54,64,118
2016,7,22,21,53,70,123
2016,7,22,22,38,56,94
2016,7,22,23,24,36,60
2016,7,23,0,10,20,30
2016,7,23,1,10,34,44
2016,7,23,2,10,22,32
2016,7,23,3,15,13,28
2016,7,23,4,19,16,35
2016,7,23,5,32,19,51
2016,7,23,6,29,26,55
2016,7,23,7,55,48,103
2016,7,23,8,80,68,148
2016,7,23,9,127,87,214
2016,7,23,10,100,97,197
2016,7,23,11,118,119,237
2016,7,23,12,131,129,260
2016,7,23,13,83,128,211
2016,7,23,14,113,107,220
2016,7,23,15,110,99,209
2016,7,23,16,103,113,216
2016,7,23,17,77,94,171
2016,7,23,18,71,79,150
2016,7,23,19,64,71,135
2016,7,23,20,63,61,124
2016,7,23,21,37,51,88
2016,7,23,22,46,57,103
2016,7,23,23,27,32,59
2016,7,24,0,19,45,64
2016,7,24,1,14,43,57
2016,7,24,2,18,21,39
2016,7,24,3,12,23,35
2016,7,24,4,22,14,36
2016,7,24,5,18,22,40
2016,7,24,6,28,17,45
2016,7,24,7,29,29,58
2016,7,24,8,56,41,97
2016,7,24,9,80,83,163
2016,7,24,10,116,100,216
2016,7,24,11,110,113,223
2016,7,24,12,115,129,244
2016,7,24,13,114,110,224
2016,7,24,14,103,128,231
2016,7,24,15,281,114,395
2016,7,24,16,97,122,219
2016,7,24,17,112,148,260
2016,7,24,18,92,115,207
2016,7,24,19,120,116,236
2016,7,24,20,63,85,148
2016,7,24,21,38,52,90
2016,7,24,22,27,42,69
2016,7,24,23,16,24,40
2016,7,25,0,10,24,34
2016,7,25,1,11,9,20
2016,7,25,2,2,10,12
2016,7,25,3,12,11,23
2016,7,25,4,55,44,99
2016,7,25,5,106,87,193
2016,7,25,6,114,89,203
2016,7,25,7,142,95,237
2016,7,25,8,132,122,254
2016,7,25,9,162,139,301
2016,7,25,10,184,151,335
2016,7,25,11,172,150,322
2016,7,25,12,185,177,362
2016,7,25,13,162,213,375
2016,7,25,14,149,159,308
2016,7,25,15,138,136,274
2016,7,25,16,123,128,251
2016,7,25,17,105,94,199
2016,7,25,18,95,112,207
2016,7,25,19,89,92,181
2016,7,25,20,55,55,110
2016,7,25,21,40,44,84
2016,7,25,22,32,35,67
2016,7,25,23,21,22,43
2016,7,26,0,6,10,16
2016,7,26,1,11,25,36
2016,7,26,2,14,13,27
2016,7,26,3,15,13,28
2016,7,26,4,66,36,102
2016,7,26,5,107,91,198
2016,7,26,6,130,89,219
2016,7,26,7,154,91,245
2016,7,26,8,136,116,252
2016,7,26,9,151,149,300
2016,7,26,10,185,161,346
2016,7,26,11,172,165,337
2016,7,26,12,192,200,392
2016,7,26,13,176,205,381
2016,7,26,14,130,184,314
2016,7,26,15,145,148,293
2016,7,26,16,144,140,284
2016,7,26,17,109,103,212
2016,7,26,18,110,113,223
2016,7,26,19,106,90,196
2016,7,26,20,69,62,131
2016,7,26,21,49,47,96
2016,7,26,22,27,40,67
2016,7,26,23,14,25,39
2016,7,27,0,8,21,29
2016,7,27,1,11,14,25
2016,7,27,2,7,14,21
2016,7,27,3,16,9,25
2016,7,27,4,63,33,96
2016,7,27,5,110,71,181
2016,7,27,6,125,80,205
2016,7,27,7,134,98,232
2016,7,27,8,168,122,290
2016,7,27,9,179,116,295
2016,7,27,10,171,148,319
2016,7,27,11,184,156,340
2016,7,27,12,187,191,378
2016,7,27,13,175,229,404
2016,7,27,14,155,202,357
2016,7,27,15,157,150,307
2016,7,27,16,125,113,238
2016,7,27,17,109,98,207
2016,7,27,18,92,94,186
2016,7,27,19,84,72,156
2016,7,27,20,57,66,123
2016,7,27,21,43,54,97
2016,7,27,22,30,34,64
2016,7,27,23,20,22,42
2016,7,28,0,13,18,31
2016,7,28,1,7,10,17
2016,7,28,2,8,7,15
2016,7,28,3,9,6,15
2016,7,28,4,67,35,102
2016,7,28,5,114,75,189
2016,7,28,6,127,96,223
2016,7,28,7,145,102,247
2016,7,28,8,156,104,260
2016,7,28,9,157,145,302
2016,7,28,10,182,146,328
2016,7,28,11,158,168,326
2016,7,28,12,182,213,395
2016,7,28,13,161,213,374
2016,7,28,14,138,203,341
2016,7,28,15,147,146,293
2016,7,28,16,120,120,240
2016,7,28,17,121,135,256
2016,7,28,18,102,91,193
2016,7,28,19,76,100,176
2016,7,28,20,52,80,132
2016,7,28,21,41,56,97
2016,7,28,22,37,45,82
2016,7,28,23,19,25,44
2016,7,29,0,13,20,33
2016,7,29,1,11,23,34
2016,7,29,2,4,13,17
2016,7,29,3,12,11,23
2016,7,29,4,60,42,102
2016,7,29,5,112,64,176
2016,7,29,6,123,90,213
2016,7,29,7,147,76,223
2016,7,29,8,151,119,270
2016,7,29,9,188,139,327
2016,7,29,10,161,164,325
2016,7,29,11,196,186,382
2016,7,29,12,189,207,396
2016,7,29,13,166,233,399
2016,7,29,14,168,185,353
2016,7,29,15,141,165,306
2016,7,29,16,139,117,256
2016,7,29,17,108,110,218
2016,7,29,18,97,87,184
2016,7,29,19,85,97,182
2016,7,29,20,76,58,134
2016,7,29,21,40,50,90
2016,7,29,22,35,53,88
2016,7,29,23,25,36,61
2016,7,30,0,18,40,58
2016,7,30,1,18,42,60
2016,7,30,2,15,16,31
2016,7,30,3,7,9,16
2016,7,30,4,12,7,19
2016,7,30,5,30,33,63
2016,7,30,6,28,26,54
2016,7,30,7,73,38,111
2016,7,30,8,85,55,140
2016,7,30,9,127,81,208
2016,7,30,10,114,107,221
2016,7,30,11,150,134,284
2016,7,30,12,157,148,305
2016,7,30,13,129,165,294
2016,7,30,14,115,158,273
2016,7,30,15,109,124,233
2016,7,30,16,111,135,246
2016,7,30,17,105,90,195
2016,7,30,18,90,84,174
2016,7,30,19,56,73,129
2016,7,30,20,61,81,142
2016,7,30,21,35,55,90
2016,7,30,22,42,57,99
2016,7,30,23,31,33,64
2016,7,31,0,23,42,65
2016,7,31,1,24,48,72
2016,7,31,2,20,36,56
2016,7,31,3,15,20,35
2016,7,31,4,11,11,22
2016,7,31,5,17,17,34
2016,7,31,6,29,13,42
2016,7,31,7,34,38,72
2016,7,31,8,71,57,128
2016,7,31,9,105,73,178
2016,7,31,10,125,100,225
2016,7,31,11,144,132,276
2016,7,31,12,171,169,340
2016,7,31,13,168,200,368
2016,7,31,14,125,152,277
2016,7,31,15,162,172,334
2016,7,31,16,143,141,284
2016,7,31,17,130,120,250
2016,7,31,18,113,158,271
2016,7,31,19,97,88,185
2016,7,31,20,65,86,151
2016,7,31,21,38,59,97
2016,7,31,22,32,38,70
2016,7,31,23,21,26,47
2016,8,1,0,7,15,22
2016,8,1,1,5,13,18
2016,8,1,2,4,11,15
2016,8,1,3,16,7,23
2016,8,1,4,92,49,141
2016,8,1,5,136,116,252
2016,8,1,6,202,111,313
2016,8,1,7,230,125,355
2016,8,1,8,190,131,321
2016,8,1,9,210,173,383
2016,8,1,10,238,182,420
2016,8,1,11,229,218,447
2016,8,1,12,238,211,449
2016,8,1,13,216,280,496
2016,8,1,14,179,243,422
2016,8,1,15,161,161,322
2016,8,1,16,137,130,267
2016,8,1,17,109,135,244
2016,8,1,18,108,103,211
2016,8,1,19,85,75,160
2016,8,1,20,83,81,164
2016,8,1,21,37,48,85
2016,8,1,22,23,36,59
2016,8,1,23,11,14,25
2016,8,2,0,4,11,15
2016,8,2,1,1,9,10
2016,8,2,2,7,5,12
2016,8,2,3,15,18,33
2016,8,2,4,90,47,137
2016,8,2,5,137,106,243
2016,8,2,6,195,108,303
2016,8,2,7,157,106,263
2016,8,2,8,187,129,316
2016,8,2,9,219,161,380
2016,8,2,10,199,182,381
2016,8,2,11,198,191,389
2016,8,2,12,210,214,424
2016,8,2,13,193,301,494
2016,8,2,14,172,216,388
2016,8,2,15,177,177,354
2016,8,2,16,137,129,266
2016,8,2,17,123,128,251
2016,8,2,18,105,121,226
2016,8,2,19,104,95,199
2016,8,2,20,69,74,143
2016,8,2,21,49,50,99
2016,8,2,22,29,39,68
2016,8,2,23,15,34,49
2016,8,3,0,7,18,25
2016,8,3,1,8,16,24
2016,8,3,2,6,9,15
2016,8,3,3,15,12,27
2016,8,3,4,89,47,136
2016,8,3,5,131,101,232
2016,8,3,6,184,106,290
2016,8,3,7,186,127,313
2016,8,3,8,188,140,328
2016,8,3,9,187,134,321
2016,8,3,10,204,169,373
2016,8,3,11,217,196,413
2016,8,3,12,163,217,380
2016,8,3,13,190,269,459
2016,8,3,14,165,225,390
2016,8,3,15,153,184,337
2016,8,3,16,147,136,283
2016,8,3,17,116,122,238
2016,8,3,18,106,101,207
2016,8,3,19,96,97,193
2016,8,3,20,69,96,165
2016,8,3,21,62,46,108
2016,8,3,22,11,19,30
2016,8,3,23,12,26,38
2016,8,4,0,6,15,21
2016,8,4,1,5,11,16
2016,8,4,2,6,14,20
2016,8,4,3,9,9,18
2016,8,4,4,102,42,144
2016,8,4,5,145,106,251
2016,8,4,6,196,108,304
2016,8,4,7,181,117,298
2016,8,4,8,180,114,294
2016,8,4,9,199,139,338
2016,8,4,10,181,146,327
2016,8,4,11,190,187,377
2016,8,4,12,206,207,413
2016,8,4,13,211,253,464
2016,8,4,14,189,231,420
2016,8,4,15,184,159,343
2016,8,4,16,159,159,318
2016,8,4,17,124,128,252
2016,8,4,18,127,131,258
2016,8,4,19,90,95,185
2016,8,4,20,64,83,147
2016,8,4,21,39,50,89
2016,8,4,22,20,27,47
2016,8,4,23,20,21,41
2016,8,5,0,13,73,86
2016,8,5,1,11,25,36
2016,8,5,2,4,11,15
2016,8,5,3,12,15,27
2016,8,5,4,86,42,128
2016,8,5,5,139,106,245
2016,8,5,6,208,115,323
2016,8,5,7,200,144,344
2016,8,5,8,191,164,355
2016,8,5,9,215,158,373
2016,8,5,10,214,173,387
2016,8,5,11,203,204,407
2016,8,5,12,203,224,427
2016,8,5,13,210,268,478
2016,8,5,14,168,221,389
2016,8,5,15,145,172,317
2016,8,5,16,137,123,260
2016,8,5,17,139,120,259
2016,8,5,18,100,115,215
2016,8,5,19,70,79,149
2016,8,5,20,64,67,131
2016,8,5,21,41,51,92
2016,8,5,22,31,37,68
2016,8,5,23,16,38,54
2016,8,6,0,19,30,49
2016,8,6,1,15,33,48
2016,8,6,2,15,15,30
2016,8,6,3,11,9,20
2016,8,6,4,19,20,39
2016,8,6,5,34,23,57
2016,8,6,6,40,21,61
2016,8,6,7,56,47,103
2016,8,6,8,99,77,176
2016,8,6,9,132,91,223
2016,8,6,10,157,105,262
2016,8,6,11,156,137,293
2016,8,6,12,135,169,304
2016,8,6,13,137,149,286
2016,8,6,14,125,123,248
2016,8,6,15,116,134,250
2016,8,6,16,127,125,252
2016,8,6,17,109,116,225
2016,8,6,18,88,110,198
2016,8,6,19,72,89,161
2016,8,6,20,70,75,145
2016,8,6,21,55,90,145
2016,8,6,22,47,55,102
2016,8,6,23,34,51,85
2016,8,7,0,21,42,63
2016,8,7,1,30,48,78
2016,8,7,2,22,27,49
2016,8,7,3,10,25,35
2016,8,7,4,16,15,31
2016,8,7,5,19,14,33
2016,8,7,6,31,11,42
2016,8,7,7,31,27,58
2016,8,7,8,87,43,130
2016,8,7,9,111,81,192
2016,8,7,10,132,119,251
2016,8,7,11,202,138,340
2016,8,7,12,153,162,315
2016,8,7,13,145,210,355
2016,8,7,14,158,195,353
2016,8,7,15,137,191,328
2016,8,7,16,125,130,255
2016,8,7,17,128,123,251
2016,8,7,18,161,146,307
2016,8,7,19,112,128,240
2016,8,7,20,67,67,134
2016,8,7,21,42,67,109
2016,8,7,22,24,31,55
2016,8,7,23,14,36,50
2016,8,8,0,6,13,19
2016,8,8,1,7,9,16
2016,8,8,2,5,13,18
2016,8,8,3,18,11,29
2016,8,8,4,121,60,181
2016,8,8,5,221,139,360
2016,8,8,6,314,148,462
2016,8,8,7,232,149,381
2016,8,8,8,243,169,412
2016,8,8,9,230,165,395
2016,8,8,10,220,184,404
2016,8,8,11,205,213,418
2016,8,8,12,215,242,457
2016,8,8,13,216,334,550
2016,8,8,14,198,284,482
2016,8,8,15,185,195,380
2016,8,8,16,164,134,298
2016,8,8,17,130,143,273
2016,8,8,18,120,121,241
2016,8,8,19,86,95,181
2016,8,8,20,64,137,201
2016,8,8,21,32,108,140
2016,8,8,22,11,25,36
2016,8,8,23,18,25,43
2016,8,9,0,8,13,21
2016,8,9,1,3,8,11
2016,8,9,2,1,9,10
2016,8,9,3,17,21,38
2016,8,9,4,129,61,190
2016,8,9,5,210,135,345
2016,8,9,6,308,170,478
2016,8,9,7,247,161,408
2016,8,9,8,242,175,417
2016,8,9,9,214,165,379
2016,8,9,10,233,182,415
2016,8,9,11,225,202,427
2016,8,9,12,244,257,501
2016,8,9,13,271,343,614
2016,8,9,14,228,250,478
2016,8,9,15,188,189,377
2016,8,9,16,166,161,327
2016,8,9,17,149,139,288
2016,8,9,18,112,125,237
2016,8,9,19,100,103,203
2016,8,9,20,67,104,171
2016,8,9,21,40,58,98
2016,8,9,22,24,39,63
2016,8,9,23,15,18,33
2016,8,10,0,14,25,39
2016,8,10,1,9,24,33
2016,8,10,2,5,9,14
2016,8,10,3,22,13,35
2016,8,10,4,113,76,189
2016,8,10,5,228,124,352
2016,8,10,6,277,148,425
2016,8,10,7,233,156,389
2016,8,10,8,219,174,393
2016,8,10,9,221,171,392
2016,8,10,10,234,209,443
2016,8,10,11,222,200,422
2016,8,10,12,246,261,507
2016,8,10,13,260,349,609
2016,8,10,14,191,258,449
2016,8,10,15,159,187,346
2016,8,10,16,153,170,323
2016,8,10,17,147,159,306
2016,8,10,18,103,132,235
2016,8,10,19,87,99,186
2016,8,10,20,63,94,157
2016,8,10,21,43,53,96
2016,8,10,22,21,25,46
2016,8,10,23,13,17,30
2016,8,11,0,12,22,34
2016,8,11,1,9,13,22
2016,8,11,2,7,12,19
2016,8,11,3,14,7,21
2016,8,11,4,110,55,165
2016,8,11,5,205,134,339
2016,8,11,6,323,152,475
2016,8,11,7,221,150,371
2016,8,11,8,239,183,422
2016,8,11,9,237,161,398
2016,8,11,10,235,174,409
2016,8,11,11,238,213,451
2016,8,11,12,227,246,473
2016,8,11,13,278,373,651
2016,8,11,14,240,271,511
2016,8,11,15,198,207,405
2016,8,11,16,159,185,344
2016,8,11,17,164,143,307
2016,8,11,18,141,131,272
2016,8,11,19,116,117,233
2016,8,11,20,79,93,172
2016,8,11,21,55,56,111
2016,8,11,22,23,38,61
2016,8,11,23,23,21,44
2016,8,12,0,19,22,41
2016,8,12,1,9,16,25
2016,8,12,2,10,16,26
2016,8,12,3,15,11,26
2016,8,12,4,111,71,182
2016,8,12,5,200,122,322
2016,8,12,6,305,151,456
2016,8,12,7,260,161,421
2016,8,12,8,231,177,408
2016,8,12,9,241,204,445
2016,8,12,10,240,204,444
2016,8,12,11,263,253,516
2016,8,12,12,286,290,576
2016,8,12,13,346,392,738
2016,8,12,14,223,325,548
2016,8,12,15,193,221,414
2016,8,12,16,160,159,319
2016,8,12,17,157,157,314
2016,8,12,18,130,132,262
2016,8,12,19,84,112,196
2016,8,12,20,77,80,157
2016,8,12,21,49,73,122
2016,8,12,22,28,48,76
2016,8,12,23,30,54,84
2016,8,13,0,23,28,51
2016,8,13,1,19,38,57
2016,8,13,2,8,12,20
2016,8,13,3,14,16,30
2016,8,13,4,25,17,42
2016,8,13,5,42,27,69
2016,8,13,6,45,32,77
2016,8,13,7,75,64,139
2016,8,13,8,149,85,234
2016,8,13,9,180,127,307
2016,8,13,10,198,165,363
2016,8,13,11,218,178,396
2016,8,13,12,213,180,393
2016,8,13,13,185,196,381
2016,8,13,14,161,196,357
2016,8,13,15,154,183,337
2016,8,13,16,141,164,305
2016,8,13,17,124,136,260
2016,8,13,18,116,109,225
2016,8,13,19,98,100,198
2016,8,13,20,58,91,149
2016,8,13,21,54,90,144
2016,8,13,22,39,62,101
2016,8,13,23,38,54,92
2016,8,14,0,29,44,73
2016,8,14,1,31,45,76
2016,8,14,2,21,35,56
2016,8,14,3,10,23,33
2016,8,14,4,17,12,29
2016,8,14,5,15,18,33
2016,8,14,6,39,19,58
2016,8,14,7,44,54,98
2016,8,14,8,100,73,173
2016,8,14,9,116,102,218
2016,8,14,10,137,130,267
2016,8,14,11,145,130,275
2016,8,14,12,204,179,383
2016,8,14,13,179,173,352
2016,8,14,14,171,205,376
2016,8,14,15,161,174,335
2016,8,14,16,178,157,335
2016,8,14,17,191,203,394
2016,8,14,18,171,201,372
2016,8,14,19,102,120,222
2016,8,14,20,75,94,169
2016,8,14,21,40,42,82
2016,8,14,22,27,30,57
2016,8,14,23,17,27,44
2016,8,15,0,5,15,20
2016,8,15,1,3,10,13
2016,8,15,2,3,10,13
2016,8,15,3,17,15,32
2016,8,15,4,120,58,178
2016,8,15,5,270,176,446
2016,8,15,6,390,194,584
2016,8,15,7,272,172,444
2016,8,15,8,258,161,419
2016,8,15,9,249,206,455
2016,8,15,10,255,223,478
2016,8,15,11,225,206,431
2016,8,15,12,227,336,563
2016,8,15,13,291,360,651
2016,8,15,14,264,325,589
2016,8,15,15,209,202,411
2016,8,15,16,171,179,350
2016,8,15,17,160,157,317
2016,8,15,18,158,155,313
2016,8,15,19,128,149,277
2016,8,15,20,64,93,157
2016,8,15,21,47,57,104
2016,8,15,22,34,44,78
2016,8,15,23,20,38,58
2016,8,16,0,16,26,42
2016,8,16,1,8,19,27
2016,8,16,2,7,7,14
2016,8,16,3,18,11,29
2016,8,16,4,118,73,191
2016,8,16,5,269,160,429
2016,8,16,6,372,192,564
2016,8,16,7,265,181,446
2016,8,16,8,227,200,427
2016,8,16,9,240,195,435
2016,8,16,10,244,217,461
2016,8,16,11,266,215,481
2016,8,16,12,238,286,524
2016,8,16,13,265,367,632
2016,8,16,14,235,288,523
2016,8,16,15,201,198,399
2016,8,16,16,200,210,410
2016,8,16,17,156,184,340
2016,8,16,18,133,155,288
2016,8,16,19,121,144,265
2016,8,16,20,81,94,175
2016,8,16,21,59,68,127
2016,8,16,22,41,51,92
2016,8,16,23,18,53,71
2016,8,17,0,14,39,53
2016,8,17,1,13,30,43
2016,8,17,2,6,12,18
2016,8,17,3,15,11,26
2016,8,17,4,120,62,182
2016,8,17,5,237,149,386
2016,8,17,6,355,162,517
2016,8,17,7,246,152,398
2016,8,17,8,236,159,395
2016,8,17,9,239,177,416
2016,8,17,10,253,194,447
2016,8,17,11,233,215,448
2016,8,17,12,220,248,468
2016,8,17,13,212,331,543
2016,8,17,14,227,295,522
2016,8,17,15,184,171,355
2016,8,17,16,171,169,340
2016,8,17,17,159,151,310
2016,8,17,18,135,112,247
2016,8,17,19,90,106,196
2016,8,17,20,72,82,154
2016,8,17,21,29,57,86
2016,8,17,22,20,45,65
2016,8,17,23,23,43,66
2016,8,18,0,19,38,57
2016,8,18,1,6,26,32
2016,8,18,2,10,17,27
2016,8,18,3,23,18,41
2016,8,18,4,134,58,192
2016,8,18,5,229,147,376
2016,8,18,6,343,173,516
2016,8,18,7,246,170,416
2016,8,18,8,246,174,420
2016,8,18,9,225,187,412
2016,8,18,10,212,184,396
2016,8,18,11,231,187,418
2016,8,18,12,241,271,512
2016,8,18,13,262,340,602
2016,8,18,14,226,282,508
2016,8,18,15,178,225,403
2016,8,18,16,170,154,324
2016,8,18,17,153,166,319
2016,8,18,18,137,164,301
2016,8,18,19,102,157,259
2016,8,18,20,84,221,305
2016,8,18,21,43,229,272
2016,8,18,22,28,60,88
2016,8,18,23,19,47,66
2016,8,19,0,13,41,54
2016,8,19,1,15,25,40
2016,8,19,2,6,22,28
2016,8,19,3,20,14,34
2016,8,19,4,125,70,195
2016,8,19,5,221,143,364
2016,8,19,6,363,179,542
2016,8,19,7,302,161,463
2016,8,19,8,266,175,441
2016,8,19,9,237,186,423
2016,8,19,10,240,207,447
2016,8,19,11,269,225,494
2016,8,19,12,244,314,558
2016,8,19,13,270,363,633
2016,8,19,14,225,283,508
2016,8,19,15,184,191,375
2016,8,19,16,163,154,317
2016,8,19,17,150,142,292
2016,8,19,18,139,138,277
2016,8,19,19,103,109,212
2016,8,19,20,75,91,166
2016,8,19,21,63,79,142
2016,8,19,22,54,61,115
2016,8,19,23,38,68,106
2016,8,20,0,27,38,65
2016,8,20,1,28,52,80
2016,8,20,2,9,21,30
2016,8,20,3,12,13,25
2016,8,20,4,19,27,46
2016,8,20,5,37,31,68
2016,8,20,6,40,31,71
2016,8,20,7,80,58,138
2016,8,20,8,116,92,208
2016,8,20,9,143,133,276
2016,8,20,10,189,140,329
2016,8,20,11,192,142,334
2016,8,20,12,187,194,381
2016,8,20,13,144,168,312
2016,8,20,14,161,170,331
2016,8,20,15,157,165,322
2016,8,20,16,138,140,278
2016,8,20,17,106,123,229
2016,8,20,18,95,114,209
2016,8,20,19,73,98,171
2016,8,20,20,56,68,124
2016,8,20,21,52,79,131
2016,8,20,22,63,62,125
2016,8,20,23,41,63,104
2016,8,21,0,33,44,77
2016,8,21,1,27,49,76
2016,8,21,2,22,36,58
2016,8,21,3,16,32,48
2016,8,21,4,21,20,41
2016,8,21,5,16,12,28
2016,8,21,6,37,22,59
2016,8,21,7,45,42,87
2016,8,21,8,94,58,152
2016,8,21,9,110,102,212
2016,8,21,10,141,130,271
2016,8,21,11,143,185,328
2016,8,21,12,181,181,362
2016,8,21,13,164,182,346
2016,8,21,14,176,201,377
2016,8,21,15,187,257,444
2016,8,21,16,191,162,353
2016,8,21,17,166,156,322
2016,8,21,18,234,186,420
2016,8,21,19,118,135,253
2016,8,21,20,86,93,179
2016,8,21,21,46,59,105
2016,8,21,22,25,27,52
2016,8,21,23,15,15,30
2016,8,22,0,5,17,22
2016,8,22,1,8,8,16
2016,8,22,2,9,6,15
2016,8,22,3,18,17,35
2016,8,22,4,114,70,184
2016,8,22,5,259,153,412
2016,8,22,6,377,225,602
2016,8,22,7,280,170,450
2016,8,22,8,221,201,422
2016,8,22,9,240,192,432
2016,8,22,10,255,225,480
2016,8,22,11,250,234,484
2016,8,22,12,232,284,516
2016,8,22,13,256,351,607
2016,8,22,14,253,284,537
2016,8,22,15,191,165,356
2016,8,22,16,169,199,368
2016,8,22,17,178,138,316
2016,8,22,18,131,128,259
2016,8,22,19,102,110,212
2016,8,22,20,59,84,143
2016,8,22,21,34,43,77
2016,8,22,22,15,30,45
2016,8,22,23,6,17,23
2016,8,23,0,7,10,17
2016,8,23,1,5,11,16
2016,8,23,2,4,9,13
2016,8,23,3,21,13,34
2016,8,23,4,116,68,184
2016,8,23,5,252,173,425
2016,8,23,6,369,219,588
2016,8,23,7,245,192,437
2016,8,23,8,276,197,473
2016,8,23,9,234,204,438
2016,8,23,10,218,206,424
2016,8,23,11,250,217,467
2016,8,23,12,231,294,525
2016,8,23,13,252,316,568
2016,8,23,14,213,265,478
2016,8,23,15,193,208,401
2016,8,23,16,173,160,333
2016,8,23,17,142,145,287
2016,8,23,18,135,136,271
2016,8,23,19,99,123,222
2016,8,23,20,65,82,147
2016,8,23,21,27,48,75
2016,8,23,22,17,24,41
2016,8,23,23,8,20,28
2016,8,24,0,7,18,25
2016,8,24,1,9,13,22
2016,8,24,2,5,10,15
2016,8,24,3,20,10,30
2016,8,24,4,131,66,197
2016,8,24,5,244,169,413
2016,8,24,6,377,193,570
2016,8,24,7,288,159,447
2016,8,24,8,250,191,441
2016,8,24,9,243,221,464
2016,8,24,10,233,198,431
2016,8,24,11,218,227,445
2016,8,24,12,256,274,530
2016,8,24,13,294,390,684
2016,8,24,14,239,291,530
2016,8,24,15,201,184,385
2016,8,24,16,182,181,363
2016,8,24,17,134,151,285
2016,8,24,18,132,139,271
2016,8,24,19,113,129,242
2016,8,24,20,80,88,168
2016,8,24,21,32,51,83
2016,8,24,22,24,24,48
2016,8,24,23,15,25,40
2016,8,25,0,7,13,20
2016,8,25,1,5,13,18
2016,8,25,2,5,11,16
2016,8,25,3,11,12,23
2016,8,25,4,119,65,184
2016,8,25,5,238,164,402
2016,8,25,6,373,203,576
2016,8,25,7,272,152,424
2016,8,25,8,242,194,436
2016,8,25,9,247,167,414
2016,8,25,10,237,215,452
2016,8,25,11,227,238,465
2016,8,25,12,236,262,498
2016,8,25,13,273,356,629
2016,8,25,14,224,343,567
2016,8,25,15,200,215,415
2016,8,25,16,205,172,377
2016,8,25,17,162,168,330
2016,8,25,18,141,146,287
2016,8,25,19,107,149,256
2016,8,25,20,72,99,171
2016,8,25,21,32,43,75
2016,8,25,22,26,35,61
2016,8,25,23,14,53,67
2016,8,26,0,10,44,54
2016,8,26,1,12,18,30
2016,8,26,2,9,16,25
2016,8,26,3,17,12,29
2016,8,26,4,136,59,195
2016,8,26,5,264,162,426
2016,8,26,6,413,218,631
2016,8,26,7,324,189,513
2016,8,26,8,261,192,453
2016,8,26,9,273,199,472
2016,8,26,10,255,230,485
2016,8,26,11,255,279,534
2016,8,26,12,281,328,609
2016,8,26,13,310,409,719
2016,8,26,14,251,273,524
2016,8,26,15,187,194,381
2016,8,26,16,168,162,330
2016,8,26,17,125,137,262
2016,8,26,18,133,107,240
2016,8,26,19,100,105,205
2016,8,26,20,78,70,148
2016,8,26,21,55,69,124
2016,8,26,22,36,52,88
2016,8,26,23,29,44,73
2016,8,27,0,18,43,61
2016,8,27,1,20,36,56
2016,8,27,2,8,23,31
2016,8,27,3,10,13,23
2016,8,27,4,21,20,41
2016,8,27,5,37,30,67
2016,8,27,6,29,25,54
2016,8,27,7,61,55,116
2016,8,27,8,109,91,200
2016,8,27,9,163,118,281
2016,8,27,10,185,134,319
2016,8,27,11,185,170,355
2016,8,27,12,161,186,347
2016,8,27,13,144,197,341
2016,8,27,14,141,138,279
2016,8,27,15,129,148,277
2016,8,27,16,163,142,305
2016,8,27,17,135,134,269
2016,8,27,18,102,114,216
2016,8,27,19,67,98,165
2016,8,27,20,50,68,118
2016,8,27,21,51,68,119
2016,8,27,22,43,68,111
2016,8,27,23,37,58,95
2016,8,28,0,35,55,90
2016,8,28,1,32,67,99
2016,8,28,2,18,49,67
2016,8,28,3,12,24,36
2016,8,28,4,10,12,22
2016,8,28,5,20,15,35
2016,8,28,6,26,13,39
2016,8,28,7,35,36,71
2016,8,28,8,97,73,170
2016,8,28,9,142,93,235
2016,8,28,10,135,131,266
2016,8,28,11,157,160,317
2016,8,28,12,176,182,358
2016,8,28,13,144,193,337
2016,8,28,14,167,215,382
2016,8,28,15,168,171,339
2016,8,28,16,161,171,332
2016,8,28,17,180,144,324
2016,8,28,18,152,195,347
2016,8,28,19,99,117,216
2016,8,28,20,55,88,143
2016,8,28,21,44,43,87
2016,8,28,22,23,20,43
2016,8,28,23,11,17,28
2016,8,29,0,6,15,21
2016,8,29,1,5,8,13
2016,8,29,2,7,10,17
2016,8,29,3,19,15,34
2016,8,29,4,142,70,212
2016,8,29,5,283,173,456
2016,8,29,6,373,218,591
2016,8,29,7,308,187,495
2016,8,29,8,262,203,465
2016,8,29,9,244,198,442
2016,8,29,10,219,185,404
2016,8,29,11,224,236,460
2016,8,29,12,218,262,480
2016,8,29,13,268,370,638
2016,8,29,14,232,312,544
2016,8,29,15,180,183,363
2016,8,29,16,180,182,362
2016,8,29,17,130,157,287
2016,8,29,18,139,158,297
2016,8,29,19,97,143,240
2016,8,29,20,58,77,135
2016,8,29,21,23,27,50
2016,8,29,22,19,19,38
2016,8,29,23,14,15,29
2016,8,30,0,11,8,19
2016,8,30,1,8,11,19
2016,8,30,2,2,10,12
2016,8,30,3,19,12,31
2016,8,30,4,127,75,202
2016,8,30,5,261,194,455
2016,8,30,6,372,219,591
2016,8,30,7,301,182,483
2016,8,30,8,259,197,456
2016,8,30,9,233,189,422
2016,8,30,10,239,214,453
2016,8,30,11,256,248,504
2016,8,30,12,207,295,502
2016,8,30,13,289,348,637
2016,8,30,14,227,302,529
2016,8,30,15,189,213,402
2016,8,30,16,191,174,365
2016,8,30,17,172,182,354
2016,8,30,18,124,141,265
2016,8,30,19,105,107,212
2016,8,30,20,73,93,166
2016,8,30,21,27,30,57
2016,8,30,22,18,23,41
2016,8,30,23,10,12,22
2016,8,31,0,8,19,27
2016,8,31,1,7,16,23
2016,8,31,2,7,10,17
2016,8,31,3,15,17,32
2016,8,31,4,134,64,198
2016,8,31,5,245,159,404
2016,8,31,6,402,208,610
2016,8,31,7,263,180,443
2016,8,31,8,226,179,405
2016,8,31,9,246,198,444
2016,8,31,10,233,224,457
2016,8,31,11,268,226,494
2016,8,31,12,249,252,501
2016,8,31,13,264,345,609
2016,8,31,14,271,285,556
2016,8,31,15,212,214,426
2016,8,31,16,191,155,346
2016,8,31,17,158,159,317
2016,8,31,18,113,150,263
2016,8,31,19,109,144,253
2016,8,31,20,63,131,194
2016,8,31,21,36,61,97
2016,8,31,22,18,32,50
2016,8,31,23,11,14,25
2016,9,1,0,5,18,23
2016,9,1,1,8,12,20
2016,9,1,2,3,10,13
2016,9,1,3,19,11,30
2016,9,1,4,131,60,191
2016,9,1,5,275,170,445
2016,9,1,6,438,254,692
2016,9,1,7,300,184,484
2016,9,1,8,310,238,548
2016,9,1,9,239,193,432
2016,9,1,10,209,208,417
2016,9,1,11,186,205,391
2016,9,1,12,224,300,524
2016,9,1,13,307,471,778
2016,9,1,14,251,317,568
2016,9,1,15,208,195,403
2016,9,1,16,199,185,384
2016,9,1,17,173,162,335
2016,9,1,18,136,161,297
2016,9,1,19,102,117,219
2016,9,1,20,73,92,165
2016,9,1,21,50,59,109
2016,9,1,22,24,42,66
2016,9,1,23,15,29,44
2016,9,2,0,10,30,40
2016,9,2,1,9,15,24
2016,9,2,2,4,11,15
2016,9,2,3,11,9,20
2016,9,2,4,140,72,212
2016,9,2,5,250,150,400
2016,9,2,6,411,202,613
2016,9,2,7,271,187,458
2016,9,2,8,228,178,406
2016,9,2,9,233,186,419
2016,9,2,10,287,226,513
2016,9,2,11,237,243,480
2016,9,2,12,277,329,606
2016,9,2,13,293,364,657
2016,9,2,14,222,298,520
2016,9,2,15,199,222,421
2016,9,2,16,161,150,311
2016,9,2,17,139,132,271
2016,9,2,18,119,132,251
2016,9,2,19,80,110,190
2016,9,2,20,62,88,150
2016,9,2,21,43,65,108
2016,9,2,22,35,48,83
2016,9,2,23,29,37,66
2016,9,3,0,20,44,64
2016,9,3,1,19,38,57
2016,9,3,2,19,30,49
2016,9,3,3,10,16,26
2016,9,3,4,28,21,49
2016,9,3,5,36,31,67
2016,9,3,6,38,39,77
2016,9,3,7,78,54,132
2016,9,3,8,133,78,211
2016,9,3,9,129,116,245
2016,9,3,10,165,127,292
2016,9,3,11,168,146,314
2016,9,3,12,169,176,345
2016,9,3,13,155,191,346
2016,9,3,14,127,166,293
2016,9,3,15,151,152,303
2016,9,3,16,141,164,305
2016,9,3,17,97,122,219
2016,9,3,18,92,95,187
2016,9,3,19,64,79,143
2016,9,3,20,48,75,123
2016,9,3,21,57,68,125
2016,9,3,22,47,64,111
2016,9,3,23,44,55,99
2016,9,4,0,28,36,64
2016,9,4,1,27,57,84
2016,9,4,2,12,36,48
2016,9,4,3,11,17,28
2016,9,4,4,25,20,45
2016,9,4,5,20,22,42
2016,9,4,6,39,27,66
2016,9,4,7,50,47,97
2016,9,4,8,95,58,153
2016,9,4,9,111,77,188
2016,9,4,10,153,124,277
2016,9,4,11,162,184,346
2016,9,4,12,173,201,374
2016,9,4,13,194,194,388
2016,9,4,14,143,222,365
2016,9,4,15,157,193,350
2016,9,4,16,168,193,361
2016,9,4,17,165,169,334
2016,9,4,18,123,193,316
2016,9,4,19,98,120,218
2016,9,4,20,56,78,134
2016,9,4,21,44,51,95
2016,9,4,22,23,27,50
2016,9,4,23,18,18,36
2016,9,5,0,5,14,19
2016,9,5,1,10,13,23
2016,9,5,2,7,12,19
2016,9,5,3,23,9,32
2016,9,5,4,131,72,203
2016,9,5,5,249,150,399
2016,9,5,6,381,219,600
2016,9,5,7,266,161,427
2016,9,5,8,263,178,441
2016,9,5,9,210,211,421
2016,9,5,10,221,210,431
2016,9,5,11,242,234,476
2016,9,5,12,231,273,504
2016,9,5,13,252,333,585
2016,9,5,14,251,319,570
2016,9,5,15,213,190,403
2016,9,5,16,168,146,314
2016,9,5,17,137,161,298
2016,9,5,18,129,139,268
2016,9,5,19,121,152,273
2016,9,5,20,62,95,157
2016,9,5,21,38,38,76
2016,9,5,22,12,23,35
2016,9,5,23,15,7,22
2016,9,6,0,5,13,18
2016,9,6,1,7,8,15
2016,9,6,2,4,8,12
2016,9,6,3,18,12,30
2016,9,6,4,119,72,191
2016,9,6,5,262,159,421
2016,9,6,6,411,197,608
2016,9,6,7,251,172,423
2016,9,6,8,255,184,439
2016,9,6,9,230,209,439
2016,9,6,10,228,215,443
2016,9,6,11,251,219,470
2016,9,6,12,219,280,499
2016,9,6,13,264,356,620
2016,9,6,14,223,307,530
2016,9,6,15,188,217,405
2016,9,6,16,185,175,360
2016,9,6,17,146,158,304
2016,9,6,18,129,142,271
2016,9,6,19,90,112,202
2016,9,6,20,66,81,147
2016,9,6,21,45,40,85
2016,9,6,22,21,18,39
2016,9,6,23,5,18,23
2016,9,7,0,13,16,29
2016,9,7,1,3,17,20
2016,9,7,2,3,11,14
2016,9,7,3,18,10,28
2016,9,7,4,112,65,177
2016,9,7,5,273,170,443
2016,9,7,6,398,196,594
2016,9,7,7,259,170,429
2016,9,7,8,241,168,409
2016,9,7,9,229,209,438
2016,9,7,10,233,194,427
2016,9,7,11,231,207,438
2016,9,7,12,236,278,514
2016,9,7,13,236,335,571
2016,9,7,14,280,318,598
2016,9,7,15,203,213,416
2016,9,7,16,169,177,346
2016,9,7,17,125,154,279
2016,9,7,18,140,134,274
2016,9,7,19,82,125,207
2016,9,7,20,66,84,150
2016,9,7,21,29,44,73
2016,9,7,22,22,27,49
2016,9,7,23,12,23,35
2016,9,8,0,11,18,29
2016,9,8,1,6,11,17
2016,9,8,2,5,12,17
2016,9,8,3,20,16,36
2016,9,8,4,120,65,185
2016,9,8,5,242,172,414
2016,9,8,6,396,205,601
2016,9,8,7,283,185,468
2016,9,8,8,223,189,412
2016,9,8,9,229,191,420
2016,9,8,10,214,210,424
2016,9,8,11,209,229,438
2016,9,8,12,203,244,447
2016,9,8,13,287,333,620
2016,9,8,14,236,264,500
2016,9,8,15,207,196,403
2016,9,8,16,210,167,377
2016,9,8,17,146,165,311
2016,9,8,18,131,148,279
2016,9,8,19,102,137,239
2016,9,8,20,77,259,336
2016,9,8,21,38,55,93
2016,9,8,22,16,40,56
2016,9,8,23,15,23,38
2016,9,9,0,13,26,39
2016,9,9,1,7,23,30
2016,9,9,2,4,9,13
2016,9,9,3,15,18,33
2016,9,9,4,115,73,188
2016,9,9,5,214,169,383
2016,9,9,6,355,202,557
2016,9,9,7,263,163,426
2016,9,9,8,227,192,419
2016,9,9,9,246,192,438
2016,9,9,10,270,208,478
2016,9,9,11,219,231,450
2016,9,9,12,253,264,517
2016,9,9,13,265,350,615
2016,9,9,14,225,298,523
2016,9,9,15,161,178,339
2016,9,9,16,144,161,305
2016,9,9,17,147,147,294
2016,9,9,18,115,104,219
2016,9,9,19,80,84,164
2016,9,9,20,66,74,140
2016,9,9,21,55,76,131
2016,9,9,22,36,66,102
2016,9,9,23,36,55,91
2016,9,10,0,29,36,65
2016,9,10,1,22,65,87
2016,9,10,2,12,24,36
2016,9,10,3,15,15,30
2016,9,10,4,18,11,29
2016,9,10,5,30,24,54
2016,9,10,6,34,45,79
2016,9,10,7,79,65,144
2016,9,10,8,136,93,229
2016,9,10,9,140,104,244
2016,9,10,10,174,135,309
2016,9,10,11,195,225,420
2016,9,10,12,170,173,343
2016,9,10,13,178,215,393
2016,9,10,14,148,208,356
2016,9,10,15,145,207,352
2016,9,10,16,140,141,281
2016,9,10,17,97,104,201
2016,9,10,18,126,98,224
2016,9,10,19,75,85,160
2016,9,10,20,44,62,106
2016,9,10,21,47,73,120
2016,9,10,22,54,66,120
2016,9,10,23,46,54,100
2016,9,11,0,24,60,84
2016,9,11,1,36,70,106
2016,9,11,2,20,41,61
2016,9,11,3,13,14,27
2016,9,11,4,19,20,39
2016,9,11,5,14,16,30
2016,9,11,6,25,24,49
2016,9,11,7,60,36,96
2016,9,11,8,112,61,173
2016,9,11,9,118,95,213
2016,9,11,10,149,143,292
2016,9,11,11,149,165,314
2016,9,11,12,207,203,410
2016,9,11,13,152,185,337
2016,9,11,14,176,247,423
2016,9,11,15,165,192,357
2016,9,11,16,169,186,355
2016,9,11,17,146,175,321
2016,9,11,18,131,155,286
2016,9,11,19,98,112,210
2016,9,11,20,61,77,138
2016,9,11,21,37,39,76
2016,9,11,22,28,22,50
2016,9,11,23,14,7,21
2016,9,12,0,4,10,14
2016,9,12,1,3,10,13
2016,9,12,2,4,6,10
2016,9,12,3,20,9,29
2016,9,12,4,132,61,193
2016,9,12,5,268,147,415
2016,9,12,6,368,196,564
2016,9,12,7,232,146,378
2016,9,12,8,253,172,425
2016,9,12,9,263,198,461
2016,9,12,10,240,240,480
2016,9,12,11,254,230,484
2016,9,12,12,219,275,494
2016,9,12,13,260,329,589
2016,9,12,14,238,314,552
2016,9,12,15,215,188,403
2016,9,12,16,171,171,342
2016,9,12,17,169,203,372
2016,9,12,18,119,163,282
2016,9,12,19,104,120,224
2016,9,12,20,43,93,136
2016,9,12,21,14,43,57
2016,9,12,22,14,24,38
2016,9,12,23,4,14,18
2016,9,13,0,1,4,5
2016,9,13,1,2,10,12
2016,9,13,2,3,10,13
2016,9,13,3,24,8,32
2016,9,13,4,137,64,201
2016,9,13,5,215,155,370
2016,9,13,6,340,174,514
2016,9,13,7,289,157,446
2016,9,13,8,280,178,458
2016,9,13,9,229,213,442
2016,9,13,10,237,230,467
2016,9,13,11,212,242,454
2016,9,13,12,227,305,532
2016,9,13,13,273,330,603
2016,9,13,14,212,313,525
2016,9,13,15,229,216,445
2016,9,13,16,171,180,351
2016,9,13,17,142,144,286
2016,9,13,18,143,146,289
2016,9,13,19,122,131,253
2016,9,13,20,35,99,134
2016,9,13,21,21,48,69
2016,9,13,22,12,25,37
2016,9,13,23,7,22,29
2016,9,14,0,4,25,29
2016,9,14,1,8,18,26
2016,9,14,2,8,10,18
2016,9,14,3,19,12,31
2016,9,14,4,126,70,196
2016,9,14,5,265,162,427
2016,9,14,6,386,191,577
2016,9,14,7,234,172,406
2016,9,14,8,227,172,399
2016,9,14,9,213,195,408
2016,9,14,10,221,199,420
2016,9,14,11,224,216,440
2016,9,14,12,226,281,507
2016,9,14,13,271,316,587
2016,9,14,14,248,315,563
2016,9,14,15,213,192,405
2016,9,14,16,173,173,346
2016,9,14,17,155,160,315
2016,9,14,18,152,179,331
2016,9,14,19,109,128,237
2016,9,14,20,37,86,123
2016,9,14,21,13,49,62
2016,9,14,22,11,29,40
2016,9,14,23,8,23,31
2016,9,15,0,3,16,19
2016,9,15,1,2,17,19
2016,9,15,2,5,17,22
2016,9,15,3,19,10,29
2016,9,15,4,127,62,189
2016,9,15,5,234,157,391
2016,9,15,6,408,214,622
2016,9,15,7,257,163,420
2016,9,15,8,227,171,398
2016,9,15,9,220,176,396
2016,9,15,10,225,172,397
2016,9,15,11,186,242,428
2016,9,15,12,236,280,516
2016,9,15,13,275,352,627
2016,9,15,14,229,292,521
2016,9,15,15,177,202,379
2016,9,15,16,180,175,355
2016,9,15,17,148,170,318
2016,9,15,18,132,144,276
2016,9,15,19,103,107,210
2016,9,15,20,75,165,240
2016,9,15,21,44,124,168
2016,9,15,22,21,34,55
2016,9,15,23,24,40,64
2016,9,16,0,15,33,48
2016,9,16,1,16,31,47
2016,9,16,2,6,20,26
2016,9,16,3,15,14,29
2016,9,16,4,121,74,195
2016,9,16,5,230,158,388
2016,9,16,6,335,174,509
2016,9,16,7,287,150,437
2016,9,16,8,213,158,371
2016,9,16,9,240,203,443
2016,9,16,10,232,247,479
2016,9,16,11,244,235,479
2016,9,16,12,244,297,541
2016,9,16,13,268,352,620
2016,9,16,14,203,247,450
2016,9,16,15,167,192,359
2016,9,16,16,135,132,267
2016,9,16,17,153,130,283
2016,9,16,18,96,115,211
2016,9,16,19,70,73,143
2016,9,16,20,51,61,112
2016,9,16,21,46,86,132
2016,9,16,22,40,56,96
2016,9,16,23,35,51,86
2016,9,17,0,15,32,47
2016,9,17,1,17,46,63
2016,9,17,2,13,26,39
2016,9,17,3,6,11,17
2016,9,17,4,33,11,44
2016,9,17,5,27,27,54
2016,9,17,6,42,30,72
2016,9,17,7,79,71,150
2016,9,17,8,115,80,195
2016,9,17,9,149,134,283
2016,9,17,10,192,129,321
2016,9,17,11,186,155,341
2016,9,17,12,142,203,345
2016,9,17,13,146,198,344
2016,9,17,14,118,167,285
2016,9,17,15,132,149,281
2016,9,17,16,136,141,277
2016,9,17,17,117,109,226
2016,9,17,18,85,84,169
2016,9,17,19,77,73,150
2016,9,17,20,64,55,119
2016,9,17,21,40,76,116
2016,9,17,22,50,81,131
2016,9,17,23,43,59,102
2016,9,18,0,30,75,105
2016,9,18,1,29,54,83
2016,9,18,2,13,48,61
2016,9,18,3,14,24,38
2016,9,18,4,15,18,33
2016,9,18,5,13,18,31
2016,9,18,6,26,20,46
2016,9,18,7,39,34,73
2016,9,18,8,109,72,181
2016,9,18,9,114,91,205
2016,9,18,10,136,153,289
2016,9,18,11,145,163,308
2016,9,18,12,189,182,371
2016,9,18,13,169,188,357
2016,9,18,14,136,195,331
2016,9,18,15,157,165,322
2016,9,18,16,176,175,351
2016,9,18,17,159,183,342
2016,9,18,18,157,179,336
2016,9,18,19,96,108,204
2016,9,18,20,60,78,138
2016,9,18,21,39,41,80
2016,9,18,22,19,25,44
2016,9,18,23,9,15,24
2016,9,19,0,3,6,9
2016,9,19,1,6,7,13
2016,9,19,2,6,8,14
2016,9,19,3,22,20,42
2016,9,19,4,147,76,223
2016,9,19,5,254,161,415
2016,9,19,6,385,207,592
2016,9,19,7,276,165,441
2016,9,19,8,234,214,448
2016,9,19,9,188,215,403
2016,9,19,10,212,212,424
2016,9,19,11,223,231,454
2016,9,19,12,213,280,493
2016,9,19,13,265,358,623
2016,9,19,14,256,294,550
2016,9,19,15,201,207,408
2016,9,19,16,203,184,387
2016,9,19,17,142,167,309
2016,9,19,18,122,155,277
2016,9,19,19,79,135,214
2016,9,19,20,72,103,175
2016,9,19,21,25,46,71
2016,9,19,22,18,17,35
2016,9,19,23,8,15,23
2016,9,20,0,6,8,14
2016,9,20,1,4,3,7
2016,9,20,2,6,10,16
2016,9,20,3,26,14,40
2016,9,20,4,118,77,195
2016,9,20,5,230,167,397
2016,9,20,6,395,210,605
2016,9,20,7,272,175,447
2016,9,20,8,225,176,401
2016,9,20,9,212,216,428
2016,9,20,10,202,187,389
2016,9,20,11,196,209,405
2016,9,20,12,207,268,475
2016,9,20,13,274,328,602
2016,9,20,14,248,304,552
2016,9,20,15,228,204,432
2016,9,20,16,175,193,368
2016,9,20,17,178,175,353
2016,9,20,18,135,152,287
2016,9,20,19,103,150,253
2016,9,20,20,58,98,156
2016,9,20,21,24,46,70
2016,9,20,22,21,24,45
2016,9,20,23,21,21,42
2016,9,21,0,13,19,32
2016,9,21,1,11,16,27
2016,9,21,2,6,13,19
2016,9,21,3,22,16,38
2016,9,21,4,128,80,208
2016,9,21,5,235,155,390
2016,9,21,6,386,229,615
2016,9,21,7,227,174,401
2016,9,21,8,217,180,397
2016,9,21,9,249,221,470
2016,9,21,10,208,190,398
2016,9,21,11,206,226,432
2016,9,21,12,217,277,494
2016,9,21,13,259,340,599
2016,9,21,14,214,305,519
2016,9,21,15,189,212,401
2016,9,21,16,208,174,382
2016,9,21,17,172,153,325
2016,9,21,18,117,145,262
2016,9,21,19,92,140,232
2016,9,21,20,59,129,188
2016,9,21,21,35,119,154
2016,9,21,22,28,27,55
2016,9,21,23,9,21,30
2016,9,22,0,8,11,19
2016,9,22,1,6,12,18
2016,9,22,2,6,12,18
2016,9,22,3,19,16,35
2016,9,22,4,121,67,188
2016,9,22,5,243,188,431
2016,9,22,6,411,227,638
2016,9,22,7,266,178,444
2016,9,22,8,229,174,403
2016,9,22,9,206,180,386
2016,9,22,10,192,190,382
2016,9,22,11,229,227,456
2016,9,22,12,219,276,495
2016,9,22,13,268,341,609
2016,9,22,14,255,325,580
2016,9,22,15,216,238,454
2016,9,22,16,240,186,426
2016,9,22,17,162,192,354
2016,9,22,18,127,140,267
2016,9,22,19,97,148,245
2016,9,22,20,57,81,138
2016,9,22,21,37,57,94
2016,9,22,22,11,26,37
2016,9,22,23,9,29,38
2016,9,23,0,15,26,41
2016,9,23,1,9,20,29
2016,9,23,2,7,16,23
2016,9,23,3,20,17,37
2016,9,23,4,135,61,196
2016,9,23,5,242,161,403
2016,9,23,6,363,184,547
2016,9,23,7,274,175,449
2016,9,23,8,237,188,425
2016,9,23,9,264,208,472
2016,9,23,10,217,238,455
2016,9,23,11,229,270,499
2016,9,23,12,276,292,568
2016,9,23,13,264,334,598
2016,9,23,14,216,380,596
2016,9,23,15,203,206,409
2016,9,23,16,146,169,315
2016,9,23,17,151,156,307
2016,9,23,18,114,136,250
2016,9,23,19,85,98,183
2016,9,23,20,85,90,175
2016,9,23,21,42,92,134
2016,9,23,22,28,45,73
2016,9,23,23,30,52,82
2016,9,24,0,22,50,72
2016,9,24,1,15,45,60
2016,9,24,2,9,29,38
2016,9,24,3,8,14,22
2016,9,24,4,20,15,35
2016,9,24,5,32,33,65
2016,9,24,6,28,41,69
2016,9,24,7,60,53,113
2016,9,24,8,117,91,208
2016,9,24,9,157,127,284
2016,9,24,10,174,164,338
2016,9,24,11,187,170,357
2016,9,24,12,159,170,329
2016,9,24,13,144,182,326
2016,9,24,14,184,191,375
2016,9,24,15,149,183,332
2016,9,24,16,109,178,287
2016,9,24,17,101,148,249
2016,9,24,18,99,129,228
2016,9,24,19,64,81,145
2016,9,24,20,67,78,145
2016,9,24,21,53,80,133
2016,9,24,22,56,77,133
2016,9,24,23,31,79,110
2016,9,25,0,36,67,103
2016,9,25,1,29,55,84
2016,9,25,2,11,51,62
2016,9,25,3,8,15,23
2016,9,25,4,17,12,29
2016,9,25,5,26,19,45
2016,9,25,6,25,17,42
2016,9,25,7,47,33,80
2016,9,25,8,103,62,165
2016,9,25,9,131,112,243
2016,9,25,10,130,162,292
2016,9,25,11,175,165,340
2016,9,25,12,218,236,454
2016,9,25,13,178,242,420
2016,9,25,14,195,243,438
2016,9,25,15,163,220,383
2016,9,25,16,141,220,361
2016,9,25,17,121,238,359
2016,9,25,18,116,152,268
2016,9,25,19,89,113,202
2016,9,25,20,106,85,191
2016,9,25,21,33,53,86
2016,9,25,22,16,19,35
2016,9,25,23,10,12,22
2016,9,26,0,7,11,18
2016,9,26,1,5,10,15
2016,9,26,2,6,11,17
2016,9,26,3,16,9,25
2016,9,26,4,132,69,201
2016,9,26,5,228,152,380
2016,9,26,6,371,205,576
2016,9,26,7,254,190,444
2016,9,26,8,208,209,417
2016,9,26,9,221,174,395
2016,9,26,10,212,203,415
2016,9,26,11,207,214,421
2016,9,26,12,211,263,474
2016,9,26,13,246,325,571
2016,9,26,14,233,320,553
2016,9,26,15,200,194,394
2016,9,26,16,200,182,382
2016,9,26,17,151,169,320
2016,9,26,18,129,149,278
2016,9,26,19,98,141,239
2016,9,26,20,54,80,134
2016,9,26,21,44,55,99
2016,9,26,22,14,21,35
2016,9,26,23,7,17,24
2016,9,27,0,8,16,24
2016,9,27,1,3,6,9
2016,9,27,2,9,5,14
2016,9,27,3,23,12,35
2016,9,27,4,139,70,209
2016,9,27,5,231,185,416
2016,9,27,6,427,252,679
2016,9,27,7,267,188,455
2016,9,27,8,242,179,421
2016,9,27,9,242,208,450
2016,9,27,10,218,232,450
2016,9,27,11,210,220,430
2016,9,27,12,226,278,504
2016,9,27,13,271,347,618
2016,9,27,14,267,341,608
2016,9,27,15,230,234,464
2016,9,27,16,261,197,458
2016,9,27,17,186,146,332
2016,9,27,18,124,142,266
2016,9,27,19,91,110,201
2016,9,27,20,60,94,154
2016,9,27,21,26,44,70
2016,9,27,22,14,28,42
2016,9,27,23,12,20,32
2016,9,28,0,11,16,27
2016,9,28,1,6,11,17
2016,9,28,2,5,4,9
2016,9,28,3,21,12,33
2016,9,28,4,107,69,176
2016,9,28,5,240,149,389
2016,9,28,6,388,215,603
2016,9,28,7,265,168,433
2016,9,28,8,244,167,411
2016,9,28,9,237,203,440
2016,9,28,10,208,201,409
2016,9,28,11,224,215,439
2016,9,28,12,215,266,481
2016,9,28,13,263,343,606
2016,9,28,14,249,329,578
2016,9,28,15,237,237,474
2016,9,28,16,164,191,355
2016,9,28,17,134,168,302
2016,9,28,18,116,159,275
2016,9,28,19,94,148,242
2016,9,28,20,59,97,156
2016,9,28,21,37,44,81
2016,9,28,22,17,27,44
2016,9,28,23,7,12,19
2016,9,29,0,8,12,20
2016,9,29,1,3,13,16
2016,9,29,2,4,10,14
2016,9,29,3,26,14,40
2016,9,29,4,125,64,189
2016,9,29,5,239,174,413
2016,9,29,6,412,210,622
2016,9,29,7,262,169,431
2016,9,29,8,258,197,455
2016,9,29,9,220,186,406
2016,9,29,10,239,215,454
2016,9,29,11,198,265,463
2016,9,29,12,228,277,505
2016,9,29,13,314,353,667
2016,9,29,14,241,315,556
2016,9,29,15,215,232,447
2016,9,29,16,194,161,355
2016,9,29,17,174,190,364
2016,9,29,18,107,153,260
2016,9,29,19,80,136,216
2016,9,29,20,71,87,158
2016,9,29,21,35,55,90
2016,9,29,22,16,31,47
2016,9,29,23,20,34,54
2016,9,30,0,18,24,42
2016,9,30,1,9,22,31
2016,9,30,2,7,16,23
2016,9,30,3,21,13,34
2016,9,30,4,130,62,192
2016,9,30,5,241,171,412
2016,9,30,6,396,224,620
2016,9,30,7,242,173,415
2016,9,30,8,264,196,460
2016,9,30,9,233,201,434
2016,9,30,10,249,225,474
2016,9,30,11,221,253,474
2016,9,30,12,256,305,561
2016,9,30,13,281,356,637
2016,9,30,14,232,283,515
2016,9,30,15,236,232,468
2016,9,30,16,149,182,331
2016,9,30,17,139,167,306
2016,9,30,18,87,122,209
2016,9,30,19,76,96,172
2016,9,30,20,64,88,152
2016,9,30,21,51,56,107
2016,9,30,22,45,73,118
2016,9,30,23,28,40,68
2016,10,1,0,28,61,89
2016,10,1,1,21,41,62
2016,10,1,2,12,33,45
2016,10,1,3,13,17,30
2016,10,1,4,26,18,44
2016,10,1,5,33,29,62
2016,10,1,6,46,43,89
2016,10,1,7,89,82,171
2016,10,1,8,121,96,217
2016,10,1,9,152,114,266
2016,10,1,10,184,152,336
2016,10,1,11,182,173,355
2016,10,1,12,170,199,369
2016,10,1,13,192,190,382
2016,10,1,14,150,204,354
2016,10,1,15,133,187,320
2016,10,1,16,159,168,327
2016,10,1,17,117,133,250
2016,10,1,18,79,110,189
2016,10,1,19,67,82,149
2016,10,1,20,35,57,92
2016,10,1,21,50,73,123
2016,10,1,22,43,71,114
2016,10,1,23,32,58,90
2016,10,2,0,27,55,82
2016,10,2,1,25,61,86
2016,10,2,2,23,49,72
2016,10,2,3,11,31,42
2016,10,2,4,17,13,30
2016,10,2,5,18,15,33
2016,10,2,6,54,18,72
2016,10,2,7,53,47,100
2016,10,2,8,128,72,200
2016,10,2,9,138,102,240
2016,10,2,10,156,169,325
2016,10,2,11,165,200,365
2016,10,2,12,155,192,347
2016,10,2,13,171,234,405
2016,10,2,14,188,235,423
2016,10,2,15,166,200,366
2016,10,2,16,177,183,360
2016,10,2,17,184,227,411
2016,10,2,18,136,154,290
2016,10,2,19,88,120,208
2016,10,2,20,61,83,144
2016,10,2,21,29,37,66
2016,10,2,22,13,26,39
2016,10,2,23,18,13,31
2016,10,3,0,10,12,22
2016,10,3,1,3,9,12
2016,10,3,2,5,9,14
2016,10,3,3,19,13,32
2016,10,3,4,132,73,205
2016,10,3,5,228,167,395
2016,10,3,6,383,200,583
2016,10,3,7,305,167,472
2016,10,3,8,235,184,419
2016,10,3,9,208,202,410
2016,10,3,10,208,194,402
2016,10,3,11,197,230,427
2016,10,3,12,218,245,463
2016,10,3,13,272,355,627
2016,10,3,14,237,296,533
2016,10,3,15,184,223,407
2016,10,3,16,157,175,332
2016,10,3,17,139,161,300
2016,10,3,18,136,137,273
2016,10,3,19,82,126,208
2016,10,3,20,57,82,139
2016,10,3,21,37,50,87
2016,10,3,22,16,15,31
2016,10,3,23,8,5,13
2016,10,4,0,4,12,16
2016,10,4,1,6,7,13
2016,10,4,2,6,12,18
2016,10,4,3,27,16,43
2016,10,4,4,135,67,202
2016,10,4,5,260,190,450
2016,10,4,6,389,206,595
2016,10,4,7,240,182,422
2016,10,4,8,227,169,396
2016,10,4,9,232,190,422
2016,10,4,10,225,240,465
2016,10,4,11,192,225,417
2016,10,4,12,235,275,510
2016,10,4,13,278,348,626
2016,10,4,14,233,274,507
2016,10,4,15,210,221,431
2016,10,4,16,208,180,388
2016,10,4,17,170,169,339
2016,10,4,18,119,159,278
2016,10,4,19,98,128,226
2016,10,4,20,55,102,157
2016,10,4,21,41,33,74
2016,10,4,22,15,25,40
2016,10,4,23,11,17,28
2016,10,5,0,6,7,13
2016,10,5,1,5,5,10
2016,10,5,2,9,6,15
2016,10,5,3,21,6,27
2016,10,5,4,122,76,198
2016,10,5,5,250,183,433
2016,10,5,6,395,203,598
2016,10,5,7,237,174,411
2016,10,5,8,225,171,396
2016,10,5,9,196,202,398
2016,10,5,10,198,191,389
2016,10,5,11,208,201,409
2016,10,5,12,212,273,485
2016,10,5,13,272,331,603
2016,10,5,14,230,286,516
2016,10,5,15,229,214,443
2016,10,5,16,157,163,320
2016,10,5,17,152,178,330
2016,10,5,18,112,151,263
2016,10,5,19,100,130,230
2016,10,5,20,73,91,164
2016,10,5,21,36,49,85
2016,10,5,22,15,19,34
2016,10,5,23,14,13,27
2016,10,6,0,10,7,17
2016,10,6,1,14,4,18
2016,10,6,2,11,7,18
2016,10,6,3,16,16,32
2016,10,6,4,118,63,181
2016,10,6,5,218,166,384
2016,10,6,6,401,210,611
2016,10,6,7,257,171,428
2016,10,6,8,233,178,411
2016,10,6,9,201,185,386
2016,10,6,10,224,188,412
2016,10,6,11,221,240,461
2016,10,6,12,216,296,512
2016,10,6,13,279,346,625
2016,10,6,14,240,266,506
2016,10,6,15,192,218,410
2016,10,6,16,186,178,364
2016,10,6,17,162,163,325
2016,10,6,18,111,139,250
2016,10,6,19,76,105,181
2016,10,6,20,62,277,339
2016,10,6,21,38,209,247
2016,10,6,22,28,76,104
2016,10,6,23,18,49,67
2016,10,7,0,12,25,37
2016,10,7,1,11,7,18
2016,10,7,2,5,3,8
2016,10,7,3,19,13,32
2016,10,7,4,127,69,196
2016,10,7,5,226,162,388
2016,10,7,6,346,181,527
2016,10,7,7,283,169,452
2016,10,7,8,211,154,365
2016,10,7,9,230,205,435
2016,10,7,10,249,210,459
2016,10,7,11,253,270,523
2016,10,7,12,266,330,596
2016,10,7,13,287,358,645
2016,10,7,14,196,301,497
2016,10,7,15,176,195,371
2016,10,7,16,159,180,339
2016,10,7,17,130,134,264
2016,10,7,18,110,105,215
2016,10,7,19,83,97,180
2016,10,7,20,73,87,160
2016,10,7,21,51,68,119
2016,10,7,22,37,67,104
2016,10,7,23,21,43,64
2016,10,8,0,30,41,71
2016,10,8,1,21,62,83
2016,10,8,2,10,27,37
2016,10,8,3,11,12,23
2016,10,8,4,21,17,38
2016,10,8,5,36,26,62
2016,10,8,6,39,37,76
2016,10,8,7,63,55,118
2016,10,8,8,101,86,187
2016,10,8,9,159,115,274
2016,10,8,10,181,147,328
2016,10,8,11,148,154,302
2016,10,8,12,151,184,335
2016,10,8,13,126,175,301
2016,10,8,14,107,163,270
2016,10,8,15,125,146,271
2016,10,8,16,130,148,278
2016,10,8,17,98,108,206
2016,10,8,18,87,100,187
2016,10,8,19,69,86,155
2016,10,8,20,45,73,118
2016,10,8,21,61,65,126
2016,10,8,22,38,60,98
2016,10,8,23,41,63,104
2016,10,9,0,30,54,84
2016,10,9,1,37,53,90
2016,10,9,2,17,48,65
2016,10,9,3,8,19,27
2016,10,9,4,10,14,24
2016,10,9,5,18,16,34
2016,10,9,6,24,21,45
2016,10,9,7,49,47,96
2016,10,9,8,93,66,159
2016,10,9,9,103,90,193
2016,10,9,10,155,120,275
2016,10,9,11,122,144,266
2016,10,9,12,150,190,340
2016,10,9,13,161,200,361
2016,10,9,14,160,205,365
2016,10,9,15,145,182,327
2016,10,9,16,160,148,308
2016,10,9,17,142,135,277
2016,10,9,18,113,137,250
2016,10,9,19,76,100,176
2016,10,9,20,74,63,137
2016,10,9,21,31,45,76
2016,10,9,22,12,18,30
2016,10,9,23,8,14,22
2016,10,10,0,6,8,14
2016,10,10,1,8,12,20
2016,10,10,2,7,13,20
2016,10,10,3,19,10,29
2016,10,10,4,120,67,187
2016,10,10,5,214,145,359
2016,10,10,6,316,174,490
2016,10,10,7,250,152,402
2016,10,10,8,229,173,402
2016,10,10,9,218,173,391
2016,10,10,10,186,197,383
2016,10,10,11,207,215,422
2016,10,10,12,228,258,486
2016,10,10,13,207,300,507
2016,10,10,14,207,268,475
2016,10,10,15,192,182,374
2016,10,10,16,166,162,328
2016,10,10,17,130,147,277
2016,10,10,18,130,135,265
2016,10,10,19,81,109,190
2016,10,10,20,61,97,158
2016,10,10,21,40,40,80
2016,10,10,22,18,23,41
2016,10,10,23,8,15,23
2016,10,11,0,5,7,12
2016,10,11,1,2,9,11
2016,10,11,2,6,13,19
2016,10,11,3,16,8,24
2016,10,11,4,123,58,181
2016,10,11,5,221,147,368
2016,10,11,6,296,174,470
2016,10,11,7,227,150,377
2016,10,11,8,189,197,386
2016,10,11,9,211,165,376
2016,10,11,10,214,165,379
2016,10,11,11,196,219,415
2016,10,11,12,217,262,479
2016,10,11,13,250,300,550
2016,10,11,14,229,278,507
2016,10,11,15,192,194,386
2016,10,11,16,190,169,359
2016,10,11,17,128,149,277
2016,10,11,18,98,131,229
2016,10,11,19,83,114,197
2016,10,11,20,58,68,126
2016,10,11,21,29,43,72
2016,10,11,22,21,23,44
2016,10,11,23,10,25,35
2016,10,12,0,10,18,28
2016,10,12,1,6,12,18
2016,10,12,2,4,10,14
2016,10,12,3,14,17,31
2016,10,12,4,122,66,188
2016,10,12,5,208,142,350
2016,10,12,6,285,173,458
2016,10,12,7,257,175,432
2016,10,12,8,225,172,397
2016,10,12,9,223,185,408
2016,10,12,10,202,201,403
2016,10,12,11,205,221,426
2016,10,12,12,194,237,431
2016,10,12,13,247,310,557
2016,10,12,14,217,281,498
2016,10,12,15,197,206,403
2016,10,12,16,146,179,325
2016,10,12,17,127,131,258
2016,10,12,18,114,117,231
2016,10,12,19,77,109,186
2016,10,12,20,69,77,146
2016,10,12,21,43,48,91
2016,10,12,22,21,36,57
2016,10,12,23,12,16,28
2016,10,13,0,8,13,21
2016,10,13,1,6,10,16
2016,10,13,2,2,9,11
2016,10,13,3,15,17,32
2016,10,13,4,117,56,173
2016,10,13,5,213,133,346
2016,10,13,6,255,143,398
2016,10,13,7,213,140,353
2016,10,13,8,221,147,368
2016,10,13,9,195,179,374
2016,10,13,10,212,182,394
2016,10,13,11,201,214,415
2016,10,13,12,214,253,467
2016,10,13,13,238,276,514
2016,10,13,14,202,263,465
2016,10,13,15,181,210,391
2016,10,13,16,124,180,304
2016,10,13,17,136,121,257
2016,10,13,18,104,111,215
2016,10,13,19,92,106,198
2016,10,13,20,62,75,137
2016,10,13,21,36,50,86
2016,10,13,22,21,38,59
2016,10,13,23,8,22,30
2016,10,14,0,16,36,52
2016,10,14,1,7,17,24
2016,10,14,2,8,16,24
2016,10,14,3,18,19,37
2016,10,14,4,117,62,179
2016,10,14,5,201,124,325
2016,10,14,6,233,153,386
2016,10,14,7,225,178,403
2016,10,14,8,231,160,391
2016,10,14,9,192,182,374
2016,10,14,10,230,218,448
2016,10,14,11,248,226,474
2016,10,14,12,219,290,509
2016,10,14,13,221,305,526
2016,10,14,14,199,257,456
2016,10,14,15,163,170,333
2016,10,14,16,153,153,306
2016,10,14,17,103,122,225
2016,10,14,18,91,101,192
2016,10,14,19,89,96,185
2016,10,14,20,61,77,138
2016,10,14,21,48,60,108
2016,10,14,22,30,43,73
2016,10,14,23,20,44,64
2016,10,15,0,17,45,62
2016,10,15,1,23,44,67
2016,10,15,2,15,22,37
2016,10,15,3,11,13,24
2016,10,15,4,18,13,31
2016,10,15,5,33,15,48
2016,10,15,6,40,40,80
2016,10,15,7,66,39,105
2016,10,15,8,96,76,172
2016,10,15,9,148,83,231
2016,10,15,10,159,126,285
2016,10,15,11,143,127,270
2016,10,15,12,139,182,321
2016,10,15,13,131,191,322
2016,10,15,14,112,144,256
2016,10,15,15,136,149,285
2016,10,15,16,127,102,229
2016,10,15,17,93,107,200
2016,10,15,18,71,73,144
2016,10,15,19,57,87,144
2016,10,15,20,44,64,108
2016,10,15,21,39,60,99
2016,10,15,22,42,74,116
2016,10,15,23,36,50,86
2016,10,16,0,45,77,122
2016,10,16,1,27,67,94
2016,10,16,2,17,46,63
2016,10,16,3,12,14,26
2016,10,16,4,17,7,24
2016,10,16,5,17,16,33
2016,10,16,6,29,19,48
2016,10,16,7,33,35,68
2016,10,16,8,68,52,120
2016,10,16,9,100,79,179
2016,10,16,10,132,117,249
2016,10,16,11,143,157,300
2016,10,16,12,161,192,353
2016,10,16,13,172,177,349
2016,10,16,14,181,232,413
2016,10,16,15,148,208,356
2016,10,16,16,151,159,310
2016,10,16,17,153,156,309
2016,10,16,18,152,142,294
2016,10,16,19,79,120,199
2016,10,16,20,55,65,120
2016,10,16,21,30,42,72
2016,10,16,22,20,15,35
2016,10,16,23,10,15,25
2016,10,17,0,7,6,13
2016,10,17,1,6,13,19
2016,10,17,2,5,10,15
2016,10,17,3,16,8,24
2016,10,17,4,125,80,205
2016,10,17,5,235,148,383
2016,10,17,6,375,197,572
2016,10,17,7,273,181,454
2016,10,17,8,222,188,410
2016,10,17,9,202,179,381
2016,10,17,10,208,207,415
2016,10,17,11,210,189,399
2016,10,17,12,218,273,491
2016,10,17,13,266,367,633
2016,10,17,14,249,315,564
2016,10,17,15,210,203,413
2016,10,17,16,172,162,334
2016,10,17,17,151,170,321
2016,10,17,18,133,128,261
2016,10,17,19,75,121,196
2016,10,17,20,40,75,115
2016,10,17,21,42,87,129
2016,10,17,22,19,26,45
2016,10,17,23,11,19,30
2016,10,18,0,6,10,16
2016,10,18,1,7,12,19
2016,10,18,2,3,5,8
2016,10,18,3,19,13,32
2016,10,18,4,132,80,212
2016,10,18,5,233,181,414
2016,10,18,6,393,224,617
2016,10,18,7,270,163,433
2016,10,18,8,232,215,447
2016,10,18,9,193,178,371
2016,10,18,10,220,201,421
2016,10,18,11,224,211,435
2016,10,18,12,215,314,529
2016,10,18,13,250,321,571
2016,10,18,14,220,297,517
2016,10,18,15,226,222,448
2016,10,18,16,179,160,339
2016,10,18,17,155,181,336
2016,10,18,18,100,139,239
2016,10,18,19,109,110,219
2016,10,18,20,55,82,137
2016,10,18,21,27,40,67
2016,10,18,22,12,22,34
2016,10,18,23,8,18,26
2016,10,19,0,12,24,36
2016,10,19,1,6,18,24
2016,10,19,2,9,4,13
2016,10,19,3,25,11,36
2016,10,19,4,128,79,207
2016,10,19,5,223,160,383
2016,10,19,6,386,197,583
2016,10,19,7,225,168,393
2016,10,19,8,218,201,419
2016,10,19,9,222,208,430
2016,10,19,10,213,187,400
2016,10,19,11,227,182,409
2016,10,19,12,211,267,478
2016,10,19,13,250,321,571
2016,10,19,14,222,287,509
2016,10,19,15,200,198,398
2016,10,19,16,190,194,384
2016,10,19,17,153,159,312
2016,10,19,18,105,131,236
2016,10,19,19,97,135,232
2016,10,19,20,79,96,175
2016,10,19,21,34,46,80
2016,10,19,22,21,25,46
2016,10,19,23,16,21,37
2016,10,20,0,9,13,22
2016,10,20,1,14,12,26
2016,10,20,2,7,16,23
2016,10,20,3,20,13,33
2016,10,20,4,116,82,198
2016,10,20,5,230,146,376
2016,10,20,6,351,210,561
2016,10,20,7,251,153,404
2016,10,20,8,224,153,377
2016,10,20,9,221,205,426
2016,10,20,10,231,215,446
2016,10,20,11,206,261,467
2016,10,20,12,226,249,475
2016,10,20,13,259,302,561
2016,10,20,14,216,284,500
2016,10,20,15,202,201,403
2016,10,20,16,192,156,348
2016,10,20,17,162,211,373
2016,10,20,18,114,163,277
2016,10,20,19,98,127,225
2016,10,20,20,46,84,130
2016,10,20,21,38,41,79
2016,10,20,22,23,40,63
2016,10,20,23,22,34,56
2016,10,21,0,13,25,38
2016,10,21,1,10,32,42
2016,10,21,2,6,14,20
2016,10,21,3,23,14,37
2016,10,21,4,122,83,205
2016,10,21,5,221,151,372
2016,10,21,6,385,189,574
2016,10,21,7,235,165,400
2016,10,21,8,217,218,435
2016,10,21,9,225,191,416
2016,10,21,10,247,233,480
2016,10,21,11,231,220,451
2016,10,21,12,264,289,553
2016,10,21,13,285,323,608
2016,10,21,14,206,294,500
2016,10,21,15,147,206,353
2016,10,21,16,168,144,312
2016,10,21,17,134,158,292
2016,10,21,18,95,125,220
2016,10,21,19,75,107,182
2016,10,21,20,57,71,128
2016,10,21,21,47,69,116
2016,10,21,22,34,57,91
2016,10,21,23,22,48,70
2016,10,22,0,25,56,81
2016,10,22,1,23,48,71
2016,10,22,2,15,23,38
2016,10,22,3,15,18,33
2016,10,22,4,15,12,27
2016,10,22,5,34,26,60
2016,10,22,6,45,45,90
2016,10,22,7,81,60,141
2016,10,22,8,108,99,207
2016,10,22,9,131,106,237
2016,10,22,10,179,142,321
2016,10,22,11,156,184,340
2016,10,22,12,152,182,334
2016,10,22,13,146,219,365
2016,10,22,14,143,189,332
2016,10,22,15,138,190,328
2016,10,22,16,123,147,270
2016,10,22,17,97,114,211
2016,10,22,18,122,108,230
2016,10,22,19,73,102,175
2016,10,22,20,49,68,117
2016,10,22,21,49,63,112
2016,10,22,22,45,53,98
2016,10,22,23,35,51,86
2016,10,23,0,30,61,91
2016,10,23,1,33,63,96
2016,10,23,2,16,57,73
2016,10,23,3,10,24,34
2016,10,23,4,16,18,34
2016,10,23,5,11,14,25
2016,10,23,6,29,15,44
2016,10,23,7,40,34,74
2016,10,23,8,116,72,188
2016,10,23,9,120,104,224
2016,10,23,10,134,142,276
2016,10,23,11,188,207,395
2016,10,23,12,242,225,467
2016,10,23,13,174,234,408
2016,10,23,14,183,219,402
2016,10,23,15,178,191,369
2016,10,23,16,149,177,326
2016,10,23,17,167,168,335
2016,10,23,18,104,164,268
2016,10,23,19,83,99,182
2016,10,23,20,42,58,100
2016,10,23,21,33,48,81
2016,10,23,22,19,27,46
2016,10,23,23,13,13,26
2016,10,24,0,11,8,19
2016,10,24,1,6,12,18
2016,10,24,2,7,9,16
2016,10,24,3,17,8,25
2016,10,24,4,121,79,200
2016,10,24,5,235,166,401
2016,10,24,6,360,207,567
2016,10,24,7,264,177,441
2016,10,24,8,218,166,384
2016,10,24,9,202,167,369
2016,10,24,10,221,194,415
2016,10,24,11,222,201,423
2016,10,24,12,237,269,506
2016,10,24,13,253,297,550
2016,10,24,14,222,289,511
2016,10,24,15,200,193,393
2016,10,24,16,167,153,320
2016,10,24,17,148,145,293
2016,10,24,18,123,137,260
2016,10,24,19,97,115,212
2016,10,24,20,68,85,153
2016,10,24,21,35,39,74
2016,10,24,22,14,31,45
2016,10,24,23,15,11,26
2016,10,25,0,8,6,14
2016,10,25,1,5,8,13
2016,10,25,2,4,5,9
2016,10,25,3,14,5,19
2016,10,25,4,114,71,185
2016,10,25,5,236,174,410
2016,10,25,6,393,210,603
2016,10,25,7,251,162,413
2016,10,25,8,221,207,428
2016,10,25,9,221,185,406
2016,10,25,10,217,181,398
2016,10,25,11,219,213,432
2016,10,25,12,213,275,488
2016,10,25,13,254,304,558
2016,10,25,14,222,306,528
2016,10,25,15,239,207,446
2016,10,25,16,210,229,439
2016,10,25,17,155,195,350
2016,10,25,18,116,125,241
2016,10,25,19,91,125,216
2016,10,25,20,58,90,148
2016,10,25,21,35,41,76
2016,10,25,22,22,15,37
2016,10,25,23,13,17,30
2016,10,26,0,5,10,15
2016,10,26,1,6,10,16
2016,10,26,2,1,7,8
2016,10,26,3,21,9,30
2016,10,26,4,105,64,169
2016,10,26,5,253,158,411
2016,10,26,6,395,199,594
2016,10,26,7,287,164,451
2016,10,26,8,233,187,420
2016,10,26,9,231,206,437
2016,10,26,10,228,217,445
2016,10,26,11,251,327,578
2016,10,26,12,227,277,504
2016,10,26,13,250,329,579
2016,10,26,14,258,326,584
2016,10,26,15,223,215,438
2016,10,26,16,183,180,363
2016,10,26,17,157,169,326
2016,10,26,18,120,133,253
2016,10,26,19,109,120,229
2016,10,26,20,50,85,135
2016,10,26,21,33,43,76
2016,10,26,22,16,30,46
2016,10,26,23,14,21,35
2016,10,27,0,10,12,22
2016,10,27,1,5,14,19
2016,10,27,2,6,7,13
2016,10,27,3,15,13,28
2016,10,27,4,126,69,195
2016,10,27,5,225,176,401
2016,10,27,6,399,214,613
2016,10,27,7,262,166,428
2016,10,27,8,253,210,463
2016,10,27,9,226,171,397
2016,10,27,10,206,176,382
2016,10,27,11,222,232,454
2016,10,27,12,231,274,505
2016,10,27,13,260,331,591
2016,10,27,14,241,300,541
2016,10,27,15,217,242,459
2016,10,27,16,182,166,348
2016,10,27,17,152,206,358
2016,10,27,18,125,132,257
2016,10,27,19,95,122,217
2016,10,27,20,79,85,164
2016,10,27,21,49,67,116
2016,10,27,22,29,32,61
2016,10,27,23,11,29,40
2016,10,28,0,10,27,37
2016,10,28,1,8,31,39
2016,10,28,2,5,7,12
2016,10,28,3,18,9,27
2016,10,28,4,123,65,188
2016,10,28,5,251,161,412
2016,10,28,6,369,220,589
2016,10,28,7,309,179,488
2016,10,28,8,211,201,412
2016,10,28,9,244,191,435
2016,10,28,10,260,229,489
2016,10,28,11,232,252,484
2016,10,28,12,237,330,567
2016,10,28,13,276,373,649
2016,10,28,14,192,278,470
2016,10,28,15,184,194,378
2016,10,28,16,155,158,313
2016,10,28,17,134,145,279
2016,10,28,18,108,130,238
2016,10,28,19,90,96,186
2016,10,28,20,81,89,170
2016,10,28,21,61,70,131
2016,10,28,22,44,57,101
2016,10,28,23,32,35,67
2016,10,29,0,21,46,67
2016,10,29,1,21,46,67
2016,10,29,2,10,27,37
2016,10,29,3,11,13,24
2016,10,29,4,23,17,40
2016,10,29,5,32,21,53
2016,10,29,6,40,33,73
2016,10,29,7,94,69,163
2016,10,29,8,100,77,177
2016,10,29,9,168,117,285
2016,10,29,10,169,168,337
2016,10,29,11,204,173,377
2016,10,29,12,185,222,407
2016,10,29,13,163,238,401
2016,10,29,14,155,206,361
2016,10,29,15,136,175,311
2016,10,29,16,138,138,276
2016,10,29,17,129,128,257
2016,10,29,18,90,105,195
2016,10,29,19,65,84,149
2016,10,29,20,62,77,139
2016,10,29,21,55,71,126
2016,10,29,22,47,87,134
2016,10,29,23,42,76,118
2016,10,30,0,46,70,116
2016,10,30,1,25,59,84
2016,10,30,2,24,54,78
2016,10,30,3,15,36,51
2016,10,30,4,8,13,21
2016,10,30,5,18,14,32
2016,10,30,6,15,20,35
2016,10,30,7,33,19,52
2016,10,30,8,50,39,89
2016,10,30,9,127,88,215
2016,10,30,10,130,87,217
2016,10,30,11,172,161,333
2016,10,30,12,183,232,415
2016,10,30,13,198,221,419
2016,10,30,14,198,208,406
2016,10,30,15,184,238,422
2016,10,30,16,176,204,380
2016,10,30,17,139,159,298
2016,10,30,18,135,156,291
2016,10,30,19,112,131,243
2016,10,30,20,82,106,188
2016,10,30,21,58,79,137
2016,10,30,22,28,28,56
2016,10,30,23,16,28,44
2016,10,31,0,11,13,24
2016,10,31,1,5,7,12
2016,10,31,2,8,15,23
2016,10,31,3,3,12,15
2016,10,31,4,21,12,33
2016,10,31,5,135,78,213
2016,10,31,6,244,172,416
2016,10,31,7,382,189,571
2016,10,31,8,268,183,451
2016,10,31,9,210,170,380
2016,10,31,10,212,190,402
2016,10,31,11,220,186,406
2016,10,31,12,221,230,451
2016,10,31,13,208,294,502
2016,10,31,14,261,292,553
2016,10,31,15,239,318,557
2016,10,31,16,194,202,396
2016,10,31,17,145,156,301
2016,10,31,18,133,122,255
2016,10,31,19,95,138,233
2016,10,31,20,82,129,211
2016,10,31,21,63,90,153
2016,10,31,22,28,37,65
2016,10,31,23,16,21,37
2016,11,1,0,4,16,20
2016,11,1,1,6,6,12
2016,11,1,2,6,5,11
2016,11,1,3,6,8,14
2016,11,1,4,18,5,23
2016,11,1,5,145,98,243
2016,11,1,6,252,168,420
2016,11,1,7,379,193,572
2016,11,1,8,256,167,423
2016,11,1,9,217,191,408
2016,11,1,10,227,179,406
2016,11,1,11,219,203,422
2016,11,1,12,194,212,406
2016,11,1,13,231,280,511
2016,11,1,14,277,313,590
2016,11,1,15,260,292,552
2016,11,1,16,242,219,461
2016,11,1,17,198,164,362
2016,11,1,18,135,190,325
2016,11,1,19,112,141,253
2016,11,1,20,78,103,181
2016,11,1,21,68,96,164
2016,11,1,22,30,62,92
2016,11,1,23,13,26,39
2016,11,2,0,7,18,25
2016,11,2,1,5,13,18
2016,11,2,2,4,17,21
2016,11,2,3,7,9,16
2016,11,2,4,12,7,19
2016,11,2,5,110,67,177
2016,11,2,6,225,149,374
2016,11,2,7,384,214,598
2016,11,2,8,263,161,424
2016,11,2,9,198,181,379
2016,11,2,10,230,195,425
2016,11,2,11,201,197,398
2016,11,2,12,207,211,418
2016,11,2,13,209,242,451
2016,11,2,14,266,317,583
2016,11,2,15,232,274,506
2016,11,2,16,217,202,419
2016,11,2,17,194,183,377
2016,11,2,18,130,149,279
2016,11,2,19,107,147,254
2016,11,2,20,74,113,187
2016,11,2,21,49,129,178
2016,11,2,22,19,45,64
2016,11,2,23,18,35,53
2016,11,3,0,6,25,31
2016,11,3,1,8,11,19
2016,11,3,2,6,17,23
2016,11,3,3,7,14,21
2016,11,3,4,16,14,30
2016,11,3,5,108,70,178
2016,11,3,6,224,153,377
2016,11,3,7,371,208,579
2016,11,3,8,227,151,378
2016,11,3,9,243,198,441
2016,11,3,10,236,198,434
2016,11,3,11,225,220,445
2016,11,3,12,202,214,416
2016,11,3,13,226,241,467
2016,11,3,14,267,322,589
2016,11,3,15,246,311,557
2016,11,3,16,232,207,439
2016,11,3,17,195,187,382
2016,11,3,18,131,160,291
2016,11,3,19,110,151,261
2016,11,3,20,96,119,215
2016,11,3,21,55,65,120
2016,11,3,22,33,49,82
2016,11,3,23,23,27,50
2016,11,4,0,8,22,30
2016,11,4,1,12,38,50
2016,11,4,2,12,35,47
2016,11,4,3,5,12,17
2016,11,4,4,12,17,29
2016,11,4,5,120,76,196
2016,11,4,6,219,160,379
2016,11,4,7,396,225,621
2016,11,4,8,254,186,440
2016,11,4,9,244,163,407
2016,11,4,10,234,171,405
2016,11,4,11,201,239,440
2016,11,4,12,212,220,432
2016,11,4,13,276,291,567
2016,11,4,14,270,323,593
2016,11,4,15,228,291,519
2016,11,4,16,175,177,352
2016,11,4,17,175,162,337
2016,11,4,18,123,138,261
2016,11,4,19,79,96,175
2016,11,4,20,65,82,147
2016,11,4,21,79,70,149
2016,11,4,22,41,66,107
2016,11,4,23,35,53,88
2016,11,5,0,23,51,74
2016,11,5,1,17,58,75
2016,11,5,2,17,53,70
2016,11,5,3,15,27,42
2016,11,5,4,5,15,20
2016,11,5,5,21,15,36
2016,11,5,6,52,37,89
2016,11,5,7,68,47,115
2016,11,5,8,83,69,152
2016,11,5,9,169,107,276
2016,11,5,10,131,116,247
2016,11,5,11,180,142,322
2016,11,5,12,147,163,310
2016,11,5,13,188,207,395
2016,11,5,14,157,276,433
2016,11,5,15,144,210,354
2016,11,5,16,151,157,308
2016,11,5,17,140,134,274
2016,11,5,18,112,120,232
2016,11,5,19,78,101,179
2016,11,5,20,55,82,137
2016,11,5,21,63,74,137
2016,11,5,22,45,60,105
2016,11,5,23,35,75,110
2016,11,6,0,32,64,96
2016,11,6,1,37,67,104
2016,11,6,2,34,66,100
2016,11,6,3,20,49,69
2016,11,6,4,13,21,34
2016,11,6,5,10,16,26
2016,11,6,6,12,15,27
2016,11,6,7,23,21,44
2016,11,6,8,51,54,105
2016,11,6,9,105,60,165
2016,11,6,10,116,90,206
2016,11,6,11,177,167,344
2016,11,6,12,180,190,370
2016,11,6,13,214,186,400
2016,11,6,14,204,247,451
2016,11,6,15,189,275,464
2016,11,6,16,232,272,504
2016,11,6,17,168,164,332
2016,11,6,18,121,204,325
2016,11,6,19,211,151,362
2016,11,6,20,83,95,178
2016,11,6,21,54,62,116
2016,11,6,22,28,49,77
2016,11,6,23,6,31,37
2016,11,7,0,7,13,20
2016,11,7,1,4,11,15
2016,11,7,2,3,11,14
2016,11,7,3,4,15,19
2016,11,7,4,14,15,29
2016,11,7,5,124,76,200
2016,11,7,6,216,173,389
2016,11,7,7,401,197,598
2016,11,7,8,263,170,433
2016,11,7,9,229,190,419
2016,11,7,10,225,187,412
2016,11,7,11,240,215,455
2016,11,7,12,211,211,422
2016,11,7,13,182,292,474
2016,11,7,14,238,318,556
2016,11,7,15,242,286,528
2016,11,7,16,212,202,414
2016,11,7,17,162,165,327
2016,11,7,18,121,135,256
2016,11,7,19,114,118,232
2016,11,7,20,85,116,201
2016,11,7,21,26,97,123
2016,11,7,22,16,33,49
2016,11,7,23,7,20,27
2016,11,8,0,5,10,15
2016,11,8,1,2,10,12
2016,11,8,2,6,9,15
2016,11,8,3,4,12,16
2016,11,8,4,15,8,23
2016,11,8,5,125,72,197
2016,11,8,6,245,163,408
2016,11,8,7,396,209,605
2016,11,8,8,254,170,424
2016,11,8,9,220,178,398
2016,11,8,10,228,182,410
2016,11,8,11,214,202,416
2016,11,8,12,192,229,421
2016,11,8,13,221,283,504
2016,11,8,14,262,318,580
2016,11,8,15,223,287,510
2016,11,8,16,209,198,407
2016,11,8,17,205,177,382
2016,11,8,18,159,167,326
2016,11,8,19,110,135,245
2016,11,8,20,90,129,219
2016,11,8,21,44,79,123
2016,11,8,22,10,33,43
2016,11,8,23,9,22,31
2016,11,9,0,5,21,26
2016,11,9,1,13,18,31
2016,11,9,2,6,14,20
2016,11,9,3,4,9,13
2016,11,9,4,16,16,32
2016,11,9,5,116,73,189
2016,11,9,6,251,182,433
2016,11,9,7,378,216,594
2016,11,9,8,231,164,395
2016,11,9,9,237,169,406
2016,11,9,10,226,176,402
2016,11,9,11,85,70,155
2016,11,10,14,161,203,364
2016,11,10,15,244,316,560
2016,11,10,16,231,183,414
2016,11,10,17,189,161,350
2016,11,10,18,172,190,362
2016,11,10,19,102,144,246
2016,11,10,20,76,97,173
2016,11,10,21,67,103,170
2016,11,10,22,36,57,93
2016,11,10,23,26,28,54
2016,11,11,0,11,31,42
2016,11,11,1,6,20,26
2016,11,11,2,13,24,37
2016,11,11,3,11,21,32
2016,11,11,4,20,20,40
2016,11,11,5,95,57,152
2016,11,11,6,227,149,376
2016,11,11,7,345,201,546
2016,11,11,8,242,177,419
2016,11,11,9,238,186,424
2016,11,11,10,234,186,420
2016,11,11,11,233,207,440
2016,11,11,12,235,243,478
2016,11,11,13,248,263,511
2016,11,11,14,258,341,599
2016,11,11,15,176,254,430
2016,11,11,16,194,176,370
2016,11,11,17,165,159,324
2016,11,11,18,128,136,264
2016,11,11,19,96,91,187
2016,11,11,20,75,94,169
2016,11,11,21,61,81,142
2016,11,11,22,50,55,105
2016,11,11,23,49,75,124
2016,11,12,0,27,33,60
2016,11,12,1,36,57,93
2016,11,12,2,20,55,75
2016,11,12,3,7,31,38
2016,11,12,4,13,14,27
2016,11,12,5,31,13,44
2016,11,12,6,30,28,58
2016,11,12,7,38,42,80
2016,11,12,8,86,57,143
2016,11,12,9,135,92,227
2016,11,12,10,147,108,255
2016,11,12,11,157,128,285
2016,11,12,12,182,179,361
2016,11,12,13,142,242,384
2016,11,12,14,154,236,390
2016,11,12,15,138,182,320
2016,11,12,16,136,169,305
2016,11,12,17,146,146,292
2016,11,12,18,121,130,251
2016,11,12,19,85,97,182
2016,11,12,20,76,77,153
2016,11,12,21,52,60,112
2016,11,12,22,58,72,130
2016,11,12,23,48,71,119
2016,11,13,0,39,70,109
2016,11,13,1,37,73,110
2016,11,13,2,30,79,109
2016,11,13,3,20,47,67
2016,11,13,4,16,26,42
2016,11,13,5,11,16,27
2016,11,13,6,12,11,23
2016,11,13,7,26,19,45
2016,11,13,8,46,29,75
2016,11,13,9,129,62,191
2016,11,13,10,123,102,225
2016,11,13,11,142,158,300
2016,11,13,12,173,184,357
2016,11,13,13,194,213,407
2016,11,13,14,177,264,441
2016,11,13,15,163,223,386
2016,11,13,16,178,160,338
2016,11,13,17,163,152,315
2016,11,13,18,158,176,334
2016,11,13,19,115,150,265
2016,11,13,20,84,118,202
2016,11,13,21,71,80,151
2016,11,13,22,26,47,73
2016,11,13,23,21,19,40
2016,11,14,0,12,19,31
2016,11,14,1,8,10,18
2016,11,14,2,3,10,13
2016,11,14,3,4,8,12
2016,11,14,4,14,19,33
2016,11,14,5,130,70,200
2016,11,14,6,226,163,389
2016,11,14,7,395,210,605
2016,11,14,8,270,170,440
2016,11,14,9,204,184,388
2016,11,14,10,189,170,359
2016,11,14,11,218,200,418
2016,11,14,12,196,213,409
2016,11,14,13,194,239,433
2016,11,14,14,252,327,579
2016,11,14,15,209,317,526
2016,11,14,16,198,191,389
2016,11,14,17,157,149,306
2016,11,14,18,103,150,253
2016,11,14,19,102,110,212
2016,11,14,20,89,112,201
2016,11,14,21,61,85,146
2016,11,14,22,29,30,59
2016,11,14,23,17,23,40
2016,11,15,0,9,9,18
2016,11,15,1,6,8,14
2016,11,15,2,10,11,21
2016,11,15,3,6,10,16
2016,11,15,4,21,6,27
2016,11,15,5,113,66,179
2016,11,15,6,227,161,388
2016,11,15,7,383,207,590
2016,11,15,8,274,164,438
2016,11,15,9,205,189,394
2016,11,15,10,238,195,433
2016,11,15,11,233,209,442
2016,11,15,12,218,230,448
2016,11,15,13,202,290,492
2016,11,15,14,265,303,568
2016,11,15,15,265,318,583
2016,11,15,16,213,211,424
2016,11,15,17,183,141,324
2016,11,15,18,140,155,295
2016,11,15,19,135,163,298
2016,11,15,20,80,129,209
2016,11,15,21,63,85,148
2016,11,15,22,32,89,121
2016,11,15,23,11,39,50
2016,11,16,0,13,16,29
2016,11,16,1,8,19,27
2016,11,16,2,5,10,15
2016,11,16,3,8,10,18
2016,11,16,4,13,9,22
2016,11,16,5,107,69,176
2016,11,16,6,227,160,387
2016,11,16,7,407,202,609
2016,11,16,8,242,160,402
2016,11,16,9,232,169,401
2016,11,16,10,201,174,375
2016,11,16,11,231,196,427
2016,11,16,12,233,224,457
2016,11,16,13,215,281,496
2016,11,16,14,275,330,605
2016,11,16,15,280,299,579
2016,11,16,16,218,230,448
2016,11,16,17,167,168,335
2016,11,16,18,156,156,312
2016,11,16,19,125,139,264
2016,11,16,20,86,127,213
2016,11,16,21,79,91,170
2016,11,16,22,37,43,80
2016,11,16,23,24,25,49
2016,11,17,0,6,20,26
2016,11,17,1,10,7,17
2016,11,17,2,5,10,15
2016,11,17,3,5,10,15
2016,11,17,4,21,9,30
2016,11,17,5,112,63,175
2016,11,17,6,226,157,383
2016,11,17,7,411,204,615
2016,11,17,8,239,172,411
2016,11,17,9,247,173,420
2016,11,17,10,219,166,385
2016,11,17,11,209,219,428
2016,11,17,12,211,230,441
2016,11,17,13,240,276,516
2016,11,17,14,257,343,600
2016,11,17,15,273,332,605
2016,11,17,16,225,209,434
2016,11,17,17,186,191,377
2016,11,17,18,154,188,342
2016,11,17,19,127,138,265
2016,11,17,20,81,128,209
2016,11,17,21,69,445,514
2016,11,17,22,41,337,378
2016,11,17,23,20,171,191
2016,11,18,0,11,70,81
2016,11,18,1,8,59,67
2016,11,18,2,17,49,66
2016,11,18,3,9,43,52
2016,11,18,4,18,50,68
2016,11,18,5,122,66,188
2016,11,18,6,224,151,375
2016,11,18,7,373,209,582
2016,11,18,8,259,158,417
2016,11,18,9,206,153,359
2016,11,18,10,230,207,437
2016,11,18,11,220,227,447
2016,11,18,12,208,240,448
2016,11,18,13,238,242,480
2016,11,18,14,274,383,657
2016,11,18,15,234,315,549
2016,11,18,16,172,186,358
2016,11,18,17,148,183,331
2016,11,18,18,125,146,271
2016,11,18,19,98,95,193
2016,11,18,20,85,97,182
2016,11,18,21,63,89,152
2016,11,18,22,41,69,110
2016,11,18,23,47,69,116
2016,11,19,0,27,52,79
2016,11,19,1,26,48,74
2016,11,19,2,20,55,75
2016,11,19,3,17,46,63
2016,11,19,4,13,18,31
2016,11,19,5,32,16,48
2016,11,19,6,26,19,45
2016,11,19,7,46,50,96
2016,11,19,8,98,67,165
2016,11,19,9,123,99,222
2016,11,19,10,157,116,273
2016,11,19,11,190,159,349
2016,11,19,12,167,140,307
2016,11,19,13,157,220,377
2016,11,19,14,160,184,344
2016,11,19,15,127,176,303
2016,11,19,16,144,172,316
2016,11,19,17,146,159,305
2016,11,19,18,121,146,267
2016,11,19,19,93,84,177
2016,11,19,20,60,91,151
2016,11,19,21,47,73,120
2016,11,19,22,48,72,120
2016,11,19,23,39,66,105
2016,11,20,0,37,57,94
2016,11,20,1,25,63,88
2016,11,20,2,35,67,102
2016,11,20,3,22,58,80
2016,11,20,4,12,27,39
2016,11,20,5,22,28,50
2016,11,20,6,18,16,34
2016,11,20,7,28,26,54
2016,11,20,8,45,46,91
2016,11,20,9,94,61,155
2016,11,20,10,96,102,198
2016,11,20,11,139,152,291
2016,11,20,12,148,176,324
2016,11,20,13,173,166,339
2016,11,20,14,192,262,454
2016,11,20,15,165,199,364
2016,11,20,16,183,188,371
2016,11,20,17,161,146,307
2016,11,20,18,131,163,294
2016,11,20,19,95,148,243
2016,11,20,20,73,117,190
2016,11,20,21,54,63,117
2016,11,20,22,28,55,83
2016,11,20,23,17,24,41
2016,11,21,0,12,13,25
2016,11,21,1,8,17,25
2016,11,21,2,7,13,20
2016,11,21,3,6,10,16
2016,11,21,4,17,9,26
2016,11,21,5,125,72,197
2016,11,21,6,214,179,393
2016,11,21,7,366,209,575
2016,11,21,8,287,184,471
2016,11,21,9,228,172,400
2016,11,21,10,197,165,362
2016,11,21,11,212,186,398
2016,11,21,12,209,218,427
2016,11,21,13,199,273,472
2016,11,21,14,244,346,590
2016,11,21,15,226,313,539
2016,11,21,16,219,199,418
2016,11,21,17,157,144,301
2016,11,21,18,124,177,301
2016,11,21,19,122,132,254
2016,11,21,20,89,123,212
2016,11,21,21,51,72,123
2016,11,21,22,31,29,60
2016,11,21,23,15,18,33
2016,11,22,0,10,6,16
2016,11,22,1,5,10,15
2016,11,22,2,5,4,9
2016,11,22,3,2,7,9
2016,11,22,4,16,8,24
2016,11,22,5,107,61,168
2016,11,22,6,224,164,388
2016,11,22,7,375,235,610
2016,11,22,8,253,167,420
2016,11,22,9,217,173,390
2016,11,22,10,211,200,411
2016,11,22,11,232,217,449
2016,11,22,12,203,209,412
2016,11,22,13,218,244,462
2016,11,22,14,274,326,600
2016,11,22,15,236,325,561
2016,11,22,16,193,220,413
2016,11,22,17,204,157,361
2016,11,22,18,126,171,297
2016,11,22,19,135,120,255
2016,11,22,20,97,116,213
2016,11,22,21,72,110,182
2016,11,22,22,36,43,79
2016,11,22,23,17,23,40
2016,11,23,0,9,20,29
2016,11,23,1,7,20,27
2016,11,23,2,7,9,16
2016,11,23,3,5,10,15
2016,11,23,4,18,19,37
2016,11,23,5,107,59,166
2016,11,23,6,243,171,414
2016,11,23,7,370,230,600
2016,11,23,8,286,163,449
2016,11,23,9,214,185,399
2016,11,23,10,206,193,399
2016,11,23,11,225,201,426
2016,11,23,12,222,223,445
2016,11,23,13,203,259,462
2016,11,23,14,237,320,557
2016,11,23,15,228,259,487
2016,11,23,16,183,204,387
2016,11,23,17,172,156,328
2016,11,23,18,144,164,308
2016,11,23,19,108,145,253
2016,11,23,20,96,110,206
2016,11,23,21,65,255,320
2016,11,23,22,32,168,200
2016,11,23,23,17,69,86
2016,11,24,0,10,40,50
2016,11,24,1,13,15,28
2016,11,24,2,12,16,28
2016,11,24,3,9,17,26
2016,11,24,4,15,13,28
2016,11,24,5,105,53,158
2016,11,24,6,231,156,387
2016,11,24,7,344,220,564
2016,11,24,8,271,150,421
2016,11,24,9,230,155,385
2016,11,24,10,205,180,385
2016,11,24,11,209,182,391
2016,11,24,12,216,214,430
2016,11,24,13,196,263,459
2016,11,24,14,271,324,595
2016,11,24,15,235,331,566
2016,11,24,16,224,214,438
2016,11,24,17,165,165,330
2016,11,24,18,154,193,347
2016,11,24,19,124,112,236
2016,11,24,20,88,122,210
2016,11,24,21,59,101,160
2016,11,24,22,36,65,101
2016,11,24,23,20,31,51
2016,11,25,0,10,29,39
2016,11,25,1,18,27,45
2016,11,25,2,22,31,53
2016,11,25,3,14,20,34
2016,11,25,4,15,7,22
2016,11,25,5,105,54,159
2016,11,25,6,243,154,397
2016,11,25,7,366,229,595
2016,11,25,8,248,179,427
2016,11,25,9,214,173,387
2016,11,25,10,227,188,415
2016,11,25,11,194,229,423
2016,11,25,12,231,223,454
2016,11,25,13,294,289,583
2016,11,25,14,299,329,628
2016,11,25,15,214,275,489
2016,11,25,16,210,206,416
2016,11,25,17,184,194,378
2016,11,25,18,148,193,341
2016,11,25,19,87,117,204
2016,11,25,20,85,96,181
2016,11,25,21,59,78,137
2016,11,25,22,59,68,127
2016,11,25,23,54,63,117
2016,11,26,0,27,53,80
2016,11,26,1,21,47,68
2016,11,26,2,23,44,67
2016,11,26,3,7,34,41
2016,11,26,4,7,15,22
2016,11,26,5,23,18,41
2016,11,26,6,32,23,55
2016,11,26,7,25,28,53
2016,11,26,8,73,63,136
2016,11,26,9,122,99,221
2016,11,26,10,145,117,262
2016,11,26,11,179,166,345
2016,11,26,12,171,165,336
2016,11,26,13,196,172,368
2016,11,26,14,264,232,496
2016,11,26,15,247,167,414
2016,11,26,16,169,432,601
2016,11,26,17,126,207,333
2016,11,26,18,112,131,243
2016,11,26,19,84,120,204
2016,11,26,20,56,81,137
2016,11,26,21,55,69,124
2016,11,26,22,42,64,106
2016,11,26,23,53,71,124
2016,11,27,0,28,55,83
2016,11,27,1,30,75,105
2016,11,27,2,30,61,91
2016,11,27,3,21,45,66
2016,11,27,4,25,23,48
2016,11,27,5,10,18,28
2016,11,27,6,10,17,27
2016,11,27,7,28,20,48
2016,11,27,8,41,38,79
2016,11,27,9,111,62,173
2016,11,27,10,114,101,215
2016,11,27,11,149,178,327
2016,11,27,12,162,156,318
2016,11,27,13,184,195,379
2016,11,27,14,178,254,432
2016,11,27,15,157,206,363
2016,11,27,16,182,195,377
2016,11,27,17,146,178,324
2016,11,27,18,130,154,284
2016,11,27,19,125,174,299
2016,11,27,20,55,111,166
2016,11,27,21,54,80,134
2016,11,27,22,32,41,73
2016,11,27,23,13,25,38
2016,11,28,0,8,16,24
2016,11,28,1,7,12,19
2016,11,28,2,11,16,27
2016,11,28,3,6,9,15
2016,11,28,4,19,15,34
2016,11,28,5,105,73,178
2016,11,28,6,219,141,360
2016,11,28,7,377,193,570
2016,11,28,8,261,181,442
2016,11,28,9,241,199,440
2016,11,28,10,197,159,356
2016,11,28,11,202,214,416
2016,11,28,12,210,191,401
2016,11,28,13,188,265,453
2016,11,28,14,255,302,557
2016,11,28,15,212,296,508
2016,11,28,16,205,214,419
2016,11,28,17,177,147,324
2016,11,28,18,137,134,271
2016,11,28,19,121,133,254
2016,11,28,20,95,106,201
2016,11,28,21,62,78,140
2016,11,28,22,23,35,58
2016,11,28,23,18,23,41
2016,11,29,0,14,14,28
2016,11,29,1,4,9,13
2016,11,29,2,7,13,20
2016,11,29,3,9,8,17
2016,11,29,4,16,16,32
2016,11,29,5,112,72,184
2016,11,29,6,229,146,375
2016,11,29,7,371,207,578
2016,11,29,8,275,174,449
2016,11,29,9,186,196,382
2016,11,29,10,246,193,439
2016,11,29,11,214,184,398
2016,11,29,12,242,226,468
2016,11,29,13,231,256,487
2016,11,29,14,261,336,597
2016,11,29,15,259,313,572
2016,11,29,16,216,228,444
2016,11,29,17,171,169,340
2016,11,29,18,141,142,283
2016,11,29,19,110,143,253
2016,11,29,20,70,117,187
2016,11,29,21,55,77,132
2016,11,29,22,31,47,78
2016,11,29,23,17,22,39
2016,11,30,0,9,18,27
2016,11,30,1,7,20,27
2016,11,30,2,2,15,17
2016,11,30,3,5,8,13
2016,11,30,4,18,14,32
2016,11,30,5,116,71,187
2016,11,30,6,213,165,378
2016,11,30,7,403,223,626
2016,11,30,8,254,162,416
2016,11,30,9,179,179,358
2016,11,30,10,232,178,410
2016,11,30,11,193,191,384
2016,11,30,12,201,195,396
2016,11,30,13,220,275,495
2016,11,30,14,279,325,604
2016,11,30,15,259,300,559
2016,11,30,16,223,224,447
2016,11,30,17,160,167,327
2016,11,30,18,148,159,307
2016,11,30,19,110,162,272
2016,11,30,20,100,129,229
2016,11,30,21,76,96,172
2016,11,30,22,38,62,100
2016,11,30,23,23,44,67
2016,12,1,0,17,18,35
2016,12,1,1,9,17,26
2016,12,1,2,6,10,16
2016,12,1,3,7,18,25
2016,12,1,4,16,13,29
2016,12,1,5,107,77,184
2016,12,1,6,217,160,377
2016,12,1,7,402,208,610
2016,12,1,8,260,168,428
2016,12,1,9,228,223,451
2016,12,1,10,201,158,359
2016,12,1,11,196,195,391
2016,12,1,12,242,232,474
2016,12,1,13,234,261,495
2016,12,1,14,287,364,651
2016,12,1,15,224,307,531
2016,12,1,16,209,238,447
2016,12,1,17,208,189,397
2016,12,1,18,156,158,314
2016,12,1,19,113,151,264
2016,12,1,20,101,136,237
2016,12,1,21,43,78,121
2016,12,1,22,27,61,88
2016,12,1,23,18,35,53
2016,12,2,0,11,27,38
2016,12,2,1,10,20,30
2016,12,2,2,5,21,26
2016,12,2,3,5,19,24
2016,12,2,4,10,12,22
2016,12,2,5,88,71,159
2016,12,2,6,211,155,366
2016,12,2,7,366,183,549
2016,12,2,8,238,158,396
2016,12,2,9,234,186,420
2016,12,2,10,235,198,433
2016,12,2,11,244,235,479
2016,12,2,12,260,246,506
2016,12,2,13,268,263,531
2016,12,2,14,261,391,652
2016,12,2,15,238,270,508
2016,12,2,16,207,207,414
2016,12,2,17,185,198,383
2016,12,2,18,154,186,340
2016,12,2,19,95,138,233
2016,12,2,20,68,94,162
2016,12,2,21,52,82,134
2016,12,2,22,57,77,134
2016,12,2,23,36,62,98
2016,12,3,0,38,53,91
2016,12,3,1,35,39,74
2016,12,3,2,23,59,82
2016,12,3,3,5,31,36
2016,12,3,4,12,16,28
2016,12,3,5,28,14,42
2016,12,3,6,34,19,53
2016,12,3,7,54,31,85
2016,12,3,8,75,56,131
2016,12,3,9,130,85,215
2016,12,3,10,163,122,285
2016,12,3,11,171,145,316
2016,12,3,12,184,191,375
2016,12,3,13,186,203,389
2016,12,3,14,161,212,373
2016,12,3,15,154,192,346
2016,12,3,16,167,222,389
2016,12,3,17,135,175,310
2016,12,3,18,117,123,240
2016,12,3,19,93,95,188
2016,12,3,20,61,95,156
2016,12,3,21,60,62,122
2016,12,3,22,39,69,108
2016,12,3,23,33,67,100
2016,12,4,0,44,51,95
2016,12,4,1,28,57,85
2016,12,4,2,39,58,97
2016,12,4,3,21,53,74
2016,12,4,4,19,32,51
2016,12,4,5,18,12,30
2016,12,4,6,19,17,36
2016,12,4,7,36,20,56
2016,12,4,8,33,31,64
2016,12,4,9,114,66,180
2016,12,4,10,111,97,208
2016,12,4,11,156,161,317
2016,12,4,12,172,179,351
2016,12,4,13,188,153,341
2016,12,4,14,167,199,366
2016,12,4,15,197,239,436
2016,12,4,16,150,192,342
2016,12,4,17,148,189,337
2016,12,4,18,134,163,297
2016,12,4,19,116,179,295
2016,12,4,20,73,109,182
2016,12,4,21,59,67,126
2016,12,4,22,34,60,94
2016,12,4,23,10,28,38
2016,12,5,0,13,19,32
2016,12,5,1,9,12,21
2016,12,5,2,5,11,16
2016,12,5,3,7,5,12
2016,12,5,4,14,17,31
2016,12,5,5,116,69,185
2016,12,5,6,236,141,377
2016,12,5,7,401,195,596
2016,12,5,8,259,166,425
2016,12,5,9,191,169,360
2016,12,5,10,219,174,393
2016,12,5,11,202,196,398
2016,12,5,12,240,199,439
2016,12,5,13,182,248,430
2016,12,5,14,246,346,592
2016,12,5,15,218,285,503
2016,12,5,16,212,200,412
2016,12,5,17,162,170,332
2016,12,5,18,121,154,275
2016,12,5,19,101,125,226
2016,12,5,20,77,111,188
2016,12,5,21,74,83,157
2016,12,5,22,32,38,70
2016,12,5,23,17,29,46
2016,12,6,0,14,18,32
2016,12,6,1,14,13,27
2016,12,6,2,8,10,18
2016,12,6,3,10,13,23
2016,12,6,4,14,10,24
2016,12,6,5,103,64,167
2016,12,6,6,210,151,361
2016,12,6,7,420,200,620
2016,12,6,8,266,155,421
2016,12,6,9,203,181,384
2016,12,6,10,198,190,388
2016,12,6,11,220,209,429
2016,12,6,12,201,192,393
2016,12,6,13,250,262,512
2016,12,6,14,257,297,554
2016,12,6,15,222,281,503
2016,12,6,16,201,211,412
2016,12,6,17,218,196,414
2016,12,6,18,161,161,322
2016,12,6,19,113,151,264
2016,12,6,20,73,121,194
2016,12,6,21,68,106,174
2016,12,6,22,47,91,138
2016,12,6,23,16,27,43
2016,12,7,0,14,11,25
2016,12,7,1,8,11,19
2016,12,7,2,8,17,25
2016,12,7,3,4,7,11
2016,12,7,4,17,13,30
2016,12,7,5,108,62,170
2016,12,7,6,261,168,429
2016,12,7,7,394,237,631
2016,12,7,8,244,167,411
2016,12,7,9,217,171,388
2016,12,7,10,204,222,426
2016,12,7,11,215,202,417
2016,12,7,12,205,234,439
2016,12,7,13,229,284,513
2016,12,7,14,279,316,595
2016,12,7,15,288,321,609
2016,12,7,16,229,214,443
2016,12,7,17,178,170,348
2016,12,7,18,160,161,321
2016,12,7,19,122,151,273
2016,12,7,20,95,117,212
2016,12,7,21,84,102,186
2016,12,7,22,41,59,100
2016,12,7,23,22,34,56
2016,12,8,0,11,11,22
2016,12,8,1,10,16,26
2016,12,8,2,8,13,21
2016,12,8,3,8,16,24
2016,12,8,4,24,9,33
2016,12,8,5,108,68,176
2016,12,8,6,243,148,391
2016,12,8,7,377,215,592
2016,12,8,8,284,204,488
2016,12,8,9,208,189,397
2016,12,8,10,244,200,444
2016,12,8,11,220,211,431
2016,12,8,12,212,207,419
2016,12,8,13,211,232,443
2016,12,8,14,262,340,602
2016,12,8,15,231,287,518
2016,12,8,16,194,215,409
2016,12,8,17,170,154,324
2016,12,8,18,138,191,329
2016,12,8,19,102,131,233
2016,12,8,20,87,117,204
2016,12,8,21,68,113,181
2016,12,8,22,46,64,110
2016,12,8,23,29,32,61
2016,12,9,0,7,31,38
2016,12,9,1,15,35,50
2016,12,9,2,14,26,40
2016,12,9,3,10,11,21
2016,12,9,4,18,12,30
2016,12,9,5,113,62,175
2016,12,9,6,222,149,371
2016,12,9,7,369,202,571
2016,12,9,8,233,181,414
2016,12,9,9,239,177,416
2016,12,9,10,227,178,405
2016,12,9,11,272,232,504
2016,12,9,12,224,250,474
2016,12,9,13,234,311,545
2016,12,9,14,313,384,697
2016,12,9,15,237,305,542
2016,12,9,16,198,203,401
2016,12,9,17,154,179,333
2016,12,9,18,138,155,293
2016,12,9,19,91,124,215
2016,12,9,20,59,78,137
2016,12,9,21,55,81,136
2016,12,9,22,54,69,123
2016,12,9,23,50,57,107
2016,12,10,0,29,48,77
2016,12,10,1,29,52,81
2016,12,10,2,24,44,68
2016,12,10,3,12,29,41
2016,12,10,4,9,21,30
2016,12,10,5,20,15,35
2016,12,10,6,30,18,48
2016,12,10,7,40,34,74
2016,12,10,8,74,50,124
2016,12,10,9,108,86,194
2016,12,10,10,152,126,278
2016,12,10,11,187,155,342
2016,12,10,12,240,212,452
2016,12,10,13,217,231,448
2016,12,10,14,174,230,404
2016,12,10,15,131,179,310
2016,12,10,16,163,205,368
2016,12,10,17,158,174,332
2016,12,10,18,110,137,247
2016,12,10,19,94,96,190
2016,12,10,20,52,85,137
2016,12,10,21,69,69,138
2016,12,10,22,35,80,115
2016,12,10,23,46,68,114
2016,12,11,0,47,53,100
2016,12,11,1,36,63,99
2016,12,11,2,27,50,77
2016,12,11,3,22,47,69
2016,12,11,4,17,32,49
2016,12,11,5,21,23,44
2016,12,11,6,14,14,28
2016,12,11,7,31,16,47
2016,12,11,8,49,29,78
2016,12,11,9,114,50,164
2016,12,11,10,109,88,197
2016,12,11,11,149,126,275
2016,12,11,12,178,190,368
2016,12,11,13,188,209,397
2016,12,11,14,163,184,347
2016,12,11,15,145,220,365
2016,12,11,16,173,180,353
2016,12,11,17,138,166,304
2016,12,11,18,128,181,309
2016,12,11,19,105,146,251
2016,12,11,20,83,118,201
2016,12,11,21,64,67,131
2016,12,11,22,46,44,90
2016,12,11,23,21,28,49
2016,12,12,0,14,14,28
2016,12,12,1,11,15,26
2016,12,12,2,7,8,15
2016,12,12,3,5,10,15
2016,12,12,4,13,19,32
2016,12,12,5,114,67,181
2016,12,12,6,241,156,397
2016,12,12,7,381,181,562
2016,12,12,8,287,172,459
2016,12,12,9,221,154,375
2016,12,12,10,236,183,419
2016,12,12,11,204,208,412
2016,12,12,12,238,229,467
2016,12,12,13,209,283,492
2016,12,12,14,293,316,609
2016,12,12,15,235,360,595
2016,12,12,16,197,205,402
2016,12,12,17,165,155,320
2016,12,12,18,119,125,244
2016,12,12,19,100,122,222
2016,12,12,20,72,110,182
2016,12,12,21,82,91,173
2016,12,12,22,52,67,119
2016,12,12,23,14,26,40
2016,12,13,0,6,18,24
2016,12,13,1,9,9,18
2016,12,13,2,8,13,21
2016,12,13,3,7,10,17
2016,12,13,4,23,15,38
2016,12,13,5,117,47,164
2016,12,13,6,230,155,385
2016,12,13,7,368,177,545
2016,12,13,8,296,197,493
2016,12,13,9,222,173,395
2016,12,13,10,203,181,384
2016,12,13,11,206,209,415
2016,12,13,12,203,201,404
2016,12,13,13,224,278,502
2016,12,13,14,267,308,575
2016,12,13,15,230,323,553
2016,12,13,16,162,202,364
2016,12,13,17,149,167,316
2016,12,13,18,149,135,284
2016,12,13,19,112,148,260
2016,12,13,20,103,157,260
2016,12,13,21,77,79,156
2016,12,13,22,32,50,82
2016,12,13,23,21,26,47
2016,12,14,0,10,16,26
2016,12,14,1,9,17,26
2016,12,14,2,8,19,27
2016,12,14,3,6,13,19
2016,12,14,4,19,16,35
2016,12,14,5,107,56,163
2016,12,14,6,222,136,358
2016,12,14,7,438,199,637
2016,12,14,8,540,210,750
2016,12,14,9,290,223,513
2016,12,14,10,230,170,400
2016,12,14,11,249,197,446
2016,12,14,12,238,214,452
2016,12,14,13,198,279,477
2016,12,14,14,238,283,521
2016,12,14,15,261,297,558
2016,12,14,16,184,236,420
2016,12,14,17,151,177,328
2016,12,14,18,144,190,334
2016,12,14,19,122,146,268
2016,12,14,20,83,118,201
2016,12,14,21,61,80,141
2016,12,14,22,45,53,98
2016,12,14,23,28,30,58
2016,12,15,0,14,23,37
2016,12,15,1,7,22,29
2016,12,15,2,11,19,30
2016,12,15,3,9,12,21
2016,12,15,4,21,20,41
2016,12,15,5,104,57,161
2016,12,15,6,257,168,425
2016,12,15,7,410,198,608
2016,12,15,8,254,189,443
2016,12,15,9,242,204,446
2016,12,15,10,205,190,395
2016,12,15,11,248,220,468
2016,12,15,12,231,221,452
2016,12,15,13,253,314,567
2016,12,15,14,290,392,682
2016,12,15,15,259,314,573
2016,12,15,16,222,217,439
2016,12,15,17,153,156,309
2016,12,15,18,144,154,298
2016,12,15,19,122,147,269
2016,12,15,20,97,149,246
2016,12,15,21,65,89,154
2016,12,15,22,43,64,107
2016,12,15,23,34,40,74
2016,12,16,0,17,32,49
2016,12,16,1,23,37,60
2016,12,16,2,14,33,47
2016,12,16,3,10,17,27
2016,12,16,4,25,21,46
2016,12,16,5,106,58,164
2016,12,16,6,228,141,369
2016,12,16,7,333,206,539
2016,12,16,8,270,175,445
2016,12,16,9,223,166,389
2016,12,16,10,249,204,453
2016,12,16,11,235,236,471
2016,12,16,12,236,261,497
2016,12,16,13,267,312,579
2016,12,16,14,306,345,651
2016,12,16,15,239,281,520
2016,12,16,16,196,223,419
2016,12,16,17,188,182,370
2016,12,16,18,144,194,338
2016,12,16,19,104,129,233
2016,12,16,20,76,86,162
2016,12,16,21,68,101,169
2016,12,16,22,50,87,137
2016,12,16,23,45,81,126
2016,12,17,0,34,52,86
2016,12,17,1,26,51,77
2016,12,17,2,28,65,93
2016,12,17,3,14,36,50
2016,12,17,4,20,16,36
2016,12,17,5,18,21,39
2016,12,17,6,35,28,63
2016,12,17,7,31,31,62
2016,12,17,8,65,41,106
2016,12,17,9,114,93,207
2016,12,17,10,141,112,253
2016,12,17,11,195,165,360
2016,12,17,12,188,188,376
2016,12,17,13,211,228,439
2016,12,17,14,201,272,473
2016,12,17,15,157,248,405
2016,12,17,16,154,188,342
2016,12,17,17,160,224,384
2016,12,17,18,123,149,272
2016,12,17,19,85,110,195
2016,12,17,20,64,92,156
2016,12,17,21,47,86,133
2016,12,17,22,36,72,108
2016,12,17,23,41,62,103
2016,12,18,0,35,46,81
2016,12,18,1,31,56,87
2016,12,18,2,23,42,65
2016,12,18,3,17,34,51
2016,12,18,4,15,24,39
2016,12,18,5,10,17,27
2016,12,18,6,20,19,39
2016,12,18,7,33,15,48
2016,12,18,8,38,28,66
2016,12,18,9,85,55,140
2016,12,18,10,141,119,260
2016,12,18,11,164,164,328
2016,12,18,12,187,160,347
2016,12,18,13,213,162,375
2016,12,18,14,180,239,419
2016,12,18,15,170,246,416
2016,12,18,16,169,151,320
2016,12,18,17,132,201,333
2016,12,18,18,151,163,314
2016,12,18,19,102,182,284
2016,12,18,20,89,107,196
2016,12,18,21,56,84,140
2016,12,18,22,39,53,92
2016,12,18,23,18,18,36
2016,12,19,0,9,24,33
2016,12,19,1,7,13,20
2016,12,19,2,12,19,31
2016,12,19,3,6,16,22
2016,12,19,4,18,14,32
2016,12,19,5,129,58,187
2016,12,19,6,198,164,362
2016,12,19,7,376,194,570
2016,12,19,8,257,182,439
2016,12,19,9,239,152,391
2016,12,19,10,219,195,414
2016,12,19,11,253,232,485
2016,12,19,12,230,222,452
2016,12,19,13,245,287,532
2016,12,19,14,273,344,617
2016,12,19,15,267,284,551
2016,12,19,16,205,187,392
2016,12,19,17,145,175,320
2016,12,19,18,130,186,316
2016,12,19,19,124,151,275
2016,12,19,20,84,112,196
2016,12,19,21,61,73,134
2016,12,19,22,44,60,104
2016,12,19,23,15,32,47
2016,12,20,0,14,22,36
2016,12,20,1,15,18,33
2016,12,20,2,16,23,39
2016,12,20,3,5,9,14
2016,12,20,4,20,10,30
2016,12,20,5,106,61,167
2016,12,20,6,242,175,417
2016,12,20,7,286,168,454
2016,12,20,8,270,187,457
2016,12,20,9,238,169,407
2016,12,20,10,237,224,461
2016,12,20,11,252,260,512
2016,12,20,12,233,243,476
2016,12,20,13,249,275,524
2016,12,20,14,289,337,626
2016,12,20,15,245,273,518
2016,12,20,16,191,210,401
2016,12,20,17,150,158,308
2016,12,20,18,140,196,336
2016,12,20,19,113,160,273
2016,12,20,20,98,117,215
2016,12,20,21,60,92,152
2016,12,20,22,38,49,87
2016,12,20,23,26,30,56
2016,12,21,0,17,20,37
2016,12,21,1,9,20,29
2016,12,21,2,6,15,21
2016,12,21,3,10,12,22
2016,12,21,4,15,14,29
2016,12,21,5,92,52,144
2016,12,21,6,230,145,375
2016,12,21,7,285,165,450
2016,12,21,8,240,161,401
2016,12,21,9,226,166,392
2016,12,21,10,232,192,424
2016,12,21,11,249,240,489
2016,12,21,12,249,259,508
2016,12,21,13,250,300,550
2016,12,21,14,267,374,641
2016,12,21,15,228,302,530
2016,12,21,16,160,194,354
2016,12,21,17,148,168,316
2016,12,21,18,125,171,296
2016,12,21,19,119,123,242
2016,12,21,20,85,117,202
2016,12,21,21,75,190,265
2016,12,21,22,62,97,159
2016,12,21,23,38,55,93
2016,12,22,0,26,17,43
2016,12,22,1,14,21,35
2016,12,22,2,13,26,39
2016,12,22,3,4,13,17
2016,12,22,4,16,8,24
2016,12,22,5,99,51,150
2016,12,22,6,215,124,339
2016,12,22,7,242,145,387
2016,12,22,8,260,168,428
2016,12,22,9,227,138,365
2016,12,22,10,266,234,500
2016,12,22,11,248,248,496
2016,12,22,12,245,273,518
2016,12,22,13,228,314,542
2016,12,22,14,376,467,843
2016,12,22,15,341,545,886
2016,12,22,16,242,323,565
2016,12,22,17,148,177,325
2016,12,22,18,140,156,296
2016,12,22,19,107,137,244
2016,12,22,20,83,97,180
2016,12,22,21,67,97,164
2016,12,22,22,42,60,102
2016,12,22,23,27,30,57
2016,12,23,0,17,26,43
2016,12,23,1,14,25,39
2016,12,23,2,10,19,29
2016,12,23,3,6,8,14
2016,12,23,4,13,12,25
2016,12,23,5,74,38,112
2016,12,23,6,154,95,249
2016,12,23,7,154,102,256
2016,12,23,8,138,126,264
2016,12,23,9,203,167,370
2016,12,23,10,213,191,404
2016,12,23,11,232,224,456
2016,12,23,12,223,264,487
2016,12,23,13,223,273,496
2016,12,23,14,193,252,445
2016,12,23,15,161,190,351
2016,12,23,16,153,145,298
2016,12,23,17,115,113,228
2016,12,23,18,108,120,228
2016,12,23,19,89,78,167
2016,12,23,20,86,90,176
2016,12,23,21,49,46,95
2016,12,23,22,39,46,85
2016,12,23,23,24,31,55
2016,12,24,0,19,38,57
2016,12,24,1,9,17,26
2016,12,24,2,4,8,12
2016,12,24,3,7,12,19
2016,12,24,4,7,6,13
2016,12,24,5,15,13,28
2016,12,24,6,24,18,42
2016,12,24,7,16,31,47
2016,12,24,8,25,42,67
2016,12,24,9,75,85,160
2016,12,24,10,111,131,242
2016,12,24,11,172,127,299
2016,12,24,12,136,174,310
2016,12,24,13,151,140,291
2016,12,24,14,157,125,282
2016,12,24,15,134,174,308
2016,12,24,16,83,107,190
2016,12,24,17,53,47,100
2016,12,24,18,25,36,61
2016,12,24,19,58,38,96
2016,12,24,20,40,52,92
2016,12,24,21,71,97,168
2016,12,24,22,80,59,139
2016,12,24,23,56,74,130
2016,12,25,0,30,39,69
2016,12,25,1,13,14,27
2016,12,25,2,7,11,18
2016,12,25,3,7,8,15
2016,12,25,4,4,3,7
2016,12,25,5,11,10,21
2016,12,25,6,14,14,28
2016,12,25,7,9,8,17
2016,12,25,8,16,12,28
2016,12,25,9,25,20,45
2016,12,25,10,34,38,72
2016,12,25,11,69,75,144
2016,12,25,12,85,89,174
2016,12,25,13,96,113,209
2016,12,25,14,96,123,219
2016,12,25,15,91,127,218
2016,12,25,16,104,81,185
2016,12,25,17,86,74,160
2016,12,25,18,94,75,169
2016,12,25,19,87,81,168
2016,12,25,20,74,88,162
2016,12,25,21,60,75,135
2016,12,25,22,39,45,84
2016,12,25,23,24,26,50
2016,12,26,0,16,35,51
2016,12,26,1,12,21,33
2016,12,26,2,9,23,32
2016,12,26,3,6,13,19
2016,12,26,4,7,12,19
2016,12,26,5,14,15,29
2016,12,26,6,19,17,36
2016,12,26,7,10,12,22
2016,12,26,8,20,24,44
2016,12,26,9,35,28,63
2016,12,26,10,72,70,142
2016,12,26,11,92,88,180
2016,12,26,12,84,95,179
2016,12,26,13,138,144,282
2016,12,26,14,104,142,246
2016,12,26,15,109,104,213
2016,12,26,16,89,93,182
2016,12,26,17,88,137,225
2016,12,26,18,104,220,324
2016,12,26,19,109,209,318
2016,12,26,20,71,165,236
2016,12,26,21,53,126,179
2016,12,26,22,38,50,88
2016,12,26,23,20,51,71
2016,12,27,0,24,27,51
2016,12,27,1,9,43,52
2016,12,27,2,22,35,57
2016,12,27,3,15,26,41
2016,12,27,4,15,25,40
2016,12,27,5,47,31,78
2016,12,27,6,71,57,128
2016,12,27,7,72,67,139
2016,12,27,8,107,60,167
2016,12,27,9,135,88,223
2016,12,27,10,123,131,254
2016,12,27,11,154,130,284
2016,12,27,12,152,157,309
2016,12,27,13,168,167,335
2016,12,27,14,130,215,345
2016,12,27,15,116,155,271
2016,12,27,16,117,119,236
2016,12,27,17,119,95,214
2016,12,27,18,74,126,200
2016,12,27,19,79,80,159
2016,12,27,20,62,69,131
2016,12,27,21,56,61,117
2016,12,27,22,33,53,86
2016,12,27,23,25,39,64
2016,12,28,0,13,30,43
2016,12,28,1,10,18,28
2016,12,28,2,10,9,19
2016,12,28,3,4,16,20
2016,12,28,4,7,14,21
2016,12,28,5,43,21,64
2016,12,28,6,78,59,137
2016,12,28,7,102,63,165
2016,12,28,8,100,80,180
2016,12,28,9,132,89,221
2016,12,28,10,155,121,276
2016,12,28,11,180,146,326
2016,12,28,12,164,167,331
2016,12,28,13,163,183,346
2016,12,28,14,159,173,332
2016,12,28,15,139,183,322
2016,12,28,16,118,141,259
2016,12,28,17,121,118,239
2016,12,28,18,97,151,248
2016,12,28,19,81,87,168
2016,12,28,20,74,86,160
2016,12,28,21,53,74,127
2016,12,28,22,37,65,102
2016,12,28,23,21,41,62
2016,12,29,0,18,36,54
2016,12,29,1,11,22,33
2016,12,29,2,10,21,31
2016,12,29,3,13,20,33
2016,12,29,4,13,6,19
2016,12,29,5,46,27,73
2016,12,29,6,78,65,143
2016,12,29,7,100,73,173
2016,12,29,8,109,71,180
2016,12,29,9,120,92,212
2016,12,29,10,155,114,269
2016,12,29,11,160,143,303
2016,12,29,12,168,164,332
2016,12,29,13,173,198,371
2016,12,29,14,173,198,371
2016,12,29,15,151,203,354
2016,12,29,16,104,148,252
2016,12,29,17,121,98,219
2016,12,29,18,76,130,206
2016,12,29,19,86,94,180
2016,12,29,20,67,86,153
2016,12,29,21,50,67,117
2016,12,29,22,37,44,81
2016,12,29,23,22,40,62
2016,12,30,0,18,29,47
2016,12,30,1,9,20,29
2016,12,30,2,8,20,28
2016,12,30,3,17,17,34
2016,12,30,4,9,11,20
2016,12,30,5,49,26,75
2016,12,30,6,71,50,121
2016,12,30,7,82,76,158
2016,12,30,8,114,63,177
2016,12,30,9,123,84,207
2016,12,30,10,126,97,223
2016,12,30,11,174,150,324
2016,12,30,12,173,168,341
2016,12,30,13,150,147,297
2016,12,30,14,155,156,311
2016,12,30,15,142,164,306
2016,12,30,16,125,140,265
2016,12,30,17,107,110,217
2016,12,30,18,74,92,166
2016,12,30,19,88,91,179
2016,12,30,20,58,70,128
2016,12,30,21,52,72,124
2016,12,30,22,43,62,105
2016,12,30,23,22,45,67
2016,12,31,0,17,24,41
2016,12,31,1,12,34,46
2016,12,31,2,14,34,48
2016,12,31,3,8,18,26
2016,12,31,4,10,9,19
2016,12,31,5,19,15,34
2016,12,31,6,16,19,35
2016,12,31,7,25,17,42
2016,12,31,8,26,25,51
2016,12,31,9,48,48,96
2016,12,31,10,75,60,135
2016,12,31,11,100,103,203
2016,12,31,12,108,134,242
2016,12,31,13,126,134,260
2016,12,31,14,119,125,244
2016,12,31,15,105,95,200
2016,12,31,16,106,121,227
2016,12,31,17,104,124,228
2016,12,31,18,79,91,170
2016,12,31,19,70,77,147
2016,12,31,20,65,65,130
2016,12,31,21,70,73,143
2016,12,31,22,53,49,102
2016,12,31,23,47,95,142
2017,1,1,0,66,65,131
2017,1,1,1,39,62,101
2017,1,1,2,54,60,114
2017,1,1,3,32,45,77
2017,1,1,4,36,40,76
2017,1,1,5,23,37,60
2017,1,1,6,14,20,34
2017,1,1,7,10,13,23
2017,1,1,8,13,17,30
2017,1,1,9,44,37,81
2017,1,1,10,28,39,67
2017,1,1,11,57,64,121
2017,1,1,12,77,71,148
2017,1,1,13,121,131,252
2017,1,1,14,123,132,255
2017,1,1,15,119,136,255
2017,1,1,16,113,136,249
2017,1,1,17,119,98,217
2017,1,1,18,100,124,224
2017,1,1,19,97,106,203
2017,1,1,20,62,77,139
2017,1,1,21,55,65,120
2017,1,1,22,28,30,58
2017,1,1,23,18,16,34
2017,1,2,0,9,7,16
2017,1,2,1,4,9,13
2017,1,2,2,9,17,26
2017,1,2,3,7,10,17
2017,1,2,4,11,16,27
2017,1,2,5,90,52,142
2017,1,2,6,200,115,315
2017,1,2,7,307,160,467
2017,1,2,8,204,113,317
2017,1,2,9,149,123,272
2017,1,2,10,143,117,260
2017,1,2,11,139,145,284
2017,1,2,12,149,161,310
2017,1,2,13,168,208,376
2017,1,2,14,209,290,499
2017,1,2,15,178,248,426
2017,1,2,16,125,138,263
2017,1,2,17,118,120,238
2017,1,2,18,107,118,225
2017,1,2,19,94,96,190
2017,1,2,20,73,94,167
2017,1,2,21,44,49,93
2017,1,2,22,20,32,52
2017,1,2,23,15,16,31
2017,1,3,0,10,19,29
2017,1,3,1,6,10,16
2017,1,3,2,8,9,17
2017,1,3,3,4,7,11
2017,1,3,4,16,11,27
2017,1,3,5,79,51,130
2017,1,3,6,231,146,377
2017,1,3,7,330,166,496
2017,1,3,8,227,154,381
2017,1,3,9,179,165,344
2017,1,3,10,163,161,324
2017,1,3,11,192,164,356
2017,1,3,12,182,196,378
2017,1,3,13,195,232,427
2017,1,3,14,244,279,523
2017,1,3,15,204,259,463
2017,1,3,16,166,166,332
2017,1,3,17,142,121,263
2017,1,3,18,114,113,227
2017,1,3,19,101,129,230
2017,1,3,20,84,116,200
2017,1,3,21,56,65,121
2017,1,3,22,29,36,65
2017,1,3,23,18,24,42
2017,1,4,0,8,18,26
2017,1,4,1,7,12,19
2017,1,4,2,5,7,12
2017,1,4,3,4,10,14
2017,1,4,4,14,7,21
2017,1,4,5,83,53,136
2017,1,4,6,265,145,410
2017,1,4,7,328,178,506
2017,1,4,8,208,149,357
2017,1,4,9,186,141,327
2017,1,4,10,191,177,368
2017,1,4,11,190,173,363
2017,1,4,12,173,182,355
2017,1,4,13,181,222,403
2017,1,4,14,239,284,523
2017,1,4,15,197,263,460
2017,1,4,16,157,176,333
2017,1,4,17,137,139,276
2017,1,4,18,109,109,218
2017,1,4,19,102,96,198
2017,1,4,20,75,95,170
2017,1,4,21,53,60,113
2017,1,4,22,37,87,124
2017,1,4,23,21,49,70
2017,1,5,0,19,21,40
2017,1,5,1,9,12,21
2017,1,5,2,5,10,15
2017,1,5,3,4,21,25
2017,1,5,4,12,5,17
2017,1,5,5,92,52,144
2017,1,5,6,229,147,376
2017,1,5,7,332,161,493
2017,1,5,8,215,152,367
2017,1,5,9,195,156,351
2017,1,5,10,201,145,346
2017,1,5,11,172,177,349
2017,1,5,12,190,204,394
2017,1,5,13,207,226,433
2017,1,5,14,243,316,559
2017,1,5,15,218,273,491
2017,1,5,16,175,196,371
2017,1,5,17,147,158,305
2017,1,5,18,124,163,287
2017,1,5,19,83,118,201
2017,1,5,20,68,100,168
2017,1,5,21,61,69,130
2017,1,5,22,36,34,70
2017,1,5,23,20,20,40
2017,1,6,0,20,23,43
2017,1,6,1,5,22,27
2017,1,6,2,9,19,28
2017,1,6,3,4,10,14
2017,1,6,4,12,13,25
2017,1,6,5,98,57,155
2017,1,6,6,240,162,402
2017,1,6,7,353,166,519
2017,1,6,8,226,141,367
2017,1,6,9,186,165,351
2017,1,6,10,211,174,385
2017,1,6,11,217,204,421
2017,1,6,12,200,228,428
2017,1,6,13,255,273,528
2017,1,6,14,274,332,606
2017,1,6,15,200,296,496
2017,1,6,16,136,159,295
2017,1,6,17,124,141,265
2017,1,6,18,121,127,248
2017,1,6,19,103,105,208
2017,1,6,20,61,70,131
2017,1,6,21,49,84,133
2017,1,6,22,43,52,95
2017,1,6,23,30,59,89
2017,1,7,0,30,50,80
2017,1,7,1,20,33,53
2017,1,7,2,12,47,59
2017,1,7,3,14,28,42
2017,1,7,4,13,14,27
2017,1,7,5,17,25,42
2017,1,7,6,29,21,50
2017,1,7,7,38,26,64
2017,1,7,8,77,36,113
2017,1,7,9,101,64,165
2017,1,7,10,121,94,215
2017,1,7,11,116,149,265
2017,1,7,12,147,159,306
2017,1,7,13,171,184,355
2017,1,7,14,154,185,339
2017,1,7,15,120,166,286
2017,1,7,16,118,144,262
2017,1,7,17,119,142,261
2017,1,7,18,120,151,271
2017,1,7,19,92,101,193
2017,1,7,20,62,72,134
2017,1,7,21,47,70,117
2017,1,7,22,41,61,102
2017,1,7,23,38,57,95
2017,1,8,0,38,55,93
2017,1,8,1,32,36,68
2017,1,8,2,25,54,79
2017,1,8,3,11,36,47
2017,1,8,4,12,25,37
2017,1,8,5,17,8,25
2017,1,8,6,13,18,31
2017,1,8,7,31,14,45
2017,1,8,8,58,30,88
2017,1,8,9,84,33,117
2017,1,8,10,95,75,170
2017,1,8,11,122,142,264
2017,1,8,12,137,133,270
2017,1,8,13,184,178,362
2017,1,8,14,155,177,332
2017,1,8,15,132,196,328
2017,1,8,16,165,141,306
2017,1,8,17,159,175,334
2017,1,8,18,170,149,319
2017,1,8,19,109,153,262
2017,1,8,20,78,100,178
2017,1,8,21,49,63,112
2017,1,8,22,34,40,74
2017,1,8,23,24,26,50
2017,1,9,0,12,20,32
2017,1,9,1,3,10,13
2017,1,9,2,7,12,19
2017,1,9,3,4,11,15
2017,1,9,4,17,9,26
2017,1,9,5,110,60,170
2017,1,9,6,261,160,421
2017,1,9,7,408,209,617
2017,1,9,8,254,168,422
2017,1,9,9,205,165,370
2017,1,9,10,218,184,402
2017,1,9,11,194,212,406
2017,1,9,12,205,202,407
2017,1,9,13,232,261,493
2017,1,9,14,240,320,560
2017,1,9,15,226,321,547
2017,1,9,16,186,194,380
2017,1,9,17,171,151,322
2017,1,9,18,138,150,288
2017,1,9,19,113,119,232
2017,1,9,20,78,115,193
2017,1,9,21,57,73,130
2017,1,9,22,24,35,59
2017,1,9,23,27,21,48
2017,1,10,0,10,18,28
2017,1,10,1,5,13,18
2017,1,10,2,9,7,16
2017,1,10,3,6,7,13
2017,1,10,4,17,12,29
2017,1,10,5,119,48,167
2017,1,10,6,247,150,397
2017,1,10,7,382,204,586
2017,1,10,8,227,163,390
2017,1,10,9,203,161,364
2017,1,10,10,217,176,393
2017,1,10,11,198,224,422
2017,1,10,12,220,206,426
2017,1,10,13,202,252,454
2017,1,10,14,243,327,570
2017,1,10,15,199,284,483
2017,1,10,16,193,183,376
2017,1,10,17,154,149,303
2017,1,10,18,133,116,249
2017,1,10,19,102,127,229
2017,1,10,20,84,117,201
2017,1,10,21,67,67,134
2017,1,10,22,24,51,75
2017,1,10,23,15,20,35
2017,1,11,0,11,18,29
2017,1,11,1,7,17,24
2017,1,11,2,5,6,11
2017,1,11,3,5,14,19
2017,1,11,4,18,14,32
2017,1,11,5,104,60,164
2017,1,11,6,244,155,399
2017,1,11,7,347,195,542
2017,1,11,8,243,150,393
2017,1,11,9,199,160,359
2017,1,11,10,225,188,413
2017,1,11,11,196,199,395
2017,1,11,12,207,223,430
2017,1,11,13,236,251,487
2017,1,11,14,240,285,525
2017,1,11,15,224,304,528
2017,1,11,16,193,186,379
2017,1,11,17,152,146,298
2017,1,11,18,99,133,232
2017,1,11,19,105,131,236
2017,1,11,20,92,117,209
2017,1,11,21,66,85,151
2017,1,11,22,31,135,166
2017,1,11,23,17,50,67
2017,1,12,0,13,19,32
2017,1,12,1,7,14,21
2017,1,12,2,6,18,24
2017,1,12,3,6,17,23
2017,1,12,4,13,10,23
2017,1,12,5,114,54,168
2017,1,12,6,251,162,413
2017,1,12,7,379,177,556
2017,1,12,8,244,161,405
2017,1,12,9,248,160,408
2017,1,12,10,204,234,438
2017,1,12,11,205,218,423
2017,1,12,12,209,204,413
2017,1,12,13,203,257,460
2017,1,12,14,248,331,579
2017,1,12,15,213,307,520
2017,1,12,16,191,216,407
2017,1,12,17,165,149,314
2017,1,12,18,146,133,279
2017,1,12,19,91,128,219
2017,1,12,20,96,139,235
2017,1,12,21,69,107,176
2017,1,12,22,38,55,93
2017,1,12,23,24,31,55
2017,1,13,0,14,35,49
2017,1,13,1,13,26,39
2017,1,13,2,6,21,27
2017,1,13,3,14,20,34
2017,1,13,4,12,14,26
2017,1,13,5,93,58,151
2017,1,13,6,249,176,425
2017,1,13,7,354,166,520
2017,1,13,8,226,156,382
2017,1,13,9,216,150,366
2017,1,13,10,193,180,373
2017,1,13,11,197,217,414
2017,1,13,12,210,224,434
2017,1,13,13,240,278,518
2017,1,13,14,263,337,600
2017,1,13,15,181,280,461
2017,1,13,16,186,188,374
2017,1,13,17,136,134,270
2017,1,13,18,106,130,236
2017,1,13,19,81,108,189
2017,1,13,20,65,88,153
2017,1,13,21,63,84,147
2017,1,13,22,53,64,117
2017,1,13,23,48,54,102
2017,1,14,0,35,57,92
2017,1,14,1,25,49,74
2017,1,14,2,23,49,72
2017,1,14,3,15,38,53
2017,1,14,4,15,20,35
2017,1,14,5,27,20,47
2017,1,14,6,34,25,59
2017,1,14,7,41,39,80
2017,1,14,8,51,54,105
2017,1,14,9,93,79,172
2017,1,14,10,134,79,213
2017,1,14,11,132,148,280
2017,1,14,12,128,159,287
2017,1,14,13,139,160,299
2017,1,14,14,155,153,308
2017,1,14,15,139,138,277
2017,1,14,16,131,144,275
2017,1,14,17,121,97,218
2017,1,14,18,120,133,253
2017,1,14,19,58,85,143
2017,1,14,20,46,66,112
2017,1,14,21,63,65,128
2017,1,14,22,43,64,107
2017,1,14,23,50,64,114
2017,1,15,0,31,74,105
2017,1,15,1,37,59,96
2017,1,15,2,26,74,100
2017,1,15,3,19,61,80
2017,1,15,4,9,27,36
2017,1,15,5,20,24,44
2017,1,15,6,16,22,38
2017,1,15,7,23,18,41
2017,1,15,8,37,38,75
2017,1,15,9,76,47,123
2017,1,15,10,91,79,170
2017,1,15,11,120,109,229
2017,1,15,12,119,169,288
2017,1,15,13,145,153,298
2017,1,15,14,152,201,353
2017,1,15,15,140,223,363
2017,1,15,16,142,159,301
2017,1,15,17,146,116,262
2017,1,15,18,137,153,290
2017,1,15,19,110,135,245
2017,1,15,20,85,105,190
2017,1,15,21,38,96,134
2017,1,15,22,35,45,80
2017,1,15,23,13,26,39
2017,1,16,0,13,24,37
2017,1,16,1,8,18,26
2017,1,16,2,11,12,23
2017,1,16,3,5,20,25
2017,1,16,4,14,9,23
2017,1,16,5,94,63,157
2017,1,16,6,260,161,421
2017,1,16,7,346,191,537
2017,1,16,8,260,171,431
2017,1,16,9,206,185,391
2017,1,16,10,210,167,377
2017,1,16,11,195,212,407
2017,1,16,12,188,203,391
2017,1,16,13,199,250,449
2017,1,16,14,233,325,558
2017,1,16,15,226,295,521
2017,1,16,16,167,190,357
2017,1,16,17,152,151,303
2017,1,16,18,104,129,233
2017,1,16,19,118,107,225
2017,1,16,20,79,113,192
2017,1,16,21,54,70,124
2017,1,16,22,29,38,67
2017,1,16,23,11,16,27
2017,1,17,0,11,16,27
2017,1,17,1,8,12,20
2017,1,17,2,13,9,22
2017,1,17,3,6,11,17
2017,1,17,4,21,10,31
2017,1,17,5,110,65,175
2017,1,17,6,229,161,390
2017,1,17,7,373,190,563
2017,1,17,8,270,134,404
2017,1,17,9,224,198,422
2017,1,17,10,205,190,395
2017,1,17,11,191,181,372
2017,1,17,12,212,186,398
2017,1,17,13,216,252,468
2017,1,17,14,251,326,577
2017,1,17,15,209,307,516
2017,1,17,16,215,219,434
2017,1,17,17,197,159,356
2017,1,17,18,132,161,293
2017,1,17,19,99,131,230
2017,1,17,20,68,114,182
2017,1,17,21,61,83,144
2017,1,17,22,47,37,84
2017,1,17,23,14,26,40
2017,1,18,0,12,14,26
2017,1,18,1,7,13,20
2017,1,18,2,7,25,32
2017,1,18,3,5,11,16
2017,1,18,4,12,10,22
2017,1,18,5,108,64,172
2017,1,18,6,245,163,408
2017,1,18,7,367,215,582
2017,1,18,8,243,149,392
2017,1,18,9,186,153,339
2017,1,18,10,219,181,400
2017,1,18,11,193,195,388
2017,1,18,12,205,211,416
2017,1,18,13,198,251,449
2017,1,18,14,282,299,581
2017,1,18,15,221,298,519
2017,1,18,16,172,198,370
2017,1,18,17,194,138,332
2017,1,18,18,133,150,283
2017,1,18,19,88,114,202
2017,1,18,20,92,137,229
2017,1,18,21,76,60,136
2017,1,18,22,30,42,72
2017,1,18,23,20,18,38
2017,1,19,0,8,18,26
2017,1,19,1,10,14,24
2017,1,19,2,8,16,24
2017,1,19,3,11,7,18
2017,1,19,4,18,5,23
2017,1,19,5,113,64,177
2017,1,19,6,221,158,379
2017,1,19,7,396,199,595
2017,1,19,8,235,173,408
2017,1,19,9,224,181,405
2017,1,19,10,223,206,429
2017,1,19,11,174,190,364
2017,1,19,12,185,184,369
2017,1,19,13,215,262,477
2017,1,19,14,290,322,612
2017,1,19,15,224,295,519
2017,1,19,16,192,223,415
2017,1,19,17,182,172,354
2017,1,19,18,139,152,291
2017,1,19,19,112,109,221
2017,1,19,20,76,134,210
2017,1,19,21,60,76,136
2017,1,19,22,44,50,94
2017,1,19,23,16,32,48
2017,1,20,0,9,30,39
2017,1,20,1,15,30,45
2017,1,20,2,16,30,46
2017,1,20,3,4,18,22
2017,1,20,4,18,11,29
2017,1,20,5,103,60,163
2017,1,20,6,232,144,376
2017,1,20,7,364,191,555
2017,1,20,8,242,132,374
2017,1,20,9,226,173,399
2017,1,20,10,202,198,400
2017,1,20,11,194,209,403
2017,1,20,12,233,238,471
2017,1,20,13,245,298,543
2017,1,20,14,310,364,674
2017,1,20,15,231,297,528
2017,1,20,16,156,188,344
2017,1,20,17,141,155,296
2017,1,20,18,105,129,234
2017,1,20,19,76,100,176
2017,1,20,20,91,90,181
2017,1,20,21,52,66,118
2017,1,20,22,51,55,106
2017,1,20,23,31,65,96
2017,1,21,0,23,48,71
2017,1,21,1,28,53,81
2017,1,21,2,21,52,73
2017,1,21,3,11,19,30
2017,1,21,4,9,12,21
2017,1,21,5,25,15,40
2017,1,21,6,26,20,46
2017,1,21,7,44,33,77
2017,1,21,8,51,42,93
2017,1,21,9,102,68,170
2017,1,21,10,123,105,228
2017,1,21,11,151,134,285
2017,1,21,12,184,160,344
2017,1,21,13,151,202,353
2017,1,21,14,159,190,349
2017,1,21,15,136,165,301
2017,1,21,16,116,149,265
2017,1,21,17,143,138,281
2017,1,21,18,106,134,240
2017,1,21,19,64,102,166
2017,1,21,20,61,86,147
2017,1,21,21,60,62,122
2017,1,21,22,64,60,124
2017,1,21,23,45,63,108
2017,1,22,0,34,44,78
2017,1,22,1,35,78,113
2017,1,22,2,36,70,106
2017,1,22,3,22,40,62
2017,1,22,4,17,24,41
2017,1,22,5,14,15,29
2017,1,22,6,17,17,34
2017,1,22,7,24,15,39
2017,1,22,8,40,47,87
2017,1,22,9,90,43,133
2017,1,22,10,97,73,170
2017,1,22,11,134,127,261
2017,1,22,12,149,174,323
2017,1,22,13,178,205,383
2017,1,22,14,162,222,384
2017,1,22,15,133,215,348
2017,1,22,16,141,154,295
2017,1,22,17,139,142,281
2017,1,22,18,142,153,295
2017,1,22,19,118,164,282
2017,1,22,20,72,94,166
2017,1,22,21,51,63,114
2017,1,22,22,32,42,74
2017,1,22,23,20,27,47
2017,1,23,0,13,14,27
2017,1,23,1,5,16,21
2017,1,23,2,7,10,17
2017,1,23,3,6,12,18
2017,1,23,4,13,15,28
2017,1,23,5,120,72,192
2017,1,23,6,253,137,390
2017,1,23,7,364,189,553
2017,1,23,8,278,151,429
2017,1,23,9,214,164,378
2017,1,23,10,207,175,382
2017,1,23,11,220,185,405
2017,1,23,12,181,207,388
2017,1,23,13,210,228,438
2017,1,23,14,243,306,549
2017,1,23,15,238,309,547
2017,1,23,16,200,180,380
2017,1,23,17,175,141,316
2017,1,23,18,112,157,269
2017,1,23,19,106,140,246
2017,1,23,20,72,96,168
2017,1,23,21,65,69,134
2017,1,23,22,35,48,83
2017,1,23,23,12,18,30
2017,1,24,0,8,14,22
2017,1,24,1,10,10,20
2017,1,24,2,7,7,14
2017,1,24,3,8,9,17
2017,1,24,4,18,13,31
2017,1,24,5,122,65,187
2017,1,24,6,268,157,425
2017,1,24,7,379,185,564
2017,1,24,8,251,162,413
2017,1,24,9,240,217,457
2017,1,24,10,226,194,420
2017,1,24,11,185,206,391
2017,1,24,12,198,206,404
2017,1,24,13,208,261,469
2017,1,24,14,255,318,573
2017,1,24,15,224,369,593
2017,1,24,16,183,183,366
2017,1,24,17,193,136,329
2017,1,24,18,154,145,299
2017,1,24,19,106,156,262
2017,1,24,20,79,92,171
2017,1,24,21,66,74,140
2017,1,24,22,28,37,65
2017,1,24,23,17,28,45
2017,1,25,0,5,20,25
2017,1,25,1,5,17,22
2017,1,25,2,9,18,27
2017,1,25,3,3,16,19
2017,1,25,4,21,12,33
2017,1,25,5,120,60,180
2017,1,25,6,247,141,388
2017,1,25,7,388,203,591
2017,1,25,8,251,151,402
2017,1,25,9,187,177,364
2017,1,25,10,203,189,392
2017,1,25,11,197,172,369
2017,1,25,12,189,202,391
2017,1,25,13,236,263,499
2017,1,25,14,248,317,565
2017,1,25,15,231,309,540
2017,1,25,16,179,199,378
2017,1,25,17,176,171,347
2017,1,25,18,136,132,268
2017,1,25,19,103,124,227
2017,1,25,20,103,131,234
2017,1,25,21,62,102,164
2017,1,25,22,33,128,161
2017,1,25,23,24,26,50
2017,1,26,0,16,14,30
2017,1,26,1,10,23,33
2017,1,26,2,9,10,19
2017,1,26,3,9,13,22
2017,1,26,4,17,15,32
2017,1,26,5,108,66,174
2017,1,26,6,243,146,389
2017,1,26,7,379,207,586
2017,1,26,8,261,176,437
2017,1,26,9,229,194,423
2017,1,26,10,201,180,381
2017,1,26,11,232,223,455
2017,1,26,12,180,207,387
2017,1,26,13,220,287,507
2017,1,26,14,277,323,600
2017,1,26,15,236,339,575
2017,1,26,16,192,218,410
2017,1,26,17,194,172,366
2017,1,26,18,156,173,329
2017,1,26,19,98,169,267
2017,1,26,20,72,115,187
2017,1,26,21,58,83,141
2017,1,26,22,34,43,77
2017,1,26,23,20,33,53
2017,1,27,0,10,22,32
2017,1,27,1,13,31,44
2017,1,27,2,7,27,34
2017,1,27,3,8,12,20
2017,1,27,4,14,17,31
2017,1,27,5,108,65,173
2017,1,27,6,218,147,365
2017,1,27,7,357,193,550
2017,1,27,8,259,174,433
2017,1,27,9,197,172,369
2017,1,27,10,243,179,422
2017,1,27,11,214,196,410
2017,1,27,12,242,219,461
2017,1,27,13,242,327,569
2017,1,27,14,280,365,645
2017,1,27,15,202,287,489
2017,1,27,16,146,191,337
2017,1,27,17,151,152,303
2017,1,27,18,108,129,237
2017,1,27,19,93,109,202
2017,1,27,20,63,84,147
2017,1,27,21,57,67,124
2017,1,27,22,49,80,129
2017,1,27,23,40,49,89
2017,1,28,0,33,43,76
2017,1,28,1,30,51,81
2017,1,28,2,19,51,70
2017,1,28,3,13,28,41
2017,1,28,4,13,19,32
2017,1,28,5,21,16,37
2017,1,28,6,30,25,55
2017,1,28,7,35,29,64
2017,1,28,8,63,59,122
2017,1,28,9,102,79,181
2017,1,28,10,122,111,233
2017,1,28,11,167,131,298
2017,1,28,12,143,147,290
2017,1,28,13,156,198,354
2017,1,28,14,150,204,354
2017,1,28,15,138,160,298
2017,1,28,16,130,153,283
2017,1,28,17,158,136,294
2017,1,28,18,93,119,212
2017,1,28,19,64,88,152
2017,1,28,20,49,67,116
2017,1,28,21,42,61,103
2017,1,28,22,44,76,120
2017,1,28,23,53,59,112
2017,1,29,0,33,73,106
2017,1,29,1,25,65,90
2017,1,29,2,33,75,108
2017,1,29,3,20,48,68
2017,1,29,4,14,27,41
2017,1,29,5,15,15,30
2017,1,29,6,21,17,38
2017,1,29,7,36,18,54
2017,1,29,8,47,38,85
2017,1,29,9,95,54,149
2017,1,29,10,105,71,176
2017,1,29,11,143,125,268
2017,1,29,12,138,213,351
2017,1,29,13,180,184,364
2017,1,29,14,146,211,357
2017,1,29,15,130,206,336
2017,1,29,16,155,163,318
2017,1,29,17,109,122,231
2017,1,29,18,136,159,295
2017,1,29,19,103,140,243
2017,1,29,20,82,127,209
2017,1,29,21,42,51,93
2017,1,29,22,24,42,66
2017,1,29,23,17,20,37
2017,1,30,0,12,16,28
2017,1,30,1,9,6,15
2017,1,30,2,5,13,18
2017,1,30,3,5,10,15
2017,1,30,4,14,15,29
2017,1,30,5,108,57,165
2017,1,30,6,233,176,409
2017,1,30,7,331,203,534
2017,1,30,8,236,135,371
2017,1,30,9,197,179,376
2017,1,30,10,194,152,346
2017,1,30,11,183,161,344
2017,1,30,12,180,200,380
2017,1,30,13,193,239,432
2017,1,30,14,242,305,547
2017,1,30,15,207,279,486
2017,1,30,16,207,223,430
2017,1,30,17,165,138,303
2017,1,30,18,132,135,267
2017,1,30,19,113,149,262
2017,1,30,20,92,113,205
2017,1,30,21,51,77,128
2017,1,30,22,34,47,81
2017,1,30,23,17,21,38
2017,1,31,0,14,16,30
2017,1,31,1,9,13,22
2017,1,31,2,6,11,17
2017,1,31,3,7,12,19
2017,1,31,4,18,10,28
2017,1,31,5,102,53,155
2017,1,31,6,239,161,400
2017,1,31,7,352,179,531
2017,1,31,8,239,188,427
2017,1,31,9,220,186,406
2017,1,31,10,231,208,439
2017,1,31,11,187,181,368
2017,1,31,12,223,206,429
2017,1,31,13,188,222,410
2017,1,31,14,249,353,602
2017,1,31,15,198,321,519
2017,1,31,16,174,207,381
2017,1,31,17,194,181,375
2017,1,31,18,160,130,290
2017,1,31,19,120,137,257
2017,1,31,20,84,113,197
2017,1,31,21,53,84,137
2017,1,31,22,39,44,83
2017,1,31,23,10,38,48
2017,2,1,0,12,32,44
2017,2,1,1,14,28,42
2017,2,1,2,9,19,28
2017,2,1,3,12,14,26
2017,2,1,4,15,11,26
2017,2,1,5,105,64,169
2017,2,1,6,232,156,388
2017,2,1,7,369,199,568
2017,2,1,8,261,150,411
2017,2,1,9,154,153,307
2017,2,1,10,183,165,348
2017,2,1,11,192,192,384
2017,2,1,12,210,208,418
2017,2,1,13,212,257,469
2017,2,1,14,232,320,552
2017,2,1,15,215,309,524
2017,2,1,16,169,191,360
2017,2,1,17,173,152,325
2017,2,1,18,119,146,265
2017,2,1,19,120,115,235
2017,2,1,20,91,117,208
2017,2,1,21,55,82,137
2017,2,1,22,37,48,85
2017,2,1,23,19,24,43
2017,2,2,0,10,17,27
2017,2,2,1,11,15,26
2017,2,2,2,8,10,18
2017,2,2,3,2,7,9
2017,2,2,4,17,7,24
2017,2,2,5,103,59,162
2017,2,2,6,115,140,255
2017,2,2,7,169,213,382
2017,2,2,8,65,181,246
2017,2,2,9,88,220,308
2017,2,2,10,212,187,399
2017,2,2,11,222,188,410
2017,2,2,12,123,223,346
2017,2,2,13,66,260,326
2017,2,2,14,204,405,609
2017,2,2,15,179,472,651
2017,2,2,16,139,234,373
2017,2,2,17,168,159,327
2017,2,2,18,146,169,315
2017,2,2,19,92,137,229
2017,2,2,20,67,113,180
2017,2,2,21,56,80,136
2017,2,2,22,29,58,87
2017,2,2,23,21,22,43
2017,2,3,0,17,21,38
2017,2,3,1,9,22,31
2017,2,3,2,9,28,37
2017,2,3,3,7,17,24
2017,2,3,4,17,12,29
2017,2,3,5,107,52,159
2017,2,3,6,219,145,364
2017,2,3,7,269,162,431
2017,2,3,8,241,151,392
2017,2,3,9,212,174,386
2017,2,3,10,214,194,408
2017,2,3,11,211,223,434
2017,2,3,12,238,238,476
2017,2,3,13,246,312,558
2017,2,3,14,288,360,648
2017,2,3,15,194,272,466
2017,2,3,16,180,190,370
2017,2,3,17,138,142,280
2017,2,3,18,129,136,265
2017,2,3,19,73,98,171
2017,2,3,20,76,99,175
2017,2,3,21,47,60,107
2017,2,3,22,44,66,110
2017,2,3,23,32,57,89
2017,2,4,0,20,35,55
2017,2,4,1,22,46,68
2017,2,4,2,17,63,80
2017,2,4,3,11,28,39
2017,2,4,4,11,17,28
2017,2,4,5,20,17,37
2017,2,4,6,26,18,44
2017,2,4,7,32,28,60
2017,2,4,8,63,43,106
2017,2,4,9,116,88,204
2017,2,4,10,122,120,242
2017,2,4,11,140,126,266
2017,2,4,12,151,149,300
2017,2,4,13,144,147,291
2017,2,4,14,119,153,272
2017,2,4,15,138,169,307
2017,2,4,16,112,132,244
2017,2,4,17,130,138,268
2017,2,4,18,96,93,189
2017,2,4,19,71,81,152
2017,2,4,20,46,71,117
2017,2,4,21,33,56,89
2017,2,4,22,34,72,106
2017,2,4,23,32,68,100
2017,2,5,0,36,60,96
2017,2,5,1,27,65,92
2017,2,5,2,28,48,76
2017,2,5,3,21,43,64
2017,2,5,4,15,33,48
2017,2,5,5,16,14,30
2017,2,5,6,19,17,36
2017,2,5,7,22,12,34
2017,2,5,8,47,30,77
2017,2,5,9,76,63,139
2017,2,5,10,91,67,158
2017,2,5,11,126,140,266
2017,2,5,12,118,164,282
2017,2,5,13,179,189,368
2017,2,5,14,154,192,346
2017,2,5,15,158,212,370
2017,2,5,16,169,173,342
2017,2,5,17,151,149,300
2017,2,5,18,123,154,277
2017,2,5,19,97,174,271
2017,2,5,20,76,94,170
2017,2,5,21,55,57,112
2017,2,5,22,36,35,71
2017,2,5,23,20,23,43
2017,2,6,0,7,22,29
2017,2,6,1,6,15,21
2017,2,6,2,5,11,16
2017,2,6,3,5,16,21
2017,2,6,4,19,8,27
2017,2,6,5,108,65,173
2017,2,6,6,225,144,369
2017,2,6,7,401,203,604
2017,2,6,8,249,167,416
2017,2,6,9,231,173,404
2017,2,6,10,194,188,382
2017,2,6,11,184,179,363
2017,2,6,12,178,221,399
2017,2,6,13,229,268,497
2017,2,6,14,260,370,630
2017,2,6,15,234,268,502
2017,2,6,16,205,171,376
2017,2,6,17,167,130,297
2017,2,6,18,130,169,299
2017,2,6,19,112,99,211
2017,2,6,20,69,113,182
2017,2,6,21,59,150,209
2017,2,6,22,39,157,196
2017,2,6,23,14,59,73
2017,2,7,0,11,20,31
2017,2,7,1,11,26,37
2017,2,7,2,6,12,18
2017,2,7,3,4,10,14
2017,2,7,4,17,8,25
2017,2,7,5,108,64,172
2017,2,7,6,229,162,391
2017,2,7,7,385,175,560
2017,2,7,8,272,155,427
2017,2,7,9,215,189,404
2017,2,7,10,198,175,373
2017,2,7,11,197,189,386
2017,2,7,12,200,226,426
2017,2,7,13,211,250,461
2017,2,7,14,256,296,552
2017,2,7,15,246,291,537
2017,2,7,16,193,216,409
2017,2,7,17,171,156,327
2017,2,7,18,154,168,322
2017,2,7,19,124,183,307
2017,2,7,20,82,127,209
2017,2,7,21,59,79,138
2017,2,7,22,23,41,64
2017,2,7,23,14,18,32
2017,2,8,0,12,20,32
2017,2,8,1,8,13,21
2017,2,8,2,7,13,20
2017,2,8,3,6,9,15
2017,2,8,4,12,14,26
2017,2,8,5,118,63,181
2017,2,8,6,234,150,384
2017,2,8,7,354,190,544
2017,2,8,8,281,175,456
2017,2,8,9,257,177,434
2017,2,8,10,205,177,382
2017,2,8,11,198,181,379
2017,2,8,12,191,216,407
2017,2,8,13,205,263,468
2017,2,8,14,282,333,615
2017,2,8,15,214,309,523
2017,2,8,16,178,184,362
2017,2,8,17,182,185,367
2017,2,8,18,127,127,254
2017,2,8,19,112,119,231
2017,2,8,20,90,136,226
2017,2,8,21,49,71,120
2017,2,8,22,29,35,64
2017,2,8,23,20,30,50
2017,2,9,0,11,15,26
2017,2,9,1,7,17,24
2017,2,9,2,6,17,23
2017,2,9,3,8,9,17
2017,2,9,4,13,15,28
2017,2,9,5,99,57,156
2017,2,9,6,238,153,391
2017,2,9,7,383,228,611
2017,2,9,8,258,163,421
2017,2,9,9,207,171,378
2017,2,9,10,204,164,368
2017,2,9,11,197,206,403
2017,2,9,12,201,215,416
2017,2,9,13,208,247,455
2017,2,9,14,265,328,593
2017,2,9,15,225,316,541
2017,2,9,16,187,210,397
2017,2,9,17,195,159,354
2017,2,9,18,134,189,323
2017,2,9,19,118,114,232
2017,2,9,20,97,113,210
2017,2,9,21,50,225,275
2017,2,9,22,38,154,192
2017,2,9,23,24,30,54
2017,2,10,0,11,21,32
2017,2,10,1,12,29,41
2017,2,10,2,8,24,32
2017,2,10,3,4,16,20
2017,2,10,4,15,16,31
2017,2,10,5,97,64,161
2017,2,10,6,241,142,383
2017,2,10,7,376,174,550
2017,2,10,8,240,163,403
2017,2,10,9,204,175,379
2017,2,10,10,209,184,393
2017,2,10,11,198,216,414
2017,2,10,12,228,247,475
2017,2,10,13,249,313,562
2017,2,10,14,288,377,665
2017,2,10,15,197,262,459
2017,2,10,16,182,201,383
2017,2,10,17,134,151,285
2017,2,10,18,104,154,258
2017,2,10,19,102,95,197
2017,2,10,20,75,82,157
2017,2,10,21,52,70,122
2017,2,10,22,50,68,118
2017,2,10,23,38,47,85
2017,2,11,0,36,41,77
2017,2,11,1,15,53,68
2017,2,11,2,20,60,80
2017,2,11,3,10,26,36
2017,2,11,4,12,12,24
2017,2,11,5,22,24,46
2017,2,11,6,32,22,54
2017,2,11,7,38,37,75
2017,2,11,8,67,49,116
2017,2,11,9,106,81,187
2017,2,11,10,119,104,223
2017,2,11,11,133,138,271
2017,2,11,12,144,157,301
2017,2,11,13,140,158,298
2017,2,11,14,149,195,344
2017,2,11,15,145,166,311
2017,2,11,16,130,174,304
2017,2,11,17,136,141,277
2017,2,11,18,104,102,206
2017,2,11,19,79,91,170
2017,2,11,20,60,84,144
2017,2,11,21,41,64,105
2017,2,11,22,48,63,111
2017,2,11,23,37,76,113
2017,2,12,0,36,62,98
2017,2,12,1,32,60,92
2017,2,12,2,30,73,103
2017,2,12,3,19,43,62
2017,2,12,4,15,18,33
2017,2,12,5,12,8,20
2017,2,12,6,15,21,36
2017,2,12,7,30,20,50
2017,2,12,8,48,33,81
2017,2,12,9,74,47,121
2017,2,12,10,91,78,169
2017,2,12,11,141,142,283
2017,2,12,12,142,162,304
2017,2,12,13,167,198,365
2017,2,12,14,175,186,361
2017,2,12,15,136,204,340
2017,2,12,16,159,187,346
2017,2,12,17,164,170,334
2017,2,12,18,162,148,310
2017,2,12,19,82,110,192
2017,2,12,20,74,89,163
2017,2,12,21,59,89,148
2017,2,12,22,23,48,71
2017,2,12,23,26,24,50
2017,2,13,0,7,14,21
2017,2,13,1,11,13,24
2017,2,13,2,4,18,22
2017,2,13,3,6,8,14
2017,2,13,4,10,10,20
2017,2,13,5,106,59,165
2017,2,13,6,227,157,384
2017,2,13,7,374,179,553
2017,2,13,8,247,156,403
2017,2,13,9,200,160,360
2017,2,13,10,202,167,369
2017,2,13,11,184,209,393
2017,2,13,12,230,280,510
2017,2,13,13,209,262,471
2017,2,13,14,241,340,581
2017,2,13,15,204,290,494
2017,2,13,16,179,194,373
2017,2,13,17,172,146,318
2017,2,13,18,116,139,255
2017,2,13,19,108,122,230
2017,2,13,20,77,123,200
2017,2,13,21,69,62,131
2017,2,13,22,31,38,69
2017,2,13,23,15,13,28
2017,2,14,0,10,14,24
2017,2,14,1,5,6,11
2017,2,14,2,5,18,23
2017,2,14,3,5,4,9
2017,2,14,4,20,3,23
2017,2,14,5,99,49,148
2017,2,14,6,237,138,375
2017,2,14,7,385,190,575
2017,2,14,8,226,158,384
2017,2,14,9,202,180,382
2017,2,14,10,215,176,391
2017,2,14,11,184,198,382
2017,2,14,12,220,208,428
2017,2,14,13,196,249,445
2017,2,14,14,254,312,566
2017,2,14,15,241,301,542
2017,2,14,16,204,205,409
2017,2,14,17,221,169,390
2017,2,14,18,147,164,311
2017,2,14,19,106,136,242
2017,2,14,20,81,105,186
2017,2,14,21,63,103,166
2017,2,14,22,23,54,77
2017,2,14,23,19,29,48
2017,2,15,0,10,32,42
2017,2,15,1,5,14,19
2017,2,15,2,7,22,29
2017,2,15,3,9,17,26
2017,2,15,4,15,16,31
2017,2,15,5,94,55,149
2017,2,15,6,228,150,378
2017,2,15,7,380,180,560
2017,2,15,8,241,184,425
2017,2,15,9,194,158,352
2017,2,15,10,176,180,356
2017,2,15,11,206,201,407
2017,2,15,12,194,212,406
2017,2,15,13,204,231,435
2017,2,15,14,266,334,600
2017,2,15,15,244,353,597
2017,2,15,16,204,213,417
2017,2,15,17,157,155,312
2017,2,15,18,136,148,284
2017,2,15,19,123,99,222
2017,2,15,20,82,112,194
2017,2,15,21,59,98,157
2017,2,15,22,37,62,99
2017,2,15,23,12,25,37
2017,2,16,0,12,19,31
2017,2,16,1,11,15,26
2017,2,16,2,9,23,32
2017,2,16,3,7,19,26
2017,2,16,4,14,15,29
2017,2,16,5,91,54,145
2017,2,16,6,248,165,413
2017,2,16,7,427,192,619
2017,2,16,8,263,177,440
2017,2,16,9,209,187,396
2017,2,16,10,201,183,384
2017,2,16,11,235,213,448
2017,2,16,12,217,230,447
2017,2,16,13,216,255,471
2017,2,16,14,261,308,569
2017,2,16,15,243,300,543
2017,2,16,16,190,234,424
2017,2,16,17,204,140,344
2017,2,16,18,155,202,357
2017,2,16,19,115,152,267
2017,2,16,20,73,133,206
2017,2,16,21,58,102,160
2017,2,16,22,26,51,77
2017,2,16,23,19,28,47
2017,2,17,0,10,18,28
2017,2,17,1,11,14,25
2017,2,17,2,9,32,41
2017,2,17,3,6,13,19
2017,2,17,4,12,20,32
2017,2,17,5,99,59,158
2017,2,17,6,226,136,362
2017,2,17,7,365,182,547
2017,2,17,8,236,133,369
2017,2,17,9,190,177,367
2017,2,17,10,213,170,383
2017,2,17,11,220,224,444
2017,2,17,12,205,248,453
2017,2,17,13,253,293,546
2017,2,17,14,232,318,550
2017,2,17,15,242,256,498
2017,2,17,16,156,192,348
2017,2,17,17,189,138,327
2017,2,17,18,113,145,258
2017,2,17,19,89,103,192
2017,2,17,20,79,96,175
2017,2,17,21,67,76,143
2017,2,17,22,45,73,118
2017,2,17,23,47,69,116
2017,2,18,0,27,42,69
2017,2,18,1,16,41,57
2017,2,18,2,14,48,62
2017,2,18,3,10,42,52
2017,2,18,4,14,9,23
2017,2,18,5,17,21,38
2017,2,18,6,22,17,39
2017,2,18,7,45,35,80
2017,2,18,8,86,64,150
2017,2,18,9,102,77,179
2017,2,18,10,152,111,263
2017,2,18,11,169,166,335
2017,2,18,12,150,171,321
2017,2,18,13,153,170,323
2017,2,18,14,146,252,398
2017,2,18,15,144,204,348
2017,2,18,16,106,160,266
2017,2,18,17,135,123,258
2017,2,18,18,124,121,245
2017,2,18,19,111,124,235
2017,2,18,20,66,107,173
2017,2,18,21,49,64,113
2017,2,18,22,45,65,110
2017,2,18,23,48,62,110
2017,2,19,0,42,68,110
2017,2,19,1,33,50,83
2017,2,19,2,24,69,93
2017,2,19,3,28,44,72
2017,2,19,4,15,24,39
2017,2,19,5,17,23,40
2017,2,19,6,12,18,30
2017,2,19,7,41,16,57
2017,2,19,8,41,34,75
2017,2,19,9,109,42,151
2017,2,19,10,105,61,166
2017,2,19,11,153,164,317
2017,2,19,12,145,171,316
2017,2,19,13,205,198,403
2017,2,19,14,163,241,404
2017,2,19,15,162,251,413
2017,2,19,16,138,207,345
2017,2,19,17,163,140,303
2017,2,19,18,148,171,319
2017,2,19,19,117,179,296
2017,2,19,20,78,101,179
2017,2,19,21,55,71,126
2017,2,19,22,41,61,102
2017,2,19,23,17,18,35
2017,2,20,0,12,21,33
2017,2,20,1,12,15,27
2017,2,20,2,6,11,17
2017,2,20,3,6,11,17
2017,2,20,4,19,20,39
2017,2,20,5,113,56,169
2017,2,20,6,235,152,387
2017,2,20,7,394,193,587
2017,2,20,8,240,166,406
2017,2,20,9,211,178,389
2017,2,20,10,231,167,398
2017,2,20,11,211,185,396
2017,2,20,12,212,243,455
2017,2,20,13,196,254,450
2017,2,20,14,245,336,581
2017,2,20,15,233,322,555
2017,2,20,16,218,194,412
2017,2,20,17,188,162,350
2017,2,20,18,144,165,309
2017,2,20,19,127,143,270
2017,2,20,20,90,138,228
2017,2,20,21,44,93,137
2017,2,20,22,25,57,82
2017,2,20,23,23,21,44
2017,2,21,0,12,10,22
2017,2,21,1,5,14,19
2017,2,21,2,5,8,13
2017,2,21,3,11,11,22
2017,2,21,4,23,14,37
2017,2,21,5,101,58,159
2017,2,21,6,233,144,377
2017,2,21,7,391,205,596
2017,2,21,8,241,165,406
2017,2,21,9,217,184,401
2017,2,21,10,240,194,434
2017,2,21,11,210,216,426
2017,2,21,12,197,200,397
2017,2,21,13,191,255,446
2017,2,21,14,247,357,604
2017,2,21,15,246,349,595
2017,2,21,16,220,218,438
2017,2,21,17,169,132,301
2017,2,21,18,146,163,309
2017,2,21,19,131,133,264
2017,2,21,20,81,121,202
2017,2,21,21,65,112,177
2017,2,21,22,32,53,85
2017,2,21,23,14,37,51
2017,2,22,0,9,16,25
2017,2,22,1,7,20,27
2017,2,22,2,12,15,27
2017,2,22,3,8,13,21
2017,2,22,4,15,20,35
2017,2,22,5,100,68,168
2017,2,22,6,248,155,403
2017,2,22,7,384,206,590
2017,2,22,8,275,160,435
2017,2,22,9,206,168,374
2017,2,22,10,226,201,427
2017,2,22,11,215,184,399
2017,2,22,12,201,240,441
2017,2,22,13,217,242,459
2017,2,22,14,233,351,584
2017,2,22,15,229,309,538
2017,2,22,16,202,201,403
2017,2,22,17,176,165,341
2017,2,22,18,146,173,319
2017,2,22,19,111,135,246
2017,2,22,20,88,126,214
2017,2,22,21,53,111,164
2017,2,22,22,35,61,96
2017,2,22,23,19,42,61
2017,2,23,0,13,26,39
2017,2,23,1,14,31,45
2017,2,23,2,9,25,34
2017,2,23,3,9,24,33
2017,2,23,4,14,19,33
2017,2,23,5,112,51,163
2017,2,23,6,250,155,405
2017,2,23,7,419,214,633
2017,2,23,8,273,172,445
2017,2,23,9,214,171,385
2017,2,23,10,200,199,399
2017,2,23,11,204,222,426
2017,2,23,12,228,207,435
2017,2,23,13,193,247,440
2017,2,23,14,247,336,583
2017,2,23,15,238,313,551
2017,2,23,16,212,233,445
2017,2,23,17,228,169,397
2017,2,23,18,155,202,357
2017,2,23,19,99,138,237
2017,2,23,20,98,135,233
2017,2,23,21,50,112,162
2017,2,23,22,35,275,310
2017,2,23,23,14,27,41
2017,2,24,0,14,23,37
2017,2,24,1,18,27,45
2017,2,24,2,13,25,38
2017,2,24,3,5,21,26
2017,2,24,4,18,15,33
2017,2,24,5,108,57,165
2017,2,24,6,240,128,368
2017,2,24,7,359,186,545
2017,2,24,8,254,163,417
2017,2,24,9,211,163,374
2017,2,24,10,206,182,388
2017,2,24,11,211,223,434
2017,2,24,12,235,218,453
2017,2,24,13,247,314,561
2017,2,24,14,278,376,654
2017,2,24,15,206,272,478
2017,2,24,16,174,191,365
2017,2,24,17,123,133,256
2017,2,24,18,106,124,230
2017,2,24,19,85,87,172
2017,2,24,20,67,77,144
2017,2,24,21,59,72,131
2017,2,24,22,49,69,118
2017,2,24,23,35,52,87
2017,2,25,0,36,53,89
2017,2,25,1,21,35,56
2017,2,25,2,21,56,77
2017,2,25,3,17,25,42
2017,2,25,4,17,16,33
2017,2,25,5,23,19,42
2017,2,25,6,21,19,40
2017,2,25,7,32,32,64
2017,2,25,8,48,51,99
2017,2,25,9,101,78,179
2017,2,25,10,110,87,197
2017,2,25,11,162,137,299
2017,2,25,12,160,161,321
2017,2,25,13,136,180,316
2017,2,25,14,127,176,303
2017,2,25,15,107,148,255
2017,2,25,16,124,150,274
2017,2,25,17,110,135,245
2017,2,25,18,107,104,211
2017,2,25,19,81,102,183
2017,2,25,20,56,63,119
2017,2,25,21,44,52,96
2017,2,25,22,38,55,93
2017,2,25,23,37,56,93
2017,2,26,0,24,46,70
2017,2,26,1,21,64,85
2017,2,26,2,24,66,90
2017,2,26,3,24,53,77
2017,2,26,4,15,18,33
2017,2,26,5,20,20,40
2017,2,26,6,11,11,22
2017,2,26,7,29,14,43
2017,2,26,8,42,31,73
2017,2,26,9,79,48,127
2017,2,26,10,97,72,169
2017,2,26,11,130,128,258
2017,2,26,12,126,138,264
2017,2,26,13,147,170,317
2017,2,26,14,120,146,266
2017,2,26,15,119,187,306
2017,2,26,16,145,177,322
2017,2,26,17,127,139,266
2017,2,26,18,129,119,248
2017,2,26,19,114,144,258
2017,2,26,20,85,107,192
2017,2,26,21,51,62,113
2017,2,26,22,37,50,87
2017,2,26,23,20,21,41
2017,2,27,0,7,18,25
2017,2,27,1,11,15,26
2017,2,27,2,8,11,19
2017,2,27,3,9,10,19
2017,2,27,4,12,12,24
2017,2,27,5,108,64,172
2017,2,27,6,209,129,338
2017,2,27,7,298,157,455
2017,2,27,8,240,159,399
2017,2,27,9,195,151,346
2017,2,27,10,209,177,386
2017,2,27,11,219,171,390
2017,2,27,12,192,197,389
2017,2,27,13,193,247,440
2017,2,27,14,208,300,508
2017,2,27,15,178,285,463
2017,2,27,16,161,166,327
2017,2,27,17,164,125,289
2017,2,27,18,114,141,255
2017,2,27,19,106,104,210
2017,2,27,20,82,117,199
2017,2,27,21,46,85,131
2017,2,27,22,32,54,86
2017,2,27,23,22,18,40
2017,2,28,0,8,14,22
2017,2,28,1,1,15,16
2017,2,28,2,6,20,26
2017,2,28,3,3,8,11
2017,2,28,4,13,16,29
2017,2,28,5,98,57,155
2017,2,28,6,226,112,338
2017,2,28,7,316,148,464
2017,2,28,8,217,149,366
2017,2,28,9,207,150,357
2017,2,28,10,195,202,397
2017,2,28,11,228,197,425
2017,2,28,12,183,217,400
2017,2,28,13,185,247,432
2017,2,28,14,214,280,494
2017,2,28,15,189,262,451
2017,2,28,16,164,174,338
2017,2,28,17,158,140,298
2017,2,28,18,149,127,276
2017,2,28,19,107,123,230
2017,2,28,20,85,105,190
2017,2,28,21,68,401,469
2017,2,28,22,31,265,296
2017,2,28,23,19,94,113
2017,3,1,0,13,44,57
2017,3,1,1,5,31,36
2017,3,1,2,5,14,19
2017,3,1,3,10,9,19
2017,3,1,4,12,9,21
2017,3,1,5,96,55,151
2017,3,1,6,216,138,354
2017,3,1,7,301,147,448
2017,3,1,8,254,156,410
2017,3,1,9,217,166,383
2017,3,1,10,212,186,398
2017,3,1,11,174,186,360
2017,3,1,12,183,198,381
2017,3,1,13,197,246,443
2017,3,1,14,229,309,538
2017,3,1,15,200,264,464
2017,3,1,16,189,177,366
2017,3,1,17,152,129,281
2017,3,1,18,133,163,296
2017,3,1,19,114,141,255
2017,3,1,20,73,135,208
2017,3,1,21,59,84,143
2017,3,1,22,30,48,78
2017,3,1,23,17,30,47
2017,3,2,0,12,19,31
2017,3,2,1,13,34,47
2017,3,2,2,7,13,20
2017,3,2,3,8,17,25
2017,3,2,4,14,13,27
2017,3,2,5,78,53,131
2017,3,2,6,185,121,306
2017,3,2,7,276,157,433
2017,3,2,8,188,148,336
2017,3,2,9,202,186,388
2017,3,2,10,193,152,345
2017,3,2,11,193,175,368
2017,3,2,12,194,202,396
2017,3,2,13,175,218,393
2017,3,2,14,219,256,475
2017,3,2,15,187,245,432
2017,3,2,16,177,189,366
2017,3,2,17,138,150,288
2017,3,2,18,116,131,247
2017,3,2,19,103,112,215
2017,3,2,20,69,119,188
2017,3,2,21,63,74,137
2017,3,2,22,26,49,75
2017,3,2,23,22,29,51
2017,3,3,0,14,22,36
2017,3,3,1,5,20,25
2017,3,3,2,8,20,28
2017,3,3,3,8,17,25
2017,3,3,4,14,22,36
2017,3,3,5,85,52,137
2017,3,3,6,206,121,327
2017,3,3,7,240,131,371
2017,3,3,8,233,139,372
2017,3,3,9,189,143,332
2017,3,3,10,192,178,370
2017,3,3,11,192,150,342
2017,3,3,12,166,161,327
2017,3,3,13,193,267,460
2017,3,3,14,212,257,469
2017,3,3,15,176,189,365
2017,3,3,16,139,198,337
2017,3,3,17,119,125,244
2017,3,3,18,119,119,238
2017,3,3,19,99,96,195
2017,3,3,20,74,94,168
2017,3,3,21,36,77,113
2017,3,3,22,37,58,95
2017,3,3,23,29,51,80
2017,3,4,0,27,38,65
2017,3,4,1,18,39,57
2017,3,4,2,12,45,57
2017,3,4,3,6,30,36
2017,3,4,4,4,11,15
2017,3,4,5,19,15,34
2017,3,4,6,25,24,49
2017,3,4,7,31,38,69
2017,3,4,8,51,55,106
2017,3,4,9,103,70,173
2017,3,4,10,111,84,195
2017,3,4,11,139,124,263
2017,3,4,12,121,145,266
2017,3,4,13,123,133,256
2017,3,4,14,118,163,281
2017,3,4,15,118,167,285
2017,3,4,16,116,132,248
2017,3,4,17,118,120,238
2017,3,4,18,84,102,186
2017,3,4,19,81,90,171
2017,3,4,20,56,71,127
2017,3,4,21,48,65,113
2017,3,4,22,41,61,102
2017,3,4,23,46,59,105
2017,3,5,0,32,47,79
2017,3,5,1,22,53,75
2017,3,5,2,20,60,80
2017,3,5,3,14,45,59
2017,3,5,4,18,26,44
2017,3,5,5,11,11,22
2017,3,5,6,15,13,28
2017,3,5,7,30,20,50
2017,3,5,8,28,32,60
2017,3,5,9,85,44,129
2017,3,5,10,109,69,178
2017,3,5,11,101,126,227
2017,3,5,12,136,156,292
2017,3,5,13,137,159,296
2017,3,5,14,135,174,309
2017,3,5,15,142,201,343
2017,3,5,16,146,150,296
2017,3,5,17,154,168,322
2017,3,5,18,143,144,287
2017,3,5,19,98,157,255
2017,3,5,20,71,80,151
2017,3,5,21,38,82,120
2017,3,5,22,32,116,148
2017,3,5,23,21,17,38
2017,3,6,0,11,20,31
2017,3,6,1,5,10,15
2017,3,6,2,8,14,22
2017,3,6,3,5,9,14
2017,3,6,4,15,12,27
2017,3,6,5,113,53,166
2017,3,6,6,289,177,466
2017,3,6,7,375,242,617
2017,3,6,8,271,161,432
2017,3,6,9,196,162,358
2017,3,6,10,190,207,397
2017,3,6,11,182,208,390
2017,3,6,12,203,210,413
2017,3,6,13,184,244,428
2017,3,6,14,234,307,541
2017,3,6,15,225,294,519
2017,3,6,16,192,198,390
2017,3,6,17,151,145,296
2017,3,6,18,162,142,304
2017,3,6,19,133,134,267
2017,3,6,20,93,138,231
2017,3,6,21,55,88,143
2017,3,6,22,31,45,76
2017,3,6,23,15,25,40
2017,3,7,0,9,25,34
2017,3,7,1,8,8,16
2017,3,7,2,8,6,14
2017,3,7,3,6,6,12
2017,3,7,4,20,14,34
2017,3,7,5,102,49,151
2017,3,7,6,258,140,398
2017,3,7,7,381,235,616
2017,3,7,8,249,175,424
2017,3,7,9,187,199,386
2017,3,7,10,210,168,378
2017,3,7,11,203,194,397
2017,3,7,12,206,198,404
2017,3,7,13,192,247,439
2017,3,7,14,253,311,564
2017,3,7,15,246,297,543
2017,3,7,16,188,208,396
2017,3,7,17,188,157,345
2017,3,7,18,160,146,306
2017,3,7,19,135,147,282
2017,3,7,20,75,112,187
2017,3,7,21,63,122,185
2017,3,7,22,28,53,81
2017,3,7,23,14,22,36
2017,3,8,0,14,23,37
2017,3,8,1,8,20,28
2017,3,8,2,7,12,19
2017,3,8,3,6,12,18
2017,3,8,4,16,18,34
2017,3,8,5,114,51,165
2017,3,8,6,254,151,405
2017,3,8,7,359,228,587
2017,3,8,8,253,183,436
2017,3,8,9,223,177,400
2017,3,8,10,206,194,400
2017,3,8,11,200,208,408
2017,3,8,12,212,212,424
2017,3,8,13,199,282,481
2017,3,8,14,236,335,571
2017,3,8,15,242,287,529
2017,3,8,16,209,189,398
2017,3,8,17,172,166,338
2017,3,8,18,153,151,304
2017,3,8,19,132,130,262
2017,3,8,20,77,142,219
2017,3,8,21,57,76,133
2017,3,8,22,36,59,95
2017,3,8,23,19,24,43
2017,3,9,0,13,22,35
2017,3,9,1,10,23,33
2017,3,9,2,11,16,27
2017,3,9,3,4,10,14
2017,3,9,4,13,22,35
2017,3,9,5,96,61,157
2017,3,9,6,234,142,376
2017,3,9,7,399,203,602
2017,3,9,8,258,160,418
2017,3,9,9,216,159,375
2017,3,9,10,183,177,360
2017,3,9,11,231,194,425
2017,3,9,12,174,207,381
2017,3,9,13,209,255,464
2017,3,9,14,245,341,586
2017,3,9,15,252,330,582
2017,3,9,16,207,239,446
2017,3,9,17,175,158,333
2017,3,9,18,153,200,353
2017,3,9,19,107,160,267
2017,3,9,20,93,148,241
2017,3,9,21,80,90,170
2017,3,9,22,38,70,108
2017,3,9,23,18,23,41
2017,3,10,0,14,32,46
2017,3,10,1,12,24,36
2017,3,10,2,6,18,24
2017,3,10,3,11,15,26
2017,3,10,4,17,13,30
2017,3,10,5,107,67,174
2017,3,10,6,232,136,368
2017,3,10,7,356,231,587
2017,3,10,8,234,143,377
2017,3,10,9,216,178,394
2017,3,10,10,197,169,366
2017,3,10,11,226,242,468
2017,3,10,12,221,234,455
2017,3,10,13,235,316,551
2017,3,10,14,283,348,631
2017,3,10,15,184,295,479
2017,3,10,16,163,170,333
2017,3,10,17,143,158,301
2017,3,10,18,117,134,251
2017,3,10,19,104,119,223
2017,3,10,20,63,85,148
2017,3,10,21,57,70,127
2017,3,10,22,42,62,104
2017,3,10,23,37,65,102
2017,3,11,0,29,40,69
2017,3,11,1,19,41,60
2017,3,11,2,19,56,75
2017,3,11,3,19,34,53
2017,3,11,4,22,20,42
2017,3,11,5,21,18,39
2017,3,11,6,25,24,49
2017,3,11,7,45,43,88
2017,3,11,8,84,50,134
2017,3,11,9,133,99,232
2017,3,11,10,132,108,240
2017,3,11,11,157,151,308
2017,3,11,12,158,157,315
2017,3,11,13,159,188,347
2017,3,11,14,173,163,336
2017,3,11,15,122,174,296
2017,3,11,16,117,147,264
2017,3,11,17,107,145,252
2017,3,11,18,94,101,195
2017,3,11,19,105,100,205
2017,3,11,20,52,59,111
2017,3,11,21,47,67,114
2017,3,11,22,38,77,115
2017,3,11,23,50,62,112
2017,3,12,0,39,56,95
2017,3,12,1,24,53,77
2017,3,12,2,27,61,88
2017,3,12,3,15,46,61
2017,3,12,4,15,24,39
2017,3,12,5,17,14,31
2017,3,12,6,16,14,30
2017,3,12,7,32,23,55
2017,3,12,8,52,38,90
2017,3,12,9,103,57,160
2017,3,12,10,108,71,179
2017,3,12,11,144,128,272
2017,3,12,12,118,169,287
2017,3,12,13,187,202,389
2017,3,12,14,153,211,364
2017,3,12,15,155,242,397
2017,3,12,16,181,179,360
2017,3,12,17,160,153,313
2017,3,12,18,162,173,335
2017,3,12,19,123,165,288
2017,3,12,20,72,125,197
2017,3,12,21,51,68,119
2017,3,12,22,28,33,61
2017,3,12,23,16,20,36
2017,3,13,0,10,14,24
2017,3,13,1,10,16,26
2017,3,13,2,6,15,21
2017,3,13,3,9,15,24
2017,3,13,4,20,13,33
2017,3,13,5,109,59,168
2017,3,13,6,250,143,393
2017,3,13,7,426,211,637
2017,3,13,8,248,158,406
2017,3,13,9,191,156,347
2017,3,13,10,186,165,351
2017,3,13,11,205,200,405
2017,3,13,12,222,188,410
2017,3,13,13,196,281,477
2017,3,13,14,218,297,515
2017,3,13,15,254,323,577
2017,3,13,16,196,178,374
2017,3,13,17,170,171,341
2017,3,13,18,130,145,275
2017,3,13,19,113,121,234
2017,3,13,20,73,103,176
2017,3,13,21,36,90,126
2017,3,13,22,35,55,90
2017,3,13,23,14,26,40
2017,3,14,0,11,15,26
2017,3,14,1,9,14,23
2017,3,14,2,1,4,5
2017,3,14,3,3,10,13
2017,3,14,4,15,7,22
2017,3,14,5,115,54,169
2017,3,14,6,250,170,420
2017,3,14,7,401,216,617
2017,3,14,8,259,183,442
2017,3,14,9,219,179,398
2017,3,14,10,207,191,398
2017,3,14,11,242,204,446
2017,3,14,12,203,221,424
2017,3,14,13,217,268,485
2017,3,14,14,247,317,564
2017,3,14,15,234,344,578
2017,3,14,16,205,205,410
2017,3,14,17,216,164,380
2017,3,14,18,135,157,292
2017,3,14,19,102,133,235
2017,3,14,20,81,113,194
2017,3,14,21,63,106,169
2017,3,14,22,30,55,85
2017,3,14,23,13,39,52
2017,3,15,0,14,22,36
2017,3,15,1,14,16,30
2017,3,15,2,9,21,30
2017,3,15,3,3,21,24
2017,3,15,4,11,16,27
2017,3,15,5,101,63,164
2017,3,15,6,252,147,399
2017,3,15,7,380,199,579
2017,3,15,8,279,163,442
2017,3,15,9,212,185,397
2017,3,15,10,233,183,416
2017,3,15,11,212,233,445
2017,3,15,12,195,226,421
2017,3,15,13,216,282,498
2017,3,15,14,259,302,561
2017,3,15,15,246,304,550
2017,3,15,16,201,214,415
2017,3,15,17,173,178,351
2017,3,15,18,140,147,287
2017,3,15,19,114,136,250
2017,3,15,20,86,109,195
2017,3,15,21,56,109,165
2017,3,15,22,33,49,82
2017,3,15,23,15,26,41
2017,3,16,0,14,19,33
2017,3,16,1,14,12,26
2017,3,16,2,6,24,30
2017,3,16,3,5,28,33
2017,3,16,4,12,10,22
2017,3,16,5,115,61,176
2017,3,16,6,257,150,407
2017,3,16,7,412,215,627
2017,3,16,8,249,179,428
2017,3,16,9,250,189,439
2017,3,16,10,196,181,377
2017,3,16,11,175,191,366
2017,3,16,12,190,233,423
2017,3,16,13,195,240,435
2017,3,16,14,303,345,648
2017,3,16,15,246,318,564
2017,3,16,16,197,231,428
2017,3,16,17,182,151,333
2017,3,16,18,163,180,343
2017,3,16,19,112,131,243
2017,3,16,20,75,107,182
2017,3,16,21,67,101,168
2017,3,16,22,37,192,229
2017,3,16,23,26,66,92
2017,3,17,0,12,23,35
2017,3,17,1,9,20,29
2017,3,17,2,6,23,29
2017,3,17,3,5,31,36
2017,3,17,4,15,21,36
2017,3,17,5,112,59,171
2017,3,17,6,236,158,394
2017,3,17,7,371,177,548
2017,3,17,8,236,158,394
2017,3,17,9,235,187,422
2017,3,17,10,189,185,374
2017,3,17,11,205,195,400
2017,3,17,12,215,245,460
2017,3,17,13,274,314,588
2017,3,17,14,298,332,630
2017,3,17,15,218,299,517
2017,3,17,16,175,185,360
2017,3,17,17,132,175,307
2017,3,17,18,130,155,285
2017,3,17,19,95,97,192
2017,3,17,20,56,94,150
2017,3,17,21,50,70,120
2017,3,17,22,56,74,130
2017,3,17,23,33,53,86
2017,3,18,0,24,53,77
2017,3,18,1,20,39,59
2017,3,18,2,26,47,73
2017,3,18,3,13,33,46
2017,3,18,4,9,17,26
2017,3,18,5,22,12,34
2017,3,18,6,31,33,64
2017,3,18,7,36,29,65
2017,3,18,8,65,46,111
2017,3,18,9,95,69,164
2017,3,18,10,123,88,211
2017,3,18,11,138,152,290
2017,3,18,12,139,155,294
2017,3,18,13,147,168,315
2017,3,18,14,125,190,315
2017,3,18,15,126,172,298
2017,3,18,16,142,165,307
2017,3,18,17,133,154,287
2017,3,18,18,127,134,261
2017,3,18,19,96,89,185
2017,3,18,20,65,81,146
2017,3,18,21,52,59,111
2017,3,18,22,42,63,105
2017,3,18,23,40,68,108
2017,3,19,0,30,42,72
2017,3,19,1,22,51,73
2017,3,19,2,29,63,92
2017,3,19,3,16,53,69
2017,3,19,4,19,33,52
2017,3,19,5,14,7,21
2017,3,19,6,26,14,40
2017,3,19,7,33,19,52
2017,3,19,8,60,40,100
2017,3,19,9,79,50,129
2017,3,19,10,104,76,180
2017,3,19,11,153,161,314
2017,3,19,12,166,182,348
2017,3,19,13,179,190,369
2017,3,19,14,154,204,358
2017,3,19,15,144,212,356
2017,3,19,16,161,183,344
2017,3,19,17,141,137,278
2017,3,19,18,151,130,281
2017,3,19,19,120,177,297
2017,3,19,20,79,95,174
2017,3,19,21,37,52,89
2017,3,19,22,37,40,77
2017,3,19,23,23,28,51
2017,3,20,0,15,16,31
2017,3,20,1,6,14,20
2017,3,20,2,5,15,20
2017,3,20,3,8,9,17
2017,3,20,4,19,13,32
2017,3,20,5,115,62,177
2017,3,20,6,256,139,395
2017,3,20,7,368,200,568
2017,3,20,8,263,170,433
2017,3,20,9,214,191,405
2017,3,20,10,192,180,372
2017,3,20,11,194,211,405
2017,3,20,12,179,214,393
2017,3,20,13,197,278,475
2017,3,20,14,244,329,573
2017,3,20,15,208,311,519
2017,3,20,16,193,189,382
2017,3,20,17,161,170,331
2017,3,20,18,144,150,294
2017,3,20,19,100,121,221
2017,3,20,20,78,110,188
2017,3,20,21,48,80,128
2017,3,20,22,25,39,64
2017,3,20,23,13,23,36
2017,3,21,0,12,14,26
2017,3,21,1,7,11,18
2017,3,21,2,8,11,19
2017,3,21,3,5,13,18
2017,3,21,4,20,12,32
2017,3,21,5,108,48,156
2017,3,21,6,258,157,415
2017,3,21,7,382,190,572
2017,3,21,8,287,186,473
2017,3,21,9,234,163,397
2017,3,21,10,200,197,397
2017,3,21,11,200,204,404
2017,3,21,12,213,235,448
2017,3,21,13,193,266,459
2017,3,21,14,243,350,593
2017,3,21,15,217,324,541
2017,3,21,16,194,221,415
2017,3,21,17,179,148,327
2017,3,21,18,155,160,315
2017,3,21,19,113,155,268
2017,3,21,20,88,132,220
2017,3,21,21,55,426,481
2017,3,21,22,40,221,261
2017,3,21,23,20,100,120
2017,3,22,0,9,23,32
2017,3,22,1,9,22,31
2017,3,22,2,9,16,25
2017,3,22,3,5,13,18
2017,3,22,4,13,15,28
2017,3,22,5,108,60,168
2017,3,22,6,269,159,428
2017,3,22,7,400,200,600
2017,3,22,8,262,172,434
2017,3,22,9,207,169,376
2017,3,22,10,182,212,394
2017,3,22,11,188,190,378
2017,3,22,12,204,206,410
2017,3,22,13,224,234,458
2017,3,22,14,224,296,520
2017,3,22,15,228,294,522
2017,3,22,16,197,220,417
2017,3,22,17,165,176,341
2017,3,22,18,152,166,318
2017,3,22,19,92,154,246
2017,3,22,20,77,103,180
2017,3,22,21,61,108,169
2017,3,22,22,28,48,76
2017,3,22,23,18,30,48
2017,3,23,0,16,18,34
2017,3,23,1,7,14,21
2017,3,23,2,10,11,21
2017,3,23,3,4,21,25
2017,3,23,4,15,13,28
2017,3,23,5,120,55,175
2017,3,23,6,235,154,389
2017,3,23,7,388,201,589
2017,3,23,8,274,173,447
2017,3,23,9,234,180,414
2017,3,23,10,174,167,341
2017,3,23,11,201,190,391
2017,3,23,12,214,208,422
2017,3,23,13,192,258,450
2017,3,23,14,281,333,614
2017,3,23,15,217,310,527
2017,3,23,16,229,213,442
2017,3,23,17,183,174,357
2017,3,23,18,158,178,336
2017,3,23,19,109,125,234
2017,3,23,20,82,131,213
2017,3,23,21,46,82,128
2017,3,23,22,31,61,92
2017,3,23,23,20,27,47
2017,3,24,0,16,33,49
2017,3,24,1,9,30,39
2017,3,24,2,6,30,36
2017,3,24,3,8,14,22
2017,3,24,4,17,12,29
2017,3,24,5,114,52,166
2017,3,24,6,267,145,412
2017,3,24,7,382,190,572
2017,3,24,8,261,179,440
2017,3,24,9,229,176,405
2017,3,24,10,232,226,458
2017,3,24,11,221,215,436
2017,3,24,12,247,269,516
2017,3,24,13,240,308,548
2017,3,24,14,296,408,704
2017,3,24,15,213,321,534
2017,3,24,16,141,190,331
2017,3,24,17,145,176,321
2017,3,24,18,119,125,244
2017,3,24,19,106,96,202
2017,3,24,20,75,93,168
2017,3,24,21,46,74,120
2017,3,24,22,49,62,111
2017,3,24,23,32,50,82
2017,3,25,0,33,30,63
2017,3,25,1,22,33,55
2017,3,25,2,15,46,61
2017,3,25,3,9,20,29
2017,3,25,4,12,17,29
2017,3,25,5,25,24,49
2017,3,25,6,27,22,49
2017,3,25,7,59,43,102
2017,3,25,8,83,74,157
2017,3,25,9,133,97,230
2017,3,25,10,137,117,254
2017,3,25,11,150,162,312
2017,3,25,12,170,183,353
2017,3,25,13,190,212,402
2017,3,25,14,155,191,346
2017,3,25,15,139,167,306
2017,3,25,16,135,183,318
2017,3,25,17,143,156,299
2017,3,25,18,113,125,238
2017,3,25,19,95,77,172
2017,3,25,20,54,76,130
2017,3,25,21,55,58,113
2017,3,25,22,40,73,113
2017,3,25,23,30,60,90
2017,3,26,0,38,46,84
2017,3,26,1,38,66,104
2017,3,26,2,31,63,94
2017,3,26,3,13,38,51
2017,3,26,4,13,20,33
2017,3,26,5,10,18,28
2017,3,26,6,49,26,75
2017,3,26,7,57,48,105
2017,3,26,8,87,44,131
2017,3,26,9,95,79,174
2017,3,26,10,119,127,246
2017,3,26,11,145,165,310
2017,3,26,12,170,191,361
2017,3,26,13,192,230,422
2017,3,26,14,174,235,409
2017,3,26,15,177,185,362
2017,3,26,16,154,181,335
2017,3,26,17,144,143,287
2017,3,26,18,108,155,263
2017,3,26,19,74,123,197
2017,3,26,20,60,81,141
2017,3,26,21,42,44,86
2017,3,26,22,19,25,44
2017,3,26,23,10,17,27
2017,3,27,0,7,12,19
2017,3,27,1,5,17,22
2017,3,27,2,5,11,16
2017,3,27,3,11,13,24
2017,3,27,4,105,59,164
2017,3,27,5,243,153,396
2017,3,27,6,375,174,549
2017,3,27,7,274,154,428
2017,3,27,8,213,171,384
2017,3,27,9,189,181,370
2017,3,27,10,225,202,427
2017,3,27,11,207,220,427
2017,3,27,12,198,264,462
2017,3,27,13,233,335,568
2017,3,27,14,221,309,530
2017,3,27,15,193,205,398
2017,3,27,16,158,170,328
2017,3,27,17,107,147,254
2017,3,27,18,110,129,239
2017,3,27,19,100,96,196
2017,3,27,20,58,112,170
2017,3,27,21,22,36,58
2017,3,27,22,15,30,45
2017,3,27,23,9,15,24
2017,3,28,0,5,17,22
2017,3,28,1,5,15,20
2017,3,28,2,7,9,16
2017,3,28,3,19,9,28
2017,3,28,4,85,52,137
2017,3,28,5,223,148,371
2017,3,28,6,399,198,597
2017,3,28,7,277,179,456
2017,3,28,8,207,175,382
2017,3,28,9,219,181,400
2017,3,28,10,195,204,399
2017,3,28,11,227,211,438
2017,3,28,12,202,257,459
2017,3,28,13,251,309,560
2017,3,28,14,232,327,559
2017,3,28,15,175,219,394
2017,3,28,16,197,194,391
2017,3,28,17,159,161,320
2017,3,28,18,126,135,261
2017,3,28,19,74,132,206
2017,3,28,20,78,106,184
2017,3,28,21,26,51,77
2017,3,28,22,17,23,40
2017,3,28,23,14,25,39
2017,3,29,0,9,29,38
2017,3,29,1,10,40,50
2017,3,29,2,5,30,35
2017,3,29,3,10,16,26
2017,3,29,4,91,54,145
2017,3,29,5,242,160,402
2017,3,29,6,414,218,632
2017,3,29,7,301,175,476
2017,3,29,8,216,196,412
2017,3,29,9,213,189,402
2017,3,29,10,211,213,424
2017,3,29,11,200,211,411
2017,3,29,12,204,278,482
2017,3,29,13,226,325,551
2017,3,29,14,240,308,548
2017,3,29,15,204,228,432
2017,3,29,16,209,192,401
2017,3,29,17,142,171,313
2017,3,29,18,121,123,244
2017,3,29,19,135,131,266
2017,3,29,20,60,457,517
2017,3,29,21,44,262,306
2017,3,29,22,14,96,110
2017,3,29,23,13,47,60
2017,3,30,0,15,50,65
2017,3,30,1,6,45,51
2017,3,30,2,6,42,48
2017,3,30,3,19,17,36
2017,3,30,4,115,61,176
2017,3,30,5,218,160,378
2017,3,30,6,406,212,618
2017,3,30,7,255,160,415
2017,3,30,8,227,165,392
2017,3,30,9,222,159,381
2017,3,30,10,174,236,410
2017,3,30,11,191,214,405
2017,3,30,12,203,255,458
2017,3,30,13,277,312,589
2017,3,30,14,246,322,568
2017,3,30,15,199,193,392
2017,3,30,16,171,198,369
2017,3,30,17,159,183,342
2017,3,30,18,100,145,245
2017,3,30,19,103,135,238
2017,3,30,20,65,486,551
2017,3,30,21,34,272,306
2017,3,30,22,27,114,141
2017,3,30,23,21,76,97
2017,3,31,0,14,57,71
2017,3,31,1,8,49,57
2017,3,31,2,11,43,54
2017,3,31,3,15,36,51
2017,3,31,4,100,60,160
2017,3,31,5,227,150,377
2017,3,31,6,355,192,547
2017,3,31,7,258,166,424
2017,3,31,8,223,187,410
2017,3,31,9,247,213,460
2017,3,31,10,240,249,489
2017,3,31,11,269,221,490
2017,3,31,12,252,289,541
2017,3,31,13,295,355,650
2017,3,31,14,219,320,539
2017,3,31,15,149,183,332
2017,3,31,16,147,158,305
2017,3,31,17,125,154,279
2017,3,31,18,93,109,202
2017,3,31,19,73,106,179
2017,3,31,20,63,86,149
2017,3,31,21,53,75,128
2017,3,31,22,36,53,89
2017,3,31,23,27,34,61
2017,4,1,0,25,37,62
2017,4,1,1,22,48,70
2017,4,1,2,15,24,39
2017,4,1,3,8,18,26
2017,4,1,4,23,24,47
2017,4,1,5,40,21,61
2017,4,1,6,72,47,119
2017,4,1,7,95,59,154
2017,4,1,8,141,105,246
2017,4,1,9,164,145,309
2017,4,1,10,215,161,376
2017,4,1,11,198,184,382
2017,4,1,12,168,192,360
2017,4,1,13,166,235,401
2017,4,1,14,176,197,373
2017,4,1,15,154,218,372
2017,4,1,16,152,171,323
2017,4,1,17,125,124,249
2017,4,1,18,84,106,190
2017,4,1,19,74,76,150
2017,4,1,20,59,75,134
2017,4,1,21,39,70,109
2017,4,1,22,48,93,141
2017,4,1,23,43,70,113
2017,4,2,0,27,62,89
2017,4,2,1,24,63,87
2017,4,2,2,15,50,65
2017,4,2,3,11,24,35
2017,4,2,4,15,14,29
2017,4,2,5,16,16,32
2017,4,2,6,38,11,49
2017,4,2,7,57,48,105
2017,4,2,8,92,61,153
2017,4,2,9,113,74,187
2017,4,2,10,191,175,366
2017,4,2,11,155,155,310
2017,4,2,12,195,181,376
2017,4,2,13,171,236,407
2017,4,2,14,161,248,409
2017,4,2,15,158,149,307
2017,4,2,16,141,158,299
2017,4,2,17,136,162,298
2017,4,2,18,121,178,299
2017,4,2,19,94,108,202
2017,4,2,20,53,229,282
2017,4,2,21,35,148,183
2017,4,2,22,18,58,76
2017,4,2,23,11,33,44
2017,4,3,0,5,29,34
2017,4,3,1,6,22,28
2017,4,3,2,3,27,30
2017,4,3,3,11,43,54
2017,4,3,4,102,68,170
2017,4,3,5,244,167,411
2017,4,3,6,398,197,595
2017,4,3,7,261,164,425
2017,4,3,8,196,168,364
2017,4,3,9,219,179,398
2017,4,3,10,217,207,424
2017,4,3,11,200,217,417
2017,4,3,12,208,258,466
2017,4,3,13,239,310,549
2017,4,3,14,218,326,544
2017,4,3,15,223,215,438
2017,4,3,16,151,151,302
2017,4,3,17,156,165,321
2017,4,3,18,112,145,257
2017,4,3,19,94,113,207
2017,4,3,20,64,78,142
2017,4,3,21,22,34,56
2017,4,3,22,18,32,50
2017,4,3,23,10,13,23
2017,4,4,0,8,8,16
2017,4,4,1,1,6,7
2017,4,4,2,2,8,10
2017,4,4,3,11,10,21
2017,4,4,4,103,55,158
2017,4,4,5,245,152,397
2017,4,4,6,425,219,644
2017,4,4,7,275,170,445
2017,4,4,8,190,165,355
2017,4,4,9,208,181,389
2017,4,4,10,188,189,377
2017,4,4,11,199,226,425
2017,4,4,12,219,248,467
2017,4,4,13,241,325,566
2017,4,4,14,239,298,537
2017,4,4,15,196,218,414
2017,4,4,16,184,198,382
2017,4,4,17,126,166,292
2017,4,4,18,137,152,289
2017,4,4,19,90,120,210
2017,4,4,20,49,104,153
2017,4,4,21,32,50,82
2017,4,4,22,14,28,42
2017,4,4,23,17,16,33
2017,4,5,0,8,17,25
2017,4,5,1,7,19,26
2017,4,5,2,6,12,18
2017,4,5,3,7,16,23
2017,4,5,4,104,48,152
2017,4,5,5,246,178,424
2017,4,5,6,424,219,643
2017,4,5,7,264,163,427
2017,4,5,8,253,214,467
2017,4,5,9,232,160,392
2017,4,5,10,195,192,387
2017,4,5,11,206,212,418
2017,4,5,12,221,256,477
2017,4,5,13,241,307,548
2017,4,5,14,225,298,523
2017,4,5,15,221,200,421
2017,4,5,16,186,180,366
2017,4,5,17,123,171,294
2017,4,5,18,124,139,263
2017,4,5,19,104,111,215
2017,4,5,20,63,114,177
2017,4,5,21,45,70,115
2017,4,5,22,19,32,51
2017,4,5,23,15,21,36
2017,4,6,0,8,24,32
2017,4,6,1,5,17,22
2017,4,6,2,7,23,30
2017,4,6,3,13,16,29
2017,4,6,4,109,48,157
2017,4,6,5,247,171,418
2017,4,6,6,416,199,615
2017,4,6,7,266,185,451
2017,4,6,8,223,161,384
2017,4,6,9,201,193,394
2017,4,6,10,206,191,397
2017,4,6,11,233,229,462
2017,4,6,12,210,328,538
2017,4,6,13,277,342,619
2017,4,6,14,261,342,603
2017,4,6,15,226,268,494
2017,4,6,16,187,202,389
2017,4,6,17,161,154,315
2017,4,6,18,121,128,249
2017,4,6,19,118,142,260
2017,4,6,20,68,104,172
2017,4,6,21,32,41,73
2017,4,6,22,26,33,59
2017,4,6,23,21,36,57
2017,4,7,0,9,31,40
2017,4,7,1,13,32,45
2017,4,7,2,8,23,31
2017,4,7,3,14,19,33
2017,4,7,4,112,55,167
2017,4,7,5,242,151,393
2017,4,7,6,358,183,541
2017,4,7,7,231,167,398
2017,4,7,8,213,176,389
2017,4,7,9,234,204,438
2017,4,7,10,247,235,482
2017,4,7,11,254,237,491
2017,4,7,12,248,293,541
2017,4,7,13,261,343,604
2017,4,7,14,202,266,468
2017,4,7,15,163,185,348
2017,4,7,16,146,156,302
2017,4,7,17,119,142,261
2017,4,7,18,86,108,194
2017,4,7,19,92,92,184
2017,4,7,20,62,59,121
2017,4,7,21,40,53,93
2017,4,7,22,36,44,80
2017,4,7,23,23,30,53
2017,4,8,0,24,41,65
2017,4,8,1,20,45,65
2017,4,8,2,10,26,36
2017,4,8,3,12,16,28
2017,4,8,4,19,10,29
2017,4,8,5,28,19,47
2017,4,8,6,21,32,53
2017,4,8,7,61,63,124
2017,4,8,8,97,75,172
2017,4,8,9,122,98,220
2017,4,8,10,152,139,291
2017,4,8,11,132,136,268
2017,4,8,12,134,135,269
2017,4,8,13,131,169,300
2017,4,8,14,110,153,263
2017,4,8,15,122,132,254
2017,4,8,16,105,143,248
2017,4,8,17,85,119,204
2017,4,8,18,68,94,162
2017,4,8,19,64,81,145
2017,4,8,20,44,57,101
2017,4,8,21,37,63,100
2017,4,8,22,30,62,92
2017,4,8,23,18,38,56
2017,4,9,0,15,35,50
2017,4,9,1,27,43,70
2017,4,9,2,11,42,53
2017,4,9,3,21,17,38
2017,4,9,4,23,19,42
2017,4,9,5,16,24,40
2017,4,9,6,24,19,43
2017,4,9,7,47,26,73
2017,4,9,8,77,62,139
2017,4,9,9,89,75,164
2017,4,9,10,126,115,241
2017,4,9,11,123,149,272
2017,4,9,12,144,165,309
2017,4,9,13,120,165,285
2017,4,9,14,101,179,280
2017,4,9,15,107,135,242
2017,4,9,16,97,124,221
2017,4,9,17,118,123,241
2017,4,9,18,91,134,225
2017,4,9,19,57,83,140
2017,4,9,20,38,53,91
2017,4,9,21,29,42,71
2017,4,9,22,27,25,52
2017,4,9,23,8,27,35
2017,4,10,0,8,12,20
2017,4,10,1,4,8,12
2017,4,10,2,9,11,20
2017,4,10,3,12,13,25
2017,4,10,4,67,38,105
2017,4,10,5,137,96,233
2017,4,10,6,197,117,314
2017,4,10,7,195,118,313
2017,4,10,8,169,144,313
2017,4,10,9,173,139,312
2017,4,10,10,190,170,360
2017,4,10,11,162,185,347
2017,4,10,12,178,218,396
2017,4,10,13,156,230,386
2017,4,10,14,167,185,352
2017,4,10,15,156,167,323
2017,4,10,16,128,140,268
2017,4,10,17,86,107,193
2017,4,10,18,73,87,160
2017,4,10,19,70,83,153
2017,4,10,20,55,42,97
2017,4,10,21,35,42,77
2017,4,10,22,20,24,44
2017,4,10,23,10,14,24
2017,4,11,0,10,13,23
2017,4,11,1,5,13,18
2017,4,11,2,5,8,13
2017,4,11,3,13,8,21
2017,4,11,4,65,37,102
2017,4,11,5,136,110,246
2017,4,11,6,192,102,294
2017,4,11,7,154,110,264
2017,4,11,8,143,137,280
2017,4,11,9,178,150,328
2017,4,11,10,180,182,362
2017,4,11,11,165,202,367
2017,4,11,12,196,231,427
2017,4,11,13,188,206,394
2017,4,11,14,166,180,346
2017,4,11,15,117,151,268
2017,4,11,16,106,118,224
2017,4,11,17,103,111,214
2017,4,11,18,98,101,199
2017,4,11,19,76,94,170
2017,4,11,20,58,65,123
2017,4,11,21,28,45,73
2017,4,11,22,22,28,50
2017,4,11,23,11,24,35
2017,4,12,0,15,29,44
2017,4,12,1,5,22,27
2017,4,12,2,6,15,21
2017,4,12,3,11,12,23
2017,4,12,4,47,24,71
2017,4,12,5,117,77,194
2017,4,12,6,132,83,215
2017,4,12,7,127,91,218
2017,4,12,8,129,110,239
2017,4,12,9,188,179,367
2017,4,12,10,205,198,403
2017,4,12,11,145,196,341
2017,4,12,12,158,157,315
2017,4,12,13,109,147,256
2017,4,12,14,132,132,264
2017,4,12,15,124,136,260
2017,4,12,16,101,99,200
2017,4,12,17,69,108,177
2017,4,12,18,82,101,183
2017,4,12,19,67,59,126
2017,4,12,20,38,50,88
2017,4,12,21,27,44,71
2017,4,12,22,14,34,48
2017,4,12,23,15,29,44
2017,4,13,0,13,31,44
2017,4,13,1,8,25,33
2017,4,13,2,9,13,22
2017,4,13,3,9,11,20
2017,4,13,4,20,11,31
2017,4,13,5,17,18,35
2017,4,13,6,28,17,45
2017,4,13,7,27,20,47
2017,4,13,8,54,40,94
2017,4,13,9,90,69,159
2017,4,13,10,82,96,178
2017,4,13,11,99,127,226
2017,4,13,12,90,127,217
2017,4,13,13,104,129,233
2017,4,13,14,81,118,199
2017,4,13,15,83,136,219
2017,4,13,16,96,96,192
2017,4,13,17,66,104,170
2017,4,13,18,70,89,159
2017,4,13,19,50,73,123
2017,4,13,20,31,41,72
2017,4,13,21,25,48,73
2017,4,13,22,22,37,59
2017,4,13,23,14,36,50
2017,4,14,0,14,20,34
2017,4,14,1,9,37,46
2017,4,14,2,5,16,21
2017,4,14,3,7,4,11
2017,4,14,4,15,11,26
2017,4,14,5,23,17,40
2017,4,14,6,23,20,43
2017,4,14,7,39,29,68
2017,4,14,8,61,38,99
2017,4,14,9,85,64,149
2017,4,14,10,82,74,156
2017,4,14,11,95,128,223
2017,4,14,12,107,124,231
2017,4,14,13,115,143,258
2017,4,14,14,89,129,218
2017,4,14,15,100,120,220
2017,4,14,16,84,114,198
2017,4,14,17,64,106,170
2017,4,14,18,65,98,163
2017,4,14,19,57,87,144
2017,4,14,20,43,72,115
2017,4,14,21,28,51,79
2017,4,14,22,16,36,52
2017,4,14,23,12,34,46
2017,4,15,0,17,25,42
2017,4,15,1,7,24,31
2017,4,15,2,5,17,22
2017,4,15,3,8,10,18
2017,4,15,4,12,9,21
2017,4,15,5,23,16,39
2017,4,15,6,24,21,45
2017,4,15,7,52,32,84
2017,4,15,8,96,80,176
2017,4,15,9,103,138,241
2017,4,15,10,97,157,254
2017,4,15,11,80,111,191
2017,4,15,12,107,103,210
2017,4,15,13,98,137,235
2017,4,15,14,93,114,207
2017,4,15,15,84,91,175
2017,4,15,16,89,92,181
2017,4,15,17,63,66,129
2017,4,15,18,81,95,176
2017,4,15,19,65,68,133
2017,4,15,20,34,44,78
2017,4,15,21,45,46,91
2017,4,15,22,36,62,98
2017,4,15,23,14,33,47
2017,4,16,0,21,39,60
2017,4,16,1,17,40,57
2017,4,16,2,22,48,70
2017,4,16,3,11,20,31
2017,4,16,4,14,10,24
2017,4,16,5,12,16,28
2017,4,16,6,14,13,27
2017,4,16,7,40,17,57
2017,4,16,8,61,82,143
2017,4,16,9,43,55,98
2017,4,16,10,95,89,184
2017,4,16,11,86,109,195
2017,4,16,12,111,133,244
2017,4,16,13,103,154,257
2017,4,16,14,105,155,260
2017,4,16,15,104,124,228
2017,4,16,16,100,117,217
2017,4,16,17,122,135,257
2017,4,16,18,106,123,229
2017,4,16,19,84,97,181
2017,4,16,20,53,67,120
2017,4,16,21,39,46,85
2017,4,16,22,23,25,48
2017,4,16,23,11,24,35
2017,4,17,0,12,18,30
2017,4,17,1,11,21,32
2017,4,17,2,6,7,13
2017,4,17,3,10,12,22
2017,4,17,4,11,9,20
2017,4,17,5,15,13,28
2017,4,17,6,24,18,42
2017,4,17,7,42,39,81
2017,4,17,8,64,55,119
2017,4,17,9,86,79,165
2017,4,17,10,116,130,246
2017,4,17,11,130,151,281
2017,4,17,12,143,158,301
2017,4,17,13,138,171,309
2017,4,17,14,137,114,251
2017,4,17,15,129,167,296
2017,4,17,16,145,132,277
2017,4,17,17,121,149,270
2017,4,17,18,163,142,305
2017,4,17,19,93,124,217
2017,4,17,20,44,56,100
2017,4,17,21,37,36,73
2017,4,17,22,19,33,52
2017,4,17,23,10,19,29
2017,4,18,0,6,10,16
2017,4,18,1,8,9,17
2017,4,18,2,2,5,7
2017,4,18,3,17,16,33
2017,4,18,4,103,59,162
2017,4,18,5,253,157,410
2017,4,18,6,359,197,556
2017,4,18,7,238,174,412
2017,4,18,8,209,183,392
2017,4,18,9,206,184,390
2017,4,18,10,197,233,430
2017,4,18,11,220,208,428
2017,4,18,12,220,242,462
2017,4,18,13,281,333,614
2017,4,18,14,268,419,687
2017,4,18,15,176,184,360
2017,4,18,16,153,150,303
2017,4,18,17,152,168,320
2017,4,18,18,123,171,294
2017,4,18,19,108,148,256
2017,4,18,20,62,98,160
2017,4,18,21,41,49,90
2017,4,18,22,12,29,41
2017,4,18,23,10,19,29
2017,4,19,0,7,9,16
2017,4,19,1,8,14,22
2017,4,19,2,3,12,15
2017,4,19,3,13,18,31
2017,4,19,4,107,50,157
2017,4,19,5,241,160,401
2017,4,19,6,385,219,604
2017,4,19,7,245,170,415
2017,4,19,8,209,185,394
2017,4,19,9,196,184,380
2017,4,19,10,180,216,396
2017,4,19,11,224,208,432
2017,4,19,12,214,228,442
2017,4,19,13,252,321,573
2017,4,19,14,254,289,543
2017,4,19,15,208,226,434
2017,4,19,16,177,158,335
2017,4,19,17,144,207,351
2017,4,19,18,108,156,264
2017,4,19,19,81,115,196
2017,4,19,20,42,95,137
2017,4,19,21,34,46,80
2017,4,19,22,16,31,47
2017,4,19,23,11,31,42
2017,4,20,0,5,13,18
2017,4,20,1,6,22,28
2017,4,20,2,5,17,22
2017,4,20,3,15,14,29
2017,4,20,4,108,58,166
2017,4,20,5,241,179,420
2017,4,20,6,401,201,602
2017,4,20,7,264,155,419
2017,4,20,8,232,179,411
2017,4,20,9,201,188,389
2017,4,20,10,223,183,406
2017,4,20,11,221,229,450
2017,4,20,12,206,272,478
2017,4,20,13,247,347,594
2017,4,20,14,260,463,723
2017,4,20,15,212,257,469
2017,4,20,16,181,182,363
2017,4,20,17,160,180,340
2017,4,20,18,116,155,271
2017,4,20,19,99,133,232
2017,4,20,20,62,121,183
2017,4,20,21,35,59,94
2017,4,20,22,15,31,46
2017,4,20,23,10,26,36
2017,4,21,0,11,21,32
2017,4,21,1,7,25,32
2017,4,21,2,3,14,17
2017,4,21,3,9,17,26
2017,4,21,4,97,51,148
2017,4,21,5,241,146,387
2017,4,21,6,370,181,551
2017,4,21,7,245,172,417
2017,4,21,8,200,182,382
2017,4,21,9,235,206,441
2017,4,21,10,224,219,443
2017,4,21,11,200,262,462
2017,4,21,12,241,274,515
2017,4,21,13,262,329,591
2017,4,21,14,228,289,517
2017,4,21,15,162,201,363
2017,4,21,16,153,148,301
2017,4,21,17,133,154,287
2017,4,21,18,88,117,205
2017,4,21,19,96,95,191
2017,4,21,20,47,77,124
2017,4,21,21,38,63,101
2017,4,21,22,28,54,82
2017,4,21,23,17,33,50
2017,4,22,0,17,36,53
2017,4,22,1,14,32,46
2017,4,22,2,8,28,36
2017,4,22,3,9,16,25
2017,4,22,4,19,14,33
2017,4,22,5,51,31,82
2017,4,22,6,43,38,81
2017,4,22,7,69,59,128
2017,4,22,8,140,83,223
2017,4,22,9,158,138,296
2017,4,22,10,181,128,309
2017,4,22,11,152,153,305
2017,4,22,12,157,174,331
2017,4,22,13,192,221,413
2017,4,22,14,176,187,363
2017,4,22,15,148,244,392
2017,4,22,16,138,167,305
2017,4,22,17,113,131,244
2017,4,22,18,95,116,211
2017,4,22,19,59,88,147
2017,4,22,20,62,70,132
2017,4,22,21,43,80,123
2017,4,22,22,43,71,114
2017,4,22,23,43,53,96
2017,4,23,0,33,53,86
2017,4,23,1,22,55,77
2017,4,23,2,16,55,71
2017,4,23,3,16,23,39
2017,4,23,4,14,15,29
2017,4,23,5,16,16,32
2017,4,23,6,26,17,43
2017,4,23,7,58,41,99
2017,4,23,8,121,54,175
2017,4,23,9,101,94,195
2017,4,23,10,161,126,287
2017,4,23,11,126,170,296
2017,4,23,12,188,160,348
2017,4,23,13,154,219,373
2017,4,23,14,174,206,380
2017,4,23,15,149,176,325
2017,4,23,16,130,172,302
2017,4,23,17,145,157,302
2017,4,23,18,124,151,275
2017,4,23,19,62,85,147
2017,4,23,20,66,81,147
2017,4,23,21,38,50,88
2017,4,23,22,21,28,49
2017,4,23,23,12,21,33
2017,4,24,0,6,13,19
2017,4,24,1,6,10,16
2017,4,24,2,6,11,17
2017,4,24,3,17,8,25
2017,4,24,4,103,56,159
2017,4,24,5,230,151,381
2017,4,24,6,414,191,605
2017,4,24,7,232,164,396
2017,4,24,8,207,156,363
2017,4,24,9,217,180,397
2017,4,24,10,211,211,422
2017,4,24,11,181,192,373
2017,4,24,12,224,302,526
2017,4,24,13,274,330,604
2017,4,24,14,240,282,522
2017,4,24,15,195,209,404
2017,4,24,16,201,169,370
2017,4,24,17,131,165,296
2017,4,24,18,118,142,260
2017,4,24,19,76,133,209
2017,4,24,20,58,99,157
2017,4,24,21,26,56,82
2017,4,24,22,19,26,45
2017,4,24,23,15,12,27
2017,4,25,0,5,11,16
2017,4,25,1,3,10,13
2017,4,25,2,1,12,13
2017,4,25,3,21,9,30
2017,4,25,4,96,50,146
2017,4,25,5,248,158,406
2017,4,25,6,400,217,617
2017,4,25,7,241,166,407
2017,4,25,8,202,168,370
2017,4,25,9,195,178,373
2017,4,25,10,205,181,386
2017,4,25,11,192,224,416
2017,4,25,12,225,278,503
2017,4,25,13,244,312,556
2017,4,25,14,243,297,540
2017,4,25,15,202,219,421
2017,4,25,16,225,194,419
2017,4,25,17,156,175,331
2017,4,25,18,128,148,276
2017,4,25,19,110,164,274
2017,4,25,20,76,105,181
2017,4,25,21,36,82,118
2017,4,25,22,12,34,46
2017,4,25,23,15,33,48
2017,4,26,0,9,30,39
2017,4,26,1,5,16,21
2017,4,26,2,4,15,19
2017,4,26,3,20,13,33
2017,4,26,4,149,78,227
2017,4,26,5,230,150,380
2017,4,26,6,316,170,486
2017,4,26,7,250,145,395
2017,4,26,8,187,146,333
2017,4,26,9,213,170,383
2017,4,26,10,226,204,430
2017,4,26,11,229,235,464
2017,4,26,12,212,300,512
2017,4,26,13,272,287,559
2017,4,26,14,239,270,509
2017,4,26,15,212,238,450
2017,4,26,16,193,186,379
2017,4,26,17,148,188,336
2017,4,26,18,127,147,274
2017,4,26,19,99,128,227
2017,4,26,20,70,420,490
2017,4,26,21,32,274,306
2017,4,26,22,19,93,112
2017,4,26,23,15,60,75
2017,4,27,0,5,39,44
2017,4,27,1,6,14,20
2017,4,27,2,7,13,20
2017,4,27,3,15,14,29
2017,4,27,4,104,67,171
2017,4,27,5,257,157,414
2017,4,27,6,379,204,583
2017,4,27,7,273,188,461
2017,4,27,8,240,190,430
2017,4,27,9,193,179,372
2017,4,27,10,237,198,435
2017,4,27,11,235,250,485
2017,4,27,12,230,259,489
2017,4,27,13,271,339,610
2017,4,27,14,241,302,543
2017,4,27,15,239,242,481
2017,4,27,16,207,214,421
2017,4,27,17,170,197,367
2017,4,27,18,142,151,293
2017,4,27,19,112,139,251
2017,4,27,20,59,119,178
2017,4,27,21,81,79,160
2017,4,27,22,35,40,75
2017,4,27,23,9,32,41
2017,4,28,0,5,30,35
2017,4,28,1,6,27,33
2017,4,28,2,9,13,22
2017,4,28,3,14,14,28
2017,4,28,4,102,57,159
2017,4,28,5,253,159,412
2017,4,28,6,360,189,549
2017,4,28,7,270,191,461
2017,4,28,8,258,201,459
2017,4,28,9,231,203,434
2017,4,28,10,266,249,515
2017,4,28,11,267,281,548
2017,4,28,12,267,327,594
2017,4,28,13,299,358,657
2017,4,28,14,229,276,505
2017,4,28,15,188,221,409
2017,4,28,16,172,216,388
2017,4,28,17,140,175,315
2017,4,28,18,117,136,253
2017,4,28,19,98,116,214
2017,4,28,20,77,93,170
2017,4,28,21,54,64,118
2017,4,28,22,46,56,102
2017,4,28,23,21,45,66
2017,4,29,0,20,35,55
2017,4,29,1,8,38,46
2017,4,29,2,17,29,46
2017,4,29,3,12,16,28
2017,4,29,4,27,20,47
2017,4,29,5,30,25,55
2017,4,29,6,70,45,115
2017,4,29,7,131,44,175
2017,4,29,8,172,97,269
2017,4,29,9,179,105,284
2017,4,29,10,177,136,313
2017,4,29,11,147,156,303
2017,4,29,12,172,197,369
2017,4,29,13,142,178,320
2017,4,29,14,133,177,310
2017,4,29,15,131,190,321
2017,4,29,16,122,129,251
2017,4,29,17,110,112,222
2017,4,29,18,122,116,238
2017,4,29,19,84,110,194
2017,4,29,20,55,88,143
2017,4,29,21,35,85,120
2017,4,29,22,45,74,119
2017,4,29,23,27,52,79
2017,4,30,0,22,51,73
2017,4,30,1,22,64,86
2017,4,30,2,24,42,66
2017,4,30,3,21,30,51
2017,4,30,4,14,19,33
2017,4,30,5,20,22,42
2017,4,30,6,39,20,59
2017,4,30,7,50,42,92
2017,4,30,8,99,78,177
2017,4,30,9,144,117,261
2017,4,30,10,144,154,298
2017,4,30,11,200,193,393
2017,4,30,12,171,214,385
2017,4,30,13,143,209,352
2017,4,30,14,137,178,315
2017,4,30,15,143,175,318
2017,4,30,16,153,165,318
2017,4,30,17,164,177,341
2017,4,30,18,136,199,335
2017,4,30,19,87,149,236
2017,4,30,20,60,114,174
2017,4,30,21,41,53,94
2017,4,30,22,32,50,82
2017,4,30,23,23,45,68
2017,5,1,0,21,47,68
2017,5,1,1,17,48,65
2017,5,1,2,6,25,31
2017,5,1,3,10,8,18
2017,5,1,4,22,15,37
2017,5,1,5,21,18,39
2017,5,1,6,25,26,51
2017,5,1,7,55,49,104
2017,5,1,8,93,65,158
2017,5,1,9,100,105,205
2017,5,1,10,122,146,268
2017,5,1,11,148,139,287
2017,5,1,12,155,152,307
2017,5,1,13,171,217,388
2017,5,1,14,156,189,345
2017,5,1,15,145,193,338
2017,5,1,16,175,194,369
2017,5,1,17,168,182,350
2017,5,1,18,135,157,292
2017,5,1,19,95,125,220
2017,5,1,20,57,90,147
2017,5,1,21,47,47,94
2017,5,1,22,28,28,56
2017,5,1,23,8,25,33
2017,5,2,0,6,13,19
2017,5,2,1,6,16,22
2017,5,2,2,4,9,13
2017,5,2,3,21,17,38
2017,5,2,4,103,55,158
2017,5,2,5,250,168,418
2017,5,2,6,367,193,560
2017,5,2,7,275,168,443
2017,5,2,8,226,200,426
2017,5,2,9,216,220,436
2017,5,2,10,218,228,446
2017,5,2,11,249,232,481
2017,5,2,12,214,279,493
2017,5,2,13,262,342,604
2017,5,2,14,250,272,522
2017,5,2,15,177,213,390
2017,5,2,16,200,166,366
2017,5,2,17,126,143,269
2017,5,2,18,129,171,300
2017,5,2,19,101,124,225
2017,5,2,20,77,115,192
2017,5,2,21,33,74,107
2017,5,2,22,23,25,48
2017,5,2,23,14,29,43
2017,5,3,0,4,22,26
2017,5,3,1,10,21,31
2017,5,3,2,3,11,14
2017,5,3,3,13,20,33
2017,5,3,4,101,64,165
2017,5,3,5,230,152,382
2017,5,3,6,386,195,581
2017,5,3,7,256,178,434
2017,5,3,8,214,169,383
2017,5,3,9,215,202,417
2017,5,3,10,229,213,442
2017,5,3,11,238,225,463
2017,5,3,12,243,285,528
2017,5,3,13,249,349,598
2017,5,3,14,243,294,537
2017,5,3,15,187,219,406
2017,5,3,16,180,180,360
2017,5,3,17,145,150,295
2017,5,3,18,108,156,264
2017,5,3,19,106,133,239
2017,5,3,20,53,392,445
2017,5,3,21,39,327,366
2017,5,3,22,15,105,120
2017,5,3,23,11,52,63
2017,5,4,0,7,45,52
2017,5,4,1,9,23,32
2017,5,4,2,10,12,22
2017,5,4,3,6,13,19
2017,5,4,4,93,51,144
2017,5,4,5,244,177,421
2017,5,4,6,374,199,573
2017,5,4,7,229,180,409
2017,5,4,8,223,199,422
2017,5,4,9,216,193,409
2017,5,4,10,211,249,460
2017,5,4,11,214,253,467
2017,5,4,12,220,277,497
2017,5,4,13,288,380,668
2017,5,4,14,254,328,582
2017,5,4,15,186,241,427
2017,5,4,16,208,170,378
2017,5,4,17,148,167,315
2017,5,4,18,129,164,293
2017,5,4,19,94,158,252
2017,5,4,20,67,109,176
2017,5,4,21,38,72,110
2017,5,4,22,20,31,51
2017,5,4,23,11,31,42
2017,5,5,0,15,22,37
2017,5,5,1,8,22,30
2017,5,5,2,3,16,19
2017,5,5,3,21,15,36
2017,5,5,4,110,63,173
2017,5,5,5,236,156,392
2017,5,5,6,347,192,539
2017,5,5,7,255,196,451
2017,5,5,8,234,195,429
2017,5,5,9,205,208,413
2017,5,5,10,208,241,449
2017,5,5,11,233,256,489
2017,5,5,12,251,318,569
2017,5,5,13,255,365,620
2017,5,5,14,203,302,505
2017,5,5,15,184,204,388
2017,5,5,16,176,153,329
2017,5,5,17,125,142,267
2017,5,5,18,104,131,235
2017,5,5,19,80,128,208
2017,5,5,20,79,89,168
2017,5,5,21,43,74,117
2017,5,5,22,22,50,72
2017,5,5,23,22,37,59
2017,5,6,0,15,36,51
2017,5,6,1,15,30,45
2017,5,6,2,7,13,20
2017,5,6,3,14,17,31
2017,5,6,4,24,14,38
2017,5,6,5,36,34,70
2017,5,6,6,65,36,101
2017,5,6,7,86,65,151
2017,5,6,8,138,112,250
2017,5,6,9,131,121,252
2017,5,6,10,144,161,305
2017,5,6,11,165,147,312
2017,5,6,12,141,153,294
2017,5,6,13,113,178,291
2017,5,6,14,138,147,285
2017,5,6,15,138,180,318
2017,5,6,16,137,144,281
2017,5,6,17,117,136,253
2017,5,6,18,90,116,206
2017,5,6,19,76,95,171
2017,5,6,20,49,93,142
2017,5,6,21,55,68,123
2017,5,6,22,38,53,91
2017,5,6,23,39,45,84
2017,5,7,0,29,46,75
2017,5,7,1,16,44,60
2017,5,7,2,13,42,55
2017,5,7,3,6,13,19
2017,5,7,4,12,12,24
2017,5,7,5,15,12,27
2017,5,7,6,44,33,77
2017,5,7,7,52,41,93
2017,5,7,8,111,83,194
2017,5,7,9,131,107,238
2017,5,7,10,131,156,287
2017,5,7,11,143,166,309
2017,5,7,12,183,186,369
2017,5,7,13,137,173,310
2017,5,7,14,170,234,404
2017,5,7,15,145,171,316
2017,5,7,16,152,179,331
2017,5,7,17,190,214,404
2017,5,7,18,126,185,311
2017,5,7,19,94,140,234
2017,5,7,20,79,96,175
2017,5,7,21,52,62,114
2017,5,7,22,22,25,47
2017,5,7,23,13,10,23
2017,5,8,0,11,15,26
2017,5,8,1,4,13,17
2017,5,8,2,5,14,19
2017,5,8,3,15,10,25
2017,5,8,4,109,53,162
2017,5,8,5,274,154,428
2017,5,8,6,398,201,599
2017,5,8,7,251,171,422
2017,5,8,8,199,191,390
2017,5,8,9,206,191,397
2017,5,8,10,210,189,399
2017,5,8,11,191,211,402
2017,5,8,12,225,286,511
2017,5,8,13,234,346,580
2017,5,8,14,230,304,534
2017,5,8,15,206,198,404
2017,5,8,16,171,177,348
2017,5,8,17,157,158,315
2017,5,8,18,117,140,257
2017,5,8,19,94,140,234
2017,5,8,20,51,109,160
2017,5,8,21,31,66,97
2017,5,8,22,24,32,56
2017,5,8,23,8,21,29
2017,5,9,0,4,20,24
2017,5,9,1,9,12,21
2017,5,9,2,7,20,27
2017,5,9,3,16,6,22
2017,5,9,4,102,54,156
2017,5,9,5,246,166,412
2017,5,9,6,350,196,546
2017,5,9,7,233,175,408
2017,5,9,8,215,190,405
2017,5,9,9,203,185,388
2017,5,9,10,224,190,414
2017,5,9,11,208,256,464
2017,5,9,12,215,288,503
2017,5,9,13,258,307,565
2017,5,9,14,222,302,524
2017,5,9,15,227,186,413
2017,5,9,16,176,167,343
2017,5,9,17,167,163,330
2017,5,9,18,118,152,270
2017,5,9,19,100,135,235
2017,5,9,20,55,87,142
2017,5,9,21,31,106,137
2017,5,9,22,14,47,61
2017,5,9,23,9,20,29
2017,5,10,0,7,24,31
2017,5,10,1,4,15,19
2017,5,10,2,7,15,22
2017,5,10,3,15,15,30
2017,5,10,4,103,47,150
2017,5,10,5,259,179,438
2017,5,10,6,366,208,574
2017,5,10,7,263,151,414
2017,5,10,8,210,185,395
2017,5,10,9,228,196,424
2017,5,10,10,187,215,402
2017,5,10,11,201,224,425
2017,5,10,12,207,275,482
2017,5,10,13,260,320,580
2017,5,10,14,233,273,506
2017,5,10,15,173,216,389
2017,5,10,16,138,181,319
2017,5,10,17,157,168,325
2017,5,10,18,104,111,215
2017,5,10,19,90,117,207
2017,5,10,20,71,112,183
2017,5,10,21,22,71,93
2017,5,10,22,19,35,54
2017,5,10,23,10,18,28
2017,5,11,0,5,16,21
2017,5,11,1,4,15,19
2017,5,11,2,2,12,14
2017,5,11,3,14,10,24
2017,5,11,4,98,52,150
2017,5,11,5,243,165,408
2017,5,11,6,373,220,593
2017,5,11,7,275,173,448
2017,5,11,8,205,167,372
2017,5,11,9,192,187,379
2017,5,11,10,216,211,427
2017,5,11,11,209,213,422
2017,5,11,12,226,308,534
2017,5,11,13,269,331,600
2017,5,11,14,212,284,496
2017,5,11,15,196,200,396
2017,5,11,16,164,165,329
2017,5,11,17,145,174,319
2017,5,11,18,116,149,265
2017,5,11,19,93,136,229
2017,5,11,20,60,118,178
2017,5,11,21,41,67,108
2017,5,11,22,32,36,68
2017,5,11,23,13,22,35
2017,5,12,0,8,20,28
2017,5,12,1,8,22,30
2017,5,12,2,10,24,34
2017,5,12,3,16,13,29
2017,5,12,4,105,56,161
2017,5,12,5,255,164,419
2017,5,12,6,368,196,564
2017,5,12,7,262,199,461
2017,5,12,8,198,187,385
2017,5,12,9,202,193,395
2017,5,12,10,233,214,447
2017,5,12,11,213,230,443
2017,5,12,12,233,306,539
2017,5,12,13,265,325,590
2017,5,12,14,246,434,680
2017,5,12,15,171,230,401
2017,5,12,16,160,162,322
2017,5,12,17,140,151,291
2017,5,12,18,106,130,236
2017,5,12,19,91,120,211
2017,5,12,20,65,83,148
2017,5,12,21,46,65,111
2017,5,12,22,49,64,113
2017,5,12,23,26,41,67
2017,5,13,0,32,42,74
2017,5,13,1,21,47,68
2017,5,13,2,4,30,34
2017,5,13,3,17,21,38
2017,5,13,4,19,18,37
2017,5,13,5,25,27,52
2017,5,13,6,42,37,79
2017,5,13,7,61,71,132
2017,5,13,8,119,86,205
2017,5,13,9,139,114,253
2017,5,13,10,152,161,313
2017,5,13,11,143,167,310
2017,5,13,12,142,162,304
2017,5,13,13,122,173,295
2017,5,13,14,142,175,317
2017,5,13,15,112,169,281
2017,5,13,16,139,163,302
2017,5,13,17,106,166,272
2017,5,13,18,85,94,179
2017,5,13,19,67,79,146
2017,5,13,20,93,70,163
2017,5,13,21,55,65,120
2017,5,13,22,40,68,108
2017,5,13,23,30,66,96
2017,5,14,0,24,59,83
2017,5,14,1,22,92,114
2017,5,14,2,26,54,80
2017,5,14,3,13,33,46
2017,5,14,4,17,20,37
2017,5,14,5,20,19,39
2017,5,14,6,34,26,60
2017,5,14,7,49,62,111
2017,5,14,8,98,70,168
2017,5,14,9,136,80,216
2017,5,14,10,163,143,306
2017,5,14,11,150,224,374
2017,5,14,12,163,223,386
2017,5,14,13,162,223,385
2017,5,14,14,158,223,381
2017,5,14,15,179,189,368
2017,5,14,16,171,197,368
2017,5,14,17,156,184,340
2017,5,14,18,138,189,327
2017,5,14,19,99,136,235
2017,5,14,20,70,167,237
2017,5,14,21,48,74,122
2017,5,14,22,24,43,67
2017,5,14,23,10,26,36
2017,5,15,0,5,11,16
2017,5,15,1,8,23,31
2017,5,15,2,5,8,13
2017,5,15,3,20,19,39
2017,5,15,4,112,62,174
2017,5,15,5,238,150,388
2017,5,15,6,388,213,601
2017,5,15,7,286,176,462
2017,5,15,8,197,192,389
2017,5,15,9,217,195,412
2017,5,15,10,227,222,449
2017,5,15,11,216,248,464
2017,5,15,12,236,286,522
2017,5,15,13,283,341,624
2017,5,15,14,268,309,577
2017,5,15,15,181,224,405
2017,5,15,16,199,181,380
2017,5,15,17,155,166,321
2017,5,15,18,151,162,313
2017,5,15,19,112,157,269
2017,5,15,20,85,104,189
2017,5,15,21,37,56,93
2017,5,15,22,20,41,61
2017,5,15,23,9,19,28
2017,5,16,0,9,20,29
2017,5,16,1,8,16,24
2017,5,16,2,6,2,8
2017,5,16,3,24,22,46
2017,5,16,4,121,52,173
2017,5,16,5,271,155,426
2017,5,16,6,381,212,593
2017,5,16,7,279,188,467
2017,5,16,8,218,195,413
2017,5,16,9,215,219,434
2017,5,16,10,244,223,467
2017,5,16,11,221,269,490
2017,5,16,12,243,310,553
2017,5,16,13,287,371,658
2017,5,16,14,242,455,697
2017,5,16,15,204,422,626
2017,5,16,16,163,149,312
2017,5,16,17,150,142,292
2017,5,16,18,223,172,395
2017,5,16,19,124,123,247
2017,5,16,20,71,116,187
2017,5,16,21,47,74,121
2017,5,16,22,31,61,92
2017,5,16,23,29,34,63
2017,5,17,0,20,32,52
2017,5,17,1,20,51,71
2017,5,17,2,19,27,46
2017,5,17,3,13,19,32
2017,5,17,4,49,23,72
2017,5,17,5,91,59,150
2017,5,17,6,149,111,260
2017,5,17,7,350,164,514
2017,5,17,8,392,219,611
2017,5,17,9,241,255,496
2017,5,17,10,153,245,398
2017,5,17,11,128,383,511
2017,5,17,12,139,264,403
2017,5,17,13,116,240,356
2017,5,17,14,115,198,313
2017,5,17,15,116,182,298
2017,5,17,16,143,205,348
2017,5,17,17,130,197,327
2017,5,17,18,99,183,282
2017,5,17,19,89,173,262
2017,5,17,20,75,138,213
2017,5,17,21,51,139,190
2017,5,17,22,39,74,113
2017,5,17,23,33,78,111
2017,5,18,0,16,50,66
2017,5,18,1,24,45,69
2017,5,18,2,9,38,47
2017,5,18,3,16,24,40
2017,5,18,4,117,52,169
2017,5,18,5,242,154,396
2017,5,18,6,338,196,534
2017,5,18,7,254,151,405
2017,5,18,8,237,174,411
2017,5,18,9,208,187,395
2017,5,18,10,216,218,434
2017,5,18,11,214,220,434
2017,5,18,12,242,281,523
2017,5,18,13,269,321,590
2017,5,18,14,232,297,529
2017,5,18,15,175,202,377
2017,5,18,16,141,173,314
2017,5,18,17,161,161,322
2017,5,18,18,115,155,270
2017,5,18,19,102,132,234
2017,5,18,20,51,86,137
2017,5,18,21,30,39,69
2017,5,18,22,14,24,38
2017,5,18,23,8,18,26
2017,5,19,0,13,23,36
2017,5,19,1,11,19,30
2017,5,19,2,9,9,18
2017,5,19,3,12,16,28
2017,5,19,4,107,59,166
2017,5,19,5,258,139,397
2017,5,19,6,379,218,597
2017,5,19,7,238,179,417
2017,5,19,8,225,182,407
2017,5,19,9,212,188,400
2017,5,19,10,220,227,447
2017,5,19,11,252,251,503
2017,5,19,12,237,295,532
2017,5,19,13,291,329,620
2017,5,19,14,214,287,501
2017,5,19,15,145,219,364
2017,5,19,16,125,159,284
2017,5,19,17,112,146,258
2017,5,19,18,99,115,214
2017,5,19,19,97,114,211
2017,5,19,20,64,110,174
2017,5,19,21,54,83,137
2017,5,19,22,39,46,85
2017,5,19,23,18,31,49
2017,5,20,0,18,33,51
2017,5,20,1,13,39,52
2017,5,20,2,8,23,31
2017,5,20,3,11,11,22
2017,5,20,4,26,8,34
2017,5,20,5,27,27,54
2017,5,20,6,53,39,92
2017,5,20,7,81,65,146
2017,5,20,8,131,108,239
2017,5,20,9,122,95,217
2017,5,20,10,137,128,265
2017,5,20,11,168,215,383
2017,5,20,12,158,178,336
2017,5,20,13,144,185,329
2017,5,20,14,119,166,285
2017,5,20,15,126,164,290
2017,5,20,16,134,163,297
2017,5,20,17,107,129,236
2017,5,20,18,70,77,147
2017,5,20,19,57,92,149
2017,5,20,20,71,77,148
2017,5,20,21,46,68,114
2017,5,20,22,33,58,91
2017,5,20,23,28,44,72
2017,5,21,0,22,37,59
2017,5,21,1,21,56,77
2017,5,21,2,9,33,42
2017,5,21,3,14,15,29
2017,5,21,4,21,11,32
2017,5,21,5,18,13,31
2017,5,21,6,38,25,63
2017,5,21,7,64,47,111
2017,5,21,8,131,72,203
2017,5,21,9,121,96,217
2017,5,21,10,138,156,294
2017,5,21,11,166,187,353
2017,5,21,12,185,179,364
2017,5,21,13,158,185,343
2017,5,21,14,117,235,352
2017,5,21,15,138,175,313
2017,5,21,16,148,181,329
2017,5,21,17,143,171,314
2017,5,21,18,109,161,270
2017,5,21,19,83,101,184
2017,5,21,20,65,100,165
2017,5,21,21,31,58,89
2017,5,21,22,18,32,50
2017,5,21,23,6,23,29
2017,5,22,0,7,15,22
2017,5,22,1,5,23,28
2017,5,22,2,6,14,20
2017,5,22,3,8,12,20
2017,5,22,4,122,66,188
2017,5,22,5,266,163,429
2017,5,22,6,385,231,616
2017,5,22,7,265,190,455
2017,5,22,8,208,180,388
2017,5,22,9,231,207,438
2017,5,22,10,229,223,452
2017,5,22,11,207,240,447
2017,5,22,12,213,273,486
2017,5,22,13,269,340,609
2017,5,22,14,224,279,503
2017,5,22,15,180,215,395
2017,5,22,16,183,171,354
2017,5,22,17,143,175,318
2017,5,22,18,122,154,276
2017,5,22,19,112,142,254
2017,5,22,20,63,86,149
2017,5,22,21,34,58,92
2017,5,22,22,13,31,44
2017,5,22,23,7,15,22
2017,5,23,0,2,10,12
2017,5,23,1,7,15,22
2017,5,23,2,6,15,21
2017,5,23,3,17,18,35
2017,5,23,4,123,51,174
2017,5,23,5,227,183,410
2017,5,23,6,396,192,588
2017,5,23,7,279,195,474
2017,5,23,8,225,170,395
2017,5,23,9,233,213,446
2017,5,23,10,214,211,425
2017,5,23,11,224,220,444
2017,5,23,12,252,288,540
2017,5,23,13,268,323,591
2017,5,23,14,198,312,510
2017,5,23,15,178,196,374
2017,5,23,16,144,167,311
2017,5,23,17,141,174,315
2017,5,23,18,120,142,262
2017,5,23,19,85,122,207
2017,5,23,20,68,115,183
2017,5,23,21,33,66,99
2017,5,23,22,20,22,42
2017,5,23,23,9,25,34
2017,5,24,0,7,19,26
2017,5,24,1,5,25,30
2017,5,24,2,8,12,20
2017,5,24,3,8,14,22
2017,5,24,4,111,67,178
2017,5,24,5,268,157,425
2017,5,24,6,382,195,577
2017,5,24,7,309,186,495
2017,5,24,8,229,171,400
2017,5,24,9,224,201,425
2017,5,24,10,245,224,469
2017,5,24,11,238,235,473
2017,5,24,12,243,319,562
2017,5,24,13,293,347,640
2017,5,24,14,215,306,521
2017,5,24,15,146,194,340
2017,5,24,16,154,181,335
2017,5,24,17,139,146,285
2017,5,24,18,136,138,274
2017,5,24,19,86,144,230
2017,5,24,20,62,90,152
2017,5,24,21,43,64,107
2017,5,24,22,25,43,68
2017,5,24,23,21,39,60
2017,5,25,0,13,32,45
2017,5,25,1,14,41,55
2017,5,25,2,8,29,37
2017,5,25,3,7,9,16
2017,5,25,4,17,7,24
2017,5,25,5,31,14,45
2017,5,25,6,54,35,89
2017,5,25,7,74,56,130
2017,5,25,8,99,66,165
2017,5,25,9,131,98,229
2017,5,25,10,163,155,318
2017,5,25,11,149,185,334
2017,5,25,12,165,203,368
2017,5,25,13,139,194,333
2017,5,25,14,134,194,328
2017,5,25,15,145,189,334
2017,5,25,16,148,174,322
2017,5,25,17,145,127,272
2017,5,25,18,103,130,233
2017,5,25,19,68,132,200
2017,5,25,20,62,120,182
2017,5,25,21,47,74,121
2017,5,25,22,23,29,52
2017,5,25,23,11,24,35
2017,5,26,0,3,18,21
2017,5,26,1,8,21,29
2017,5,26,2,9,14,23
2017,5,26,3,8,17,25
2017,5,26,4,83,39,122
2017,5,26,5,154,98,252
2017,5,26,6,230,146,376
2017,5,26,7,236,162,398
2017,5,26,8,225,171,396
2017,5,26,9,228,193,421
2017,5,26,10,226,211,437
2017,5,26,11,224,220,444
2017,5,26,12,195,247,442
2017,5,26,13,232,270,502
2017,5,26,14,184,249,433
2017,5,26,15,150,187,337
2017,5,26,16,143,149,292
2017,5,26,17,108,139,247
2017,5,26,18,104,108,212
2017,5,26,19,65,115,180
2017,5,26,20,69,98,167
2017,5,26,21,48,65,113
2017,5,26,22,38,46,84
2017,5,26,23,29,36,65
2017,5,27,0,21,38,59
2017,5,27,1,16,42,58
2017,5,27,2,9,24,33
2017,5,27,3,7,18,25
2017,5,27,4,22,18,40
2017,5,27,5,32,24,56
2017,5,27,6,46,36,82
2017,5,27,7,68,68,136
2017,5,27,8,103,101,204
2017,5,27,9,130,104,234
2017,5,27,10,136,144,280
2017,5,27,11,124,144,268
2017,5,27,12,129,135,264
2017,5,27,13,149,177,326
2017,5,27,14,117,139,256
2017,5,27,15,136,169,305
2017,5,27,16,122,158,280
2017,5,27,17,104,120,224
2017,5,27,18,97,119,216
2017,5,27,19,79,100,179
2017,5,27,20,58,84,142
2017,5,27,21,44,69,113
2017,5,27,22,40,73,113
2017,5,27,23,31,46,77
2017,5,28,0,19,53,72
2017,5,28,1,25,35,60
2017,5,28,2,19,46,65
2017,5,28,3,12,20,32
2017,5,28,4,25,13,38
2017,5,28,5,27,23,50
2017,5,28,6,51,24,75
2017,5,28,7,66,34,100
2017,5,28,8,88,88,176
2017,5,28,9,108,98,206
2017,5,28,10,124,117,241
2017,5,28,11,122,153,275
2017,5,28,12,153,165,318
2017,5,28,13,134,166,300
2017,5,28,14,158,214,372
2017,5,28,15,154,216,370
2017,5,28,16,133,159,292
2017,5,28,17,154,176,330
2017,5,28,18,199,167,366
2017,5,28,19,104,154,258
2017,5,28,20,58,113,171
2017,5,28,21,40,69,109
2017,5,28,22,16,33,49
2017,5,28,23,11,29,40
2017,5,29,0,8,15,23
2017,5,29,1,6,10,16
2017,5,29,2,3,8,11
2017,5,29,3,16,18,34
2017,5,29,4,130,59,189
2017,5,29,5,251,150,401
2017,5,29,6,376,213,589
2017,5,29,7,305,183,488
2017,5,29,8,228,195,423
2017,5,29,9,234,227,461
2017,5,29,10,226,214,440
2017,5,29,11,188,222,410
2017,5,29,12,213,256,469
2017,5,29,13,261,294,555
2017,5,29,14,251,312,563
2017,5,29,15,179,210,389
2017,5,29,16,178,179,357
2017,5,29,17,164,173,337
2017,5,29,18,122,128,250
2017,5,29,19,98,178,276
2017,5,29,20,65,104,169
2017,5,29,21,27,58,85
2017,5,29,22,22,32,54
2017,5,29,23,12,19,31
2017,5,30,0,8,18,26
2017,5,30,1,4,8,12
2017,5,30,2,8,14,22
2017,5,30,3,16,19,35
2017,5,30,4,131,57,188
2017,5,30,5,232,159,391
2017,5,30,6,414,193,607
2017,5,30,7,252,181,433
2017,5,30,8,222,203,425
2017,5,30,9,209,203,412
2017,5,30,10,229,217,446
2017,5,30,11,242,245,487
2017,5,30,12,220,276,496
2017,5,30,13,273,363,636
2017,5,30,14,212,292,504
2017,5,30,15,175,198,373
2017,5,30,16,195,180,375
2017,5,30,17,151,159,310
2017,5,30,18,129,161,290
2017,5,30,19,99,145,244
2017,5,30,20,65,122,187
2017,5,30,21,42,74,116
2017,5,30,22,26,44,70
2017,5,30,23,10,33,43
2017,5,31,0,12,20,32
2017,5,31,1,14,26,40
2017,5,31,2,16,16,32
2017,5,31,3,7,20,27
2017,5,31,4,113,51,164
2017,5,31,5,278,165,443
2017,5,31,6,383,205,588
2017,5,31,7,282,191,473
2017,5,31,8,259,205,464
2017,5,31,9,252,203,455
2017,5,31,10,239,253,492
2017,5,31,11,224,217,441
2017,5,31,12,250,254,504
2017,5,31,13,234,335,569
2017,5,31,14,218,269,487
2017,5,31,15,177,176,353
2017,5,31,16,160,188,348
2017,5,31,17,154,173,327
2017,5,31,18,111,135,246
2017,5,31,19,109,153,262
2017,5,31,20,70,430,500
2017,5,31,21,45,69,114
2017,5,31,22,28,50,78
2017,5,31,23,9,31,40
2017,6,1,0,6,16,22
2017,6,1,1,10,20,30
2017,6,1,2,6,24,30
2017,6,1,3,10,14,24
2017,6,1,4,119,59,178
2017,6,1,5,245,172,417
2017,6,1,6,360,192,552
2017,6,1,7,267,189,456
2017,6,1,8,229,207,436
2017,6,1,9,236,207,443
2017,6,1,10,256,227,483
2017,6,1,11,229,253,482
2017,6,1,12,230,319,549
2017,6,1,13,289,331,620
2017,6,1,14,230,293,523
2017,6,1,15,197,203,400
2017,6,1,16,185,169,354
2017,6,1,17,158,187,345
2017,6,1,18,122,169,291
2017,6,1,19,97,140,237
2017,6,1,20,71,128,199
2017,6,1,21,47,70,117
2017,6,1,22,29,45,74
2017,6,1,23,17,36,53
2017,6,2,0,15,31,46
2017,6,2,1,10,29,39
2017,6,2,2,10,24,34
2017,6,2,3,15,17,32
2017,6,2,4,125,55,180
2017,6,2,5,228,142,370
2017,6,2,6,365,211,576
2017,6,2,7,216,173,389
2017,6,2,8,222,188,410
2017,6,2,9,235,217,452
2017,6,2,10,225,261,486
2017,6,2,11,225,266,491
2017,6,2,12,253,325,578
2017,6,2,13,277,371,648
2017,6,2,14,210,296,506
2017,6,2,15,163,191,354
2017,6,2,16,157,161,318
2017,6,2,17,128,132,260
2017,6,2,18,113,124,237
2017,6,2,19,91,95,186
2017,6,2,20,60,87,147
2017,6,2,21,36,60,96
2017,6,2,22,31,48,79
2017,6,2,23,26,31,57
2017,6,3,0,17,34,51
2017,6,3,1,17,30,47
2017,6,3,2,17,33,50
2017,6,3,3,7,9,16
2017,6,3,4,23,14,37
2017,6,3,5,33,27,60
2017,6,3,6,52,41,93
2017,6,3,7,66,65,131
2017,6,3,8,121,96,217
2017,6,3,9,153,118,271
2017,6,3,10,170,163,333
2017,6,3,11,139,144,283
2017,6,3,12,131,167,298
2017,6,3,13,150,177,327
2017,6,3,14,139,191,330
2017,6,3,15,144,187,331
2017,6,3,16,166,167,333
2017,6,3,17,146,129,275
2017,6,3,18,95,112,207
2017,6,3,19,69,84,153
2017,6,3,20,61,87,148
2017,6,3,21,49,58,107
2017,6,3,22,53,72,125
2017,6,3,23,32,61,93
2017,6,4,0,25,53,78
2017,6,4,1,33,71,104
2017,6,4,2,13,43,56
2017,6,4,3,6,20,26
2017,6,4,4,16,15,31
2017,6,4,5,17,15,32
2017,6,4,6,33,15,48
2017,6,4,7,32,39,71
2017,6,4,8,87,60,147
2017,6,4,9,105,82,187
2017,6,4,10,145,129,274
2017,6,4,11,128,151,279
2017,6,4,12,171,151,322
2017,6,4,13,137,193,330
2017,6,4,14,117,255,372
2017,6,4,15,135,149,284
2017,6,4,16,130,139,269
2017,6,4,17,95,128,223
2017,6,4,18,104,142,246
2017,6,4,19,80,93,173
2017,6,4,20,64,85,149
2017,6,4,21,40,58,98
2017,6,4,22,27,40,67
2017,6,4,23,17,28,45
2017,6,5,0,17,32,49
2017,6,5,1,7,14,21
2017,6,5,2,5,10,15
2017,6,5,3,8,9,17
2017,6,5,4,11,8,19
2017,6,5,5,29,27,56
2017,6,5,6,39,26,65
2017,6,5,7,62,52,114
2017,6,5,8,86,73,159
2017,6,5,9,100,101,201
2017,6,5,10,143,118,261
2017,6,5,11,140,167,307
2017,6,5,12,140,176,316
2017,6,5,13,135,181,316
2017,6,5,14,163,209,372
2017,6,5,15,194,192,386
2017,6,5,16,155,192,347
2017,6,5,17,165,174,339
2017,6,5,18,134,148,282
2017,6,5,19,106,127,233
2017,6,5,20,57,115,172
2017,6,5,21,34,69,103
2017,6,5,22,21,35,56
2017,6,5,23,14,21,35
2017,6,6,0,9,11,20
2017,6,6,1,6,8,14
2017,6,6,2,2,12,14
2017,6,6,3,13,12,25
2017,6,6,4,124,70,194
2017,6,6,5,271,166,437
2017,6,6,6,414,243,657
2017,6,6,7,288,200,488
2017,6,6,8,226,213,439
2017,6,6,9,220,184,404
2017,6,6,10,227,259,486
2017,6,6,11,237,216,453
2017,6,6,12,231,246,477
2017,6,6,13,276,388,664
2017,6,6,14,224,330,554
2017,6,6,15,205,200,405
2017,6,6,16,193,182,375
2017,6,6,17,146,152,298
2017,6,6,18,102,148,250
2017,6,6,19,96,142,238
2017,6,6,20,64,95,159
2017,6,6,21,33,73,106
2017,6,6,22,20,31,51
2017,6,6,23,19,29,48
2017,6,7,0,12,17,29
2017,6,7,1,10,18,28
2017,6,7,2,7,15,22
2017,6,7,3,17,10,27
2017,6,7,4,112,58,170
2017,6,7,5,245,150,395
2017,6,7,6,383,223,606
2017,6,7,7,283,159,442
2017,6,7,8,211,205,416
2017,6,7,9,221,182,403
2017,6,7,10,214,193,407
2017,6,7,11,201,222,423
2017,6,7,12,231,304,535
2017,6,7,13,252,300,552
2017,6,7,14,193,297,490
2017,6,7,15,158,198,356
2017,6,7,16,172,155,327
2017,6,7,17,136,149,285
2017,6,7,18,121,150,271
2017,6,7,19,100,135,235
2017,6,7,20,67,427,494
2017,6,7,21,44,332,376
2017,6,7,22,19,140,159
2017,6,7,23,13,91,104
2017,6,8,0,7,56,63
2017,6,8,1,6,55,61
2017,6,8,2,10,12,22
2017,6,8,3,13,11,24
2017,6,8,4,96,54,150
2017,6,8,5,234,148,382
2017,6,8,6,388,193,581
2017,6,8,7,264,190,454
2017,6,8,8,218,203,421
2017,6,8,9,226,190,416
2017,6,8,10,254,230,484
2017,6,8,11,230,241,471
2017,6,8,12,257,319,576
2017,6,8,13,262,341,603
2017,6,8,14,201,302,503
2017,6,8,15,186,214,400
2017,6,8,16,174,149,323
2017,6,8,17,144,172,316
2017,6,8,18,117,136,253
2017,6,8,19,93,136,229
2017,6,8,20,74,116,190
2017,6,8,21,50,82,132
2017,6,8,22,30,48,78
2017,6,8,23,18,47,65
2017,6,9,0,12,27,39
2017,6,9,1,6,31,37
2017,6,9,2,8,24,32
2017,6,9,3,14,11,25
2017,6,9,4,105,58,163
2017,6,9,5,266,176,442
2017,6,9,6,350,198,548
2017,6,9,7,257,182,439
2017,6,9,8,233,200,433
2017,6,9,9,246,212,458
2017,6,9,10,255,239,494
2017,6,9,11,236,258,494
2017,6,9,12,260,332,592
2017,6,9,13,262,355,617
2017,6,9,14,210,260,470
2017,6,9,15,166,187,353
2017,6,9,16,197,152,349
2017,6,9,17,114,166,280
2017,6,9,18,101,115,216
2017,6,9,19,68,111,179
2017,6,9,20,52,86,138
2017,6,9,21,48,64,112
2017,6,9,22,57,59,116
2017,6,9,23,31,53,84
2017,6,10,0,17,30,47
2017,6,10,1,17,26,43
2017,6,10,2,11,28,39
2017,6,10,3,24,14,38
2017,6,10,4,30,58,88
2017,6,10,5,37,24,61
2017,6,10,6,39,41,80
2017,6,10,7,90,78,168
2017,6,10,8,122,92,214
2017,6,10,9,145,107,252
2017,6,10,10,156,155,311
2017,6,10,11,180,186,366
2017,6,10,12,158,170,328
2017,6,10,13,177,257,434
2017,6,10,14,137,221,358
2017,6,10,15,133,211,344
2017,6,10,16,127,174,301
2017,6,10,17,117,129,246
2017,6,10,18,109,105,214
2017,6,10,19,74,99,173
2017,6,10,20,48,81,129
2017,6,10,21,53,68,121
2017,6,10,22,50,85,135
2017,6,10,23,35,52,87
2017,6,11,0,26,47,73
2017,6,11,1,27,62,89
2017,6,11,2,21,45,66
2017,6,11,3,9,22,31
2017,6,11,4,19,11,30
2017,6,11,5,21,16,37
2017,6,11,6,45,25,70
2017,6,11,7,70,52,122
2017,6,11,8,103,63,166
2017,6,11,9,160,90,250
2017,6,11,10,208,169,377
2017,6,11,11,226,233,459
2017,6,11,12,194,259,453
2017,6,11,13,168,265,433
2017,6,11,14,178,305,483
2017,6,11,15,164,215,379
2017,6,11,16,199,175,374
2017,6,11,17,138,188,326
2017,6,11,18,137,206,343
2017,6,11,19,98,115,213
2017,6,11,20,68,90,158
2017,6,11,21,50,74,124
2017,6,11,22,21,30,51
2017,6,11,23,10,15,25
2017,6,12,0,16,22,38
2017,6,12,1,8,12,20
2017,6,12,2,6,18,24
2017,6,12,3,15,16,31
2017,6,12,4,122,64,186
2017,6,12,5,244,156,400
2017,6,12,6,337,206,543
2017,6,12,7,273,189,462
2017,6,12,8,212,187,399
2017,6,12,9,215,199,414
2017,6,12,10,211,204,415
2017,6,12,11,232,242,474
2017,6,12,12,240,281,521
2017,6,12,13,285,342,627
2017,6,12,14,232,293,525
2017,6,12,15,171,188,359
2017,6,12,16,189,204,393
2017,6,12,17,143,128,271
2017,6,12,18,126,140,266
2017,6,12,19,86,116,202
2017,6,12,20,81,310,391
2017,6,12,21,37,223,260
2017,6,12,22,20,108,128
2017,6,12,23,15,76,91
2017,6,13,0,15,44,59
2017,6,13,1,12,36,48
2017,6,13,2,10,32,42
2017,6,13,3,20,29,49
2017,6,13,4,117,59,176
2017,6,13,5,248,150,398
2017,6,13,6,374,209,583
2017,6,13,7,275,174,449
2017,6,13,8,209,219,428
2017,6,13,9,214,208,422
2017,6,13,10,228,242,470
2017,6,13,11,269,234,503
2017,6,13,12,219,284,503
2017,6,13,13,261,360,621
2017,6,13,14,236,302,538
2017,6,13,15,175,186,361
2017,6,13,16,152,185,337
2017,6,13,17,130,165,295
2017,6,13,18,127,133,260
2017,6,13,19,93,115,208
2017,6,13,20,57,471,528
2017,6,13,21,43,310,353
2017,6,13,22,26,130,156
2017,6,13,23,21,81,102
2017,6,14,0,13,42,55
2017,6,14,1,9,45,54
2017,6,14,2,15,43,58
2017,6,14,3,16,67,83
2017,6,14,4,103,55,158
2017,6,14,5,199,159,358
2017,6,14,6,349,190,539
2017,6,14,7,288,166,454
2017,6,14,8,248,167,415
2017,6,14,9,203,217,420
2017,6,14,10,242,233,475
2017,6,14,11,229,235,464
2017,6,14,12,225,270,495
2017,6,14,13,299,353,652
2017,6,14,14,231,275,506
2017,6,14,15,210,232,442
2017,6,14,16,147,192,339
2017,6,14,17,152,155,307
2017,6,14,18,101,139,240
2017,6,14,19,88,129,217
2017,6,14,20,69,116,185
2017,6,14,21,38,80,118
2017,6,14,22,29,44,73
2017,6,14,23,19,47,66
2017,6,15,0,10,30,40
2017,6,15,1,10,33,43
2017,6,15,2,8,19,27
2017,6,15,3,14,21,35
2017,6,15,4,95,61,156
2017,6,15,5,214,155,369
2017,6,15,6,332,188,520
2017,6,15,7,247,162,409
2017,6,15,8,227,195,422
2017,6,15,9,212,185,397
2017,6,15,10,212,209,421
2017,6,15,11,241,233,474
2017,6,15,12,230,284,514
2017,6,15,13,258,324,582
2017,6,15,14,214,284,498
2017,6,15,15,188,191,379
2017,6,15,16,166,160,326
2017,6,15,17,133,175,308
2017,6,15,18,133,135,268
2017,6,15,19,86,112,198
2017,6,15,20,70,100,170
2017,6,15,21,57,65,122
2017,6,15,22,36,38,74
2017,6,15,23,24,36,60
2017,6,16,0,19,26,45
2017,6,16,1,8,26,34
2017,6,16,2,8,23,31
2017,6,16,3,14,16,30
2017,6,16,4,110,46,156
2017,6,16,5,225,157,382
2017,6,16,6,359,211,570
2017,6,16,7,258,173,431
2017,6,16,8,218,190,408
2017,6,16,9,227,215,442
2017,6,16,10,254,235,489
2017,6,16,11,238,243,481
2017,6,16,12,265,312,577
2017,6,16,13,259,299,558
2017,6,16,14,208,254,462
2017,6,16,15,158,174,332
2017,6,16,16,138,156,294
2017,6,16,17,118,152,270
2017,6,16,18,96,124,220
2017,6,16,19,67,110,177
2017,6,16,20,73,101,174
2017,6,16,21,47,69,116
2017,6,16,22,47,73,120
2017,6,16,23,36,50,86
2017,6,17,0,20,44,64
2017,6,17,1,25,51,76
2017,6,17,2,18,29,47
2017,6,17,3,14,14,28
2017,6,17,4,22,17,39
2017,6,17,5,32,31,63
2017,6,17,6,39,40,79
2017,6,17,7,59,58,117
2017,6,17,8,97,79,176
2017,6,17,9,158,129,287
2017,6,17,10,169,165,334
2017,6,17,11,153,178,331
2017,6,17,12,153,170,323
2017,6,17,13,146,200,346
2017,6,17,14,134,176,310
2017,6,17,15,130,159,289
2017,6,17,16,125,154,279
2017,6,17,17,98,111,209
2017,6,17,18,95,109,204
2017,6,17,19,64,89,153
2017,6,17,20,58,91,149
2017,6,17,21,46,65,111
2017,6,17,22,38,47,85
2017,6,17,23,37,55,92
2017,6,18,0,27,42,69
2017,6,18,1,27,51,78
2017,6,18,2,27,42,69
2017,6,18,3,13,31,44
2017,6,18,4,18,21,39
2017,6,18,5,20,17,37
2017,6,18,6,31,26,57
2017,6,18,7,50,41,91
2017,6,18,8,73,71,144
2017,6,18,9,94,69,163
2017,6,18,10,131,105,236
2017,6,18,11,203,176,379
2017,6,18,12,177,210,387
2017,6,18,13,175,235,410
2017,6,18,14,160,233,393
2017,6,18,15,172,253,425
2017,6,18,16,149,192,341
2017,6,18,17,166,157,323
2017,6,18,18,137,177,314
2017,6,18,19,92,134,226
2017,6,18,20,75,89,164
2017,6,18,21,47,63,110
2017,6,18,22,29,37,66
2017,6,18,23,21,21,42
2017,6,19,0,13,8,21
2017,6,19,1,7,18,25
2017,6,19,2,7,10,17
2017,6,19,3,13,12,25
2017,6,19,4,115,58,173
2017,6,19,5,234,144,378
2017,6,19,6,377,198,575
2017,6,19,7,248,173,421
2017,6,19,8,223,176,399
2017,6,19,9,214,203,417
2017,6,19,10,194,192,386
2017,6,19,11,199,197,396
2017,6,19,12,224,284,508
2017,6,19,13,265,433,698
2017,6,19,14,253,578,831
2017,6,19,15,172,231,403
2017,6,19,16,199,184,383
2017,6,19,17,130,106,236
2017,6,19,18,112,127,239
2017,6,19,19,127,155,282
2017,6,19,20,68,68,136
2017,6,19,21,45,57,102
2017,6,19,22,23,26,49
2017,6,19,23,12,8,20
2017,6,20,0,6,13,19
2017,6,20,1,8,16,24
2017,6,20,2,8,14,22
2017,6,20,3,22,15,37
2017,6,20,4,111,58,169
2017,6,20,5,237,149,386
2017,6,20,6,377,185,562
2017,6,20,7,290,180,470
2017,6,20,8,214,188,402
2017,6,20,9,214,231,445
2017,6,20,10,223,198,421
2017,6,20,11,176,210,386
2017,6,20,12,200,290,490
2017,6,20,13,268,362,630
2017,6,20,14,196,273,469
2017,6,20,15,174,182,356
2017,6,20,16,159,167,326
2017,6,20,17,126,163,289
2017,6,20,18,146,130,276
2017,6,20,19,85,107,192
2017,6,20,20,93,77,170
2017,6,20,21,87,61,148
2017,6,20,22,60,28,88
2017,6,20,23,46,18,64
2017,6,21,0,33,10,43
2017,6,21,1,12,25,37
2017,6,21,2,11,19,30
2017,6,21,3,22,7,29
2017,6,21,4,116,54,170
2017,6,21,5,228,146,374
2017,6,21,6,340,225,565
2017,6,21,7,262,174,436
2017,6,21,8,201,189,390
2017,6,21,9,186,192,378
2017,6,21,10,238,221,459
2017,6,21,11,206,218,424
2017,6,21,12,230,289,519
2017,6,21,13,284,339,623
2017,6,21,14,224,304,528
2017,6,21,15,163,190,353
2017,6,21,16,144,165,309
2017,6,21,17,139,157,296
2017,6,21,18,115,141,256
2017,6,21,19,102,123,225
2017,6,21,20,70,90,160
2017,6,21,21,53,56,109
2017,6,21,22,41,37,78
2017,6,21,23,26,26,52
2017,6,22,0,20,19,39
2017,6,22,1,5,21,26
2017,6,22,2,4,22,26
2017,6,22,3,12,13,25
2017,6,22,4,120,56,176
2017,6,22,5,208,155,363
2017,6,22,6,366,182,548
2017,6,22,7,253,151,404
2017,6,22,8,204,182,386
2017,6,22,9,218,190,408
2017,6,22,10,226,218,444
2017,6,22,11,193,230,423
2017,6,22,12,219,287,506
2017,6,22,13,265,353,618
2017,6,22,14,230,298,528
2017,6,22,15,221,206,427
2017,6,22,16,158,174,332
2017,6,22,17,140,162,302
2017,6,22,18,122,138,260
2017,6,22,19,90,112,202
2017,6,22,20,67,118,185
2017,6,22,21,54,63,117
2017,6,22,22,40,47,87
2017,6,22,23,20,25,45
2017,6,23,0,13,16,29
2017,6,23,1,8,19,27
2017,6,23,2,5,15,20
2017,6,23,3,15,10,25
2017,6,23,4,122,57,179
2017,6,23,5,241,145,386
2017,6,23,6,359,183,542
2017,6,23,7,277,163,440
2017,6,23,8,249,194,443
2017,6,23,9,225,226,451
2017,6,23,10,246,205,451
2017,6,23,11,245,260,505
2017,6,23,12,258,322,580
2017,6,23,13,257,335,592
2017,6,23,14,188,297,485
2017,6,23,15,150,175,325
2017,6,23,16,123,125,248
2017,6,23,17,108,109,217
2017,6,23,18,85,99,184
2017,6,23,19,64,90,154
2017,6,23,20,66,71,137
2017,6,23,21,50,65,115
2017,6,23,22,37,64,101
2017,6,23,23,33,44,77
2017,6,24,0,23,41,64
2017,6,24,1,18,33,51
2017,6,24,2,7,22,29
2017,6,24,3,13,15,28
2017,6,24,4,24,14,38
2017,6,24,5,28,26,54
2017,6,24,6,28,43,71
2017,6,24,7,56,73,129
2017,6,24,8,97,72,169
2017,6,24,9,118,105,223
2017,6,24,10,159,133,292
2017,6,24,11,164,152,316
2017,6,24,12,139,184,323
2017,6,24,13,127,168,295
2017,6,24,14,120,176,296
2017,6,24,15,131,160,291
2017,6,24,16,127,126,253
2017,6,24,17,84,109,193
2017,6,24,18,87,105,192
2017,6,24,19,78,72,150
2017,6,24,20,53,68,121
2017,6,24,21,44,66,110
2017,6,24,22,37,54,91
2017,6,24,23,36,56,92
2017,6,25,0,28,50,78
2017,6,25,1,27,44,71
2017,6,25,2,19,25,44
2017,6,25,3,18,21,39
2017,6,25,4,19,19,38
2017,6,25,5,19,23,42
2017,6,25,6,30,23,53
2017,6,25,7,42,57,99
2017,6,25,8,80,62,142
2017,6,25,9,155,69,224
2017,6,25,10,153,144,297
2017,6,25,11,176,178,354
2017,6,25,12,177,195,372
2017,6,25,13,163,198,361
2017,6,25,14,146,209,355
2017,6,25,15,148,178,326
2017,6,25,16,130,167,297
2017,6,25,17,130,132,262
2017,6,25,18,122,148,270
2017,6,25,19,94,129,223
2017,6,25,20,73,288,361
2017,6,25,21,51,181,232
2017,6,25,22,37,85,122
2017,6,25,23,12,46,58
2017,6,26,0,16,41,57
2017,6,26,1,7,8,15
2017,6,26,2,8,6,14
2017,6,26,3,15,18,33
2017,6,26,4,112,58,170
2017,6,26,5,216,141,357
2017,6,26,6,312,174,486
2017,6,26,7,262,183,445
2017,6,26,8,250,191,441
2017,6,26,9,216,189,405
2017,6,26,10,212,185,397
2017,6,26,11,199,224,423
2017,6,26,12,219,277,496
2017,6,26,13,240,338,578
2017,6,26,14,196,282,478
2017,6,26,15,159,181,340
2017,6,26,16,129,156,285
2017,6,26,17,131,131,262
2017,6,26,18,140,121,261
2017,6,26,19,78,135,213
2017,6,26,20,53,84,137
2017,6,26,21,39,51,90
2017,6,26,22,23,35,58
2017,6,26,23,15,20,35
2017,6,27,0,8,12,20
2017,6,27,1,3,5,8
2017,6,27,2,6,12,18
2017,6,27,3,13,17,30
2017,6,27,4,99,63,162
2017,6,27,5,216,123,339
2017,6,27,6,303,167,470
2017,6,27,7,238,172,410
2017,6,27,8,192,157,349
2017,6,27,9,214,183,397
2017,6,27,10,208,212,420
2017,6,27,11,184,197,381
2017,6,27,12,211,269,480
2017,6,27,13,222,322,544
2017,6,27,14,180,261,441
2017,6,27,15,157,188,345
2017,6,27,16,134,131,265
2017,6,27,17,107,143,250
2017,6,27,18,104,138,242
2017,6,27,19,92,115,207
2017,6,27,20,59,81,140
2017,6,27,21,54,47,101
2017,6,27,22,21,36,57
2017,6,27,23,17,33,50
2017,6,28,0,12,19,31
2017,6,28,1,6,12,18
2017,6,28,2,10,9,19
2017,6,28,3,9,21,30
2017,6,28,4,124,58,182
2017,6,28,5,197,118,315
2017,6,28,6,306,158,464
2017,6,28,7,238,181,419
2017,6,28,8,192,149,341
2017,6,28,9,201,180,381
2017,6,28,10,216,202,418
2017,6,28,11,187,202,389
2017,6,28,12,205,243,448
2017,6,28,13,258,320,578
2017,6,28,14,186,232,418
2017,6,28,15,154,170,324
2017,6,28,16,108,160,268
2017,6,28,17,137,135,272
2017,6,28,18,98,113,211
2017,6,28,19,90,98,188
2017,6,28,20,50,96,146
2017,6,28,21,48,47,95
2017,6,28,22,25,43,68
2017,6,28,23,14,43,57
2017,6,29,0,4,20,24
2017,6,29,1,3,14,17
2017,6,29,2,4,14,18
2017,6,29,3,9,14,23
2017,6,29,4,107,63,170
2017,6,29,5,171,127,298
2017,6,29,6,297,160,457
2017,6,29,7,254,188,442
2017,6,29,8,208,163,371
2017,6,29,9,195,208,403
2017,6,29,10,187,217,404
2017,6,29,11,192,220,412
2017,6,29,12,190,262,452
2017,6,29,13,248,303,551
2017,6,29,14,194,267,461
2017,6,29,15,166,192,358
2017,6,29,16,135,152,287
2017,6,29,17,136,148,284
2017,6,29,18,92,128,220
2017,6,29,19,96,111,207
2017,6,29,20,71,86,157
2017,6,29,21,48,68,116
2017,6,29,22,26,32,58
2017,6,29,23,15,29,44
2017,6,30,0,7,21,28
2017,6,30,1,10,20,30
2017,6,30,2,6,19,25
2017,6,30,3,9,18,27
2017,6,30,4,94,62,156
2017,6,30,5,208,119,327
2017,6,30,6,260,159,419
2017,6,30,7,235,201,436
2017,6,30,8,213,194,407
2017,6,30,9,220,188,408
2017,6,30,10,231,243,474
2017,6,30,11,230,303,533
2017,6,30,12,215,288,503
2017,6,30,13,217,323,540
2017,6,30,14,181,194,375
2017,6,30,15,131,173,304
2017,6,30,16,148,152,300
2017,6,30,17,106,129,235
2017,6,30,18,100,119,219
2017,6,30,19,75,91,166
2017,6,30,20,61,80,141
2017,6,30,21,54,75,129
2017,6,30,22,27,52,79
2017,6,30,23,25,40,65
2017,7,1,0,10,31,41
2017,7,1,1,10,22,32
2017,7,1,2,11,22,33
2017,7,1,3,8,11,19
2017,7,1,4,22,18,40
2017,7,1,5,29,24,53
2017,7,1,6,34,37,71
2017,7,1,7,49,66,115
2017,7,1,8,85,66,151
2017,7,1,9,106,105,211
2017,7,1,10,111,104,215
2017,7,1,11,117,132,249
2017,7,1,12,120,127,247
2017,7,1,13,122,145,267
2017,7,1,14,135,134,269
2017,7,1,15,97,135,232
2017,7,1,16,120,128,248
2017,7,1,17,91,113,204
2017,7,1,18,81,104,185
2017,7,1,19,57,77,134
2017,7,1,20,44,64,108
2017,7,1,21,27,57,84
2017,7,1,22,31,49,80
2017,7,1,23,23,37,60
2017,7,2,0,15,35,50
2017,7,2,1,17,48,65
2017,7,2,2,14,20,34
2017,7,2,3,11,19,30
2017,7,2,4,11,11,22
2017,7,2,5,13,14,27
2017,7,2,6,23,16,39
2017,7,2,7,45,39,84
2017,7,2,8,51,63,114
2017,7,2,9,101,80,181
2017,7,2,10,114,113,227
2017,7,2,11,120,141,261
2017,7,2,12,161,154,315
2017,7,2,13,119,157,276
2017,7,2,14,106,177,283
2017,7,2,15,126,156,282
2017,7,2,16,116,151,267
2017,7,2,17,140,171,311
2017,7,2,18,109,130,239
2017,7,2,19,64,91,155
2017,7,2,20,129,75,204
2017,7,2,21,43,58,101
2017,7,2,22,25,25,50
2017,7,2,23,11,17,28
2017,7,3,0,7,13,20
2017,7,3,1,5,13,18
2017,7,3,2,7,5,12
2017,7,3,3,12,7,19
2017,7,3,4,109,51,160
2017,7,3,5,158,110,268
2017,7,3,6,245,128,373
2017,7,3,7,212,170,382
2017,7,3,8,188,134,322
2017,7,3,9,179,159,338
2017,7,3,10,193,172,365
2017,7,3,11,199,211,410
2017,7,3,12,218,259,477
2017,7,3,13,201,305,506
2017,7,3,14,149,240,389
2017,7,3,15,156,159,315
2017,7,3,16,106,131,237
2017,7,3,17,113,119,232
2017,7,3,18,92,124,216
2017,7,3,19,93,116,209
2017,7,3,20,95,92,187
2017,7,3,21,48,59,107
2017,7,3,22,35,21,56
2017,7,3,23,13,20,33
2017,7,4,0,6,4,10
2017,7,4,1,8,16,24
2017,7,4,2,9,13,22
2017,7,4,3,25,14,39
2017,7,4,4,100,45,145
2017,7,4,5,211,117,328
2017,7,4,6,231,132,363
2017,7,4,7,226,180,406
2017,7,4,8,202,168,370
2017,7,4,9,195,193,388
2017,7,4,10,209,199,408
2017,7,4,11,179,221,400
2017,7,4,12,182,248,430
2017,7,4,13,216,297,513
2017,7,4,14,158,212,370
2017,7,4,15,138,170,308
2017,7,4,16,97,105,202
2017,7,4,17,92,146,238
2017,7,4,18,96,117,213
2017,7,4,19,65,95,160
2017,7,4,20,55,287,342
2017,7,4,21,40,414,454
2017,7,4,22,35,211,246
2017,7,4,23,15,110,125
2017,7,5,0,19,85,104
2017,7,5,1,17,27,44
2017,7,5,2,11,25,36
2017,7,5,3,20,13,33
2017,7,5,4,108,52,160
2017,7,5,5,172,105,277
2017,7,5,6,267,149,416
2017,7,5,7,205,169,374
2017,7,5,8,181,165,346
2017,7,5,9,178,167,345
2017,7,5,10,185,180,365
2017,7,5,11,201,188,389
2017,7,5,12,203,265,468
2017,7,5,13,186,266,452
2017,7,5,14,150,238,388
2017,7,5,15,140,153,293
2017,7,5,16,130,135,265
2017,7,5,17,113,131,244
2017,7,5,18,91,138,229
2017,7,5,19,74,109,183
2017,7,5,20,63,91,154
2017,7,5,21,34,47,81
2017,7,5,22,23,22,45
2017,7,5,23,11,18,29
2017,7,6,0,7,14,21
2017,7,6,1,7,21,28
2017,7,6,2,10,13,23
2017,7,6,3,13,13,26
2017,7,6,4,101,60,161
2017,7,6,5,185,89,274
2017,7,6,6,240,133,373
2017,7,6,7,189,172,361
2017,7,6,8,149,143,292
2017,7,6,9,162,149,311
2017,7,6,10,177,173,350
2017,7,6,11,186,198,384
2017,7,6,12,185,248,433
2017,7,6,13,208,271,479
2017,7,6,14,173,219,392
2017,7,6,15,119,157,276
2017,7,6,16,127,126,253
2017,7,6,17,99,137,236
2017,7,6,18,102,101,203
2017,7,6,19,85,111,196
2017,7,6,20,64,77,141
2017,7,6,21,37,61,98
2017,7,6,22,20,31,51
2017,7,6,23,12,21,33
2017,7,7,0,11,19,30
2017,7,7,1,8,17,25
2017,7,7,2,5,12,17
2017,7,7,3,13,12,25
2017,7,7,4,91,44,135
2017,7,7,5,153,104,257
2017,7,7,6,204,120,324
2017,7,7,7,238,154,392
2017,7,7,8,212,158,370
2017,7,7,9,177,172,349
2017,7,7,10,153,206,359
2017,7,7,11,213,185,398
2017,7,7,12,215,256,471
2017,7,7,13,201,236,437
2017,7,7,14,169,222,391
2017,7,7,15,114,150,264
2017,7,7,16,123,127,250
2017,7,7,17,97,118,215
2017,7,7,18,94,112,206
2017,7,7,19,62,76,138
2017,7,7,20,45,55,100
2017,7,7,21,33,51,84
2017,7,7,22,19,38,57
2017,7,7,23,21,27,48
2017,7,8,0,10,22,32
2017,7,8,1,7,23,30
2017,7,8,2,12,11,23
2017,7,8,3,9,7,16
2017,7,8,4,18,11,29
2017,7,8,5,28,21,49
2017,7,8,6,18,16,34
2017,7,8,7,44,47,91
2017,7,8,8,75,70,145
2017,7,8,9,103,89,192
2017,7,8,10,108,109,217
2017,7,8,11,103,110,213
2017,7,8,12,113,143,256
2017,7,8,13,116,129,245
2017,7,8,14,88,129,217
2017,7,8,15,102,114,216
2017,7,8,16,92,119,211
2017,7,8,17,88,98,186
2017,7,8,18,79,104,183
2017,7,8,19,64,83,147
2017,7,8,20,45,69,114
2017,7,8,21,29,53,82
2017,7,8,22,27,50,77
2017,7,8,23,21,41,62
2017,7,9,0,15,33,48
2017,7,9,1,12,39,51
2017,7,9,2,14,24,38
2017,7,9,3,8,10,18
2017,7,9,4,15,13,28
2017,7,9,5,14,14,28
2017,7,9,6,25,11,36
2017,7,9,7,28,35,63
2017,7,9,8,50,45,95
2017,7,9,9,75,52,127
2017,7,9,10,99,79,178
2017,7,9,11,90,116,206
2017,7,9,12,111,130,241
2017,7,9,13,110,160,270
2017,7,9,14,102,125,227
2017,7,9,15,108,124,232
2017,7,9,16,104,134,238
2017,7,9,17,103,120,223
2017,7,9,18,96,137,233
2017,7,9,19,48,78,126
2017,7,9,20,63,83,146
2017,7,9,21,34,46,80
2017,7,9,22,32,28,60
2017,7,9,23,10,16,26
2017,7,10,0,8,18,26
2017,7,10,1,5,15,20
2017,7,10,2,10,15,25
2017,7,10,3,10,17,27
2017,7,10,4,72,38,110
2017,7,10,5,129,94,223
2017,7,10,6,172,88,260
2017,7,10,7,163,135,298
2017,7,10,8,158,137,295
2017,7,10,9,195,136,331
2017,7,10,10,158,185,343
2017,7,10,11,155,163,318
2017,7,10,12,172,207,379
2017,7,10,13,159,212,371
2017,7,10,14,157,197,354
2017,7,10,15,124,135,259
2017,7,10,16,126,122,248
2017,7,10,17,96,148,244
2017,7,10,18,97,107,204
2017,7,10,19,73,114,187
2017,7,10,20,47,84,131
2017,7,10,21,28,45,73
2017,7,10,22,15,29,44
2017,7,10,23,15,17,32
2017,7,11,0,6,18,24
2017,7,11,1,3,13,16
2017,7,11,2,13,10,23
2017,7,11,3,15,14,29
2017,7,11,4,63,40,103
2017,7,11,5,143,79,222
2017,7,11,6,183,96,279
2017,7,11,7,133,125,258
2017,7,11,8,132,129,261
2017,7,11,9,157,151,308
2017,7,11,10,156,169,325
2017,7,11,11,170,160,330
2017,7,11,12,168,197,365
2017,7,11,13,155,231,386
2017,7,11,14,131,192,323
2017,7,11,15,100,156,256
2017,7,11,16,106,125,231
2017,7,11,17,96,115,211
2017,7,11,18,79,97,176
2017,7,11,19,62,92,154
2017,7,11,20,59,88,147
2017,7,11,21,29,42,71
2017,7,11,22,14,22,36
2017,7,11,23,14,16,30
2017,7,12,0,12,10,22
2017,7,12,1,8,17,25
2017,7,12,2,6,10,16
2017,7,12,3,13,16,29
2017,7,12,4,74,39,113
2017,7,12,5,128,97,225
2017,7,12,6,164,98,262
2017,7,12,7,138,94,232
2017,7,12,8,128,122,250
2017,7,12,9,148,127,275
2017,7,12,10,157,137,294
2017,7,12,11,169,173,342
2017,7,12,12,175,210,385
2017,7,12,13,182,207,389
2017,7,12,14,126,193,319
2017,7,12,15,107,155,262
2017,7,12,16,115,116,231
2017,7,12,17,113,125,238
2017,7,12,18,91,100,191
2017,7,12,19,78,106,184
2017,7,12,20,53,67,120
2017,7,12,21,21,47,68
2017,7,12,22,21,23,44
2017,7,12,23,19,16,35
2017,7,13,0,9,18,27
2017,7,13,1,8,11,19
2017,7,13,2,9,14,23
2017,7,13,3,14,15,29
2017,7,13,4,63,31,94
2017,7,13,5,129,79,208
2017,7,13,6,161,93,254
2017,7,13,7,127,118,245
2017,7,13,8,154,132,286
2017,7,13,9,156,135,291
2017,7,13,10,131,160,291
2017,7,13,11,171,173,344
2017,7,13,12,176,202,378
2017,7,13,13,157,217,374
2017,7,13,14,146,164,310
2017,7,13,15,107,155,262
2017,7,13,16,109,125,234
2017,7,13,17,84,101,185
2017,7,13,18,95,93,188
2017,7,13,19,88,86,174
2017,7,13,20,49,77,126
2017,7,13,21,43,57,100
2017,7,13,22,24,22,46
2017,7,13,23,15,34,49
2017,7,14,0,13,22,35
2017,7,14,1,9,24,33
2017,7,14,2,6,12,18
2017,7,14,3,5,12,17
2017,7,14,4,57,32,89
2017,7,14,5,107,75,182
2017,7,14,6,143,83,226
2017,7,14,7,144,117,261
2017,7,14,8,146,113,259
2017,7,14,9,187,116,303
2017,7,14,10,164,184,348
2017,7,14,11,158,153,311
2017,7,14,12,163,169,332
2017,7,14,13,125,237,362
2017,7,14,14,127,161,288
2017,7,14,15,106,122,228
2017,7,14,16,89,104,193
2017,7,14,17,84,116,200
2017,7,14,18,83,97,180
2017,7,14,19,71,89,160
2017,7,14,20,50,71,121
2017,7,14,21,32,54,86
2017,7,14,22,19,42,61
2017,7,14,23,18,27,45
2017,7,15,0,12,26,38
2017,7,15,1,8,24,32
2017,7,15,2,8,13,21
2017,7,15,3,4,9,13
2017,7,15,4,14,14,28
2017,7,15,5,20,21,41
2017,7,15,6,27,32,59
2017,7,15,7,37,34,71
2017,7,15,8,64,64,128
2017,7,15,9,89,84,173
2017,7,15,10,94,109,203
2017,7,15,11,86,119,205
2017,7,15,12,111,134,245
2017,7,15,13,115,111,226
2017,7,15,14,102,113,215
2017,7,15,15,99,115,214
2017,7,15,16,86,106,192
2017,7,15,17,71,108,179
2017,7,15,18,67,86,153
2017,7,15,19,47,64,111
2017,7,15,20,33,61,94
2017,7,15,21,35,42,77
2017,7,15,22,27,41,68
2017,7,15,23,15,37,52
2017,7,16,0,13,44,57
2017,7,16,1,21,42,63
2017,7,16,2,9,21,30
2017,7,16,3,12,11,23
2017,7,16,4,16,9,25
2017,7,16,5,18,16,34
2017,7,16,6,17,23,40
2017,7,16,7,38,31,69
2017,7,16,8,50,44,94
2017,7,16,9,56,55,111
2017,7,16,10,85,100,185
2017,7,16,11,98,117,215
2017,7,16,12,117,144,261
2017,7,16,13,128,155,283
2017,7,16,14,109,142,251
2017,7,16,15,94,130,224
2017,7,16,16,90,119,209
2017,7,16,17,109,160,269
2017,7,16,18,94,101,195
2017,7,16,19,72,86,158
2017,7,16,20,91,72,163
2017,7,16,21,25,41,66
2017,7,16,22,19,21,40
2017,7,16,23,19,18,37
2017,7,17,0,5,15,20
2017,7,17,1,2,11,13
2017,7,17,2,9,8,17
2017,7,17,3,11,9,20
2017,7,17,4,67,38,105
2017,7,17,5,103,87,190
2017,7,17,6,120,90,210
2017,7,17,7,127,97,224
2017,7,17,8,149,120,269
2017,7,17,9,141,118,259
2017,7,17,10,150,142,292
2017,7,17,11,146,150,296
2017,7,17,12,171,208,379
2017,7,17,13,138,221,359
2017,7,17,14,134,201,335
2017,7,17,15,117,127,244
2017,7,17,16,106,142,248
2017,7,17,17,78,103,181
2017,7,17,18,84,92,176
2017,7,17,19,64,68,132
2017,7,17,20,48,60,108
2017,7,17,21,35,47,82
2017,7,17,22,19,24,43
2017,7,17,23,9,15,24
2017,7,18,0,7,11,18
2017,7,18,1,3,7,10
2017,7,18,2,5,4,9
2017,7,18,3,17,8,25
2017,7,18,4,63,28,91
2017,7,18,5,106,87,193
2017,7,18,6,132,83,215
2017,7,18,7,135,111,246
2017,7,18,8,131,127,258
2017,7,18,9,140,139,279
2017,7,18,10,170,144,314
2017,7,18,11,159,170,329
2017,7,18,12,161,219,380
2017,7,18,13,142,216,358
2017,7,18,14,134,170,304
2017,7,18,15,122,158,280
2017,7,18,16,105,114,219
2017,7,18,17,92,101,193
2017,7,18,18,79,91,170
2017,7,18,19,65,99,164
2017,7,18,20,59,64,123
2017,7,18,21,39,50,89
2017,7,18,22,15,23,38
2017,7,18,23,14,13,27
2017,7,19,0,9,17,26
2017,7,19,1,6,16,22
2017,7,19,2,7,9,16
2017,7,19,3,16,8,24
2017,7,19,4,57,38,95
2017,7,19,5,107,75,182
2017,7,19,6,125,79,204
2017,7,19,7,117,109,226
2017,7,19,8,115,125,240
2017,7,19,9,144,112,256
2017,7,19,10,138,158,296
2017,7,19,11,134,159,293
2017,7,19,12,160,189,349
2017,7,19,13,155,190,345
2017,7,19,14,117,135,252
2017,7,19,15,99,124,223
2017,7,19,16,84,102,186
2017,7,19,17,84,82,166
2017,7,19,18,79,96,175
2017,7,19,19,52,81,133
2017,7,19,20,57,69,126
2017,7,19,21,43,59,102
2017,7,19,22,19,19,38
2017,7,19,23,21,27,48
2017,7,20,0,7,21,28
2017,7,20,1,9,11,20
2017,7,20,2,7,10,17
2017,7,20,3,17,11,28
2017,7,20,4,59,30,89
2017,7,20,5,103,77,180
2017,7,20,6,126,92,218
2017,7,20,7,141,113,254
2017,7,20,8,106,111,217
2017,7,20,9,120,131,251
2017,7,20,10,133,130,263
2017,7,20,11,122,140,262
2017,7,20,12,144,188,332
2017,7,20,13,149,173,322
2017,7,20,14,131,120,251
2017,7,20,15,92,117,209
2017,7,20,16,89,117,206
2017,7,20,17,86,83,169
2017,7,20,18,80,93,173
2017,7,20,19,79,94,173
2017,7,20,20,52,314,366
2017,7,20,21,43,295,338
2017,7,20,22,29,153,182
2017,7,20,23,10,92,102
2017,7,21,0,9,52,61
2017,7,21,1,7,32,39
2017,7,21,2,6,13,19
2017,7,21,3,8,10,18
2017,7,21,4,62,36,98
2017,7,21,5,98,73,171
2017,7,21,6,96,82,178
2017,7,21,7,131,94,225
2017,7,21,8,114,111,225
2017,7,21,9,131,123,254
2017,7,21,10,143,144,287
2017,7,21,11,158,137,295
2017,7,21,12,161,193,354
2017,7,21,13,134,209,343
2017,7,21,14,134,151,285
2017,7,21,15,110,114,224
2017,7,21,16,86,111,197
2017,7,21,17,95,107,202
2017,7,21,18,80,88,168
2017,7,21,19,57,66,123
2017,7,21,20,57,71,128
2017,7,21,21,38,41,79
2017,7,21,22,21,42,63
2017,7,21,23,12,32,44
2017,7,22,0,17,27,44
2017,7,22,1,14,31,45
2017,7,22,2,11,15,26
2017,7,22,3,7,13,20
2017,7,22,4,18,14,32
2017,7,22,5,22,25,47
2017,7,22,6,28,28,56
2017,7,22,7,39,37,76
2017,7,22,8,65,54,119
2017,7,22,9,70,86,156
2017,7,22,10,99,105,204
2017,7,22,11,90,75,165
2017,7,22,12,84,134,218
2017,7,22,13,95,116,211
2017,7,22,14,102,122,224
2017,7,22,15,98,100,198
2017,7,22,16,76,100,176
2017,7,22,17,80,80,160
2017,7,22,18,63,78,141
2017,7,22,19,53,65,118
2017,7,22,20,38,58,96
2017,7,22,21,30,64,94
2017,7,22,22,26,46,72
2017,7,22,23,11,25,36
2017,7,23,0,22,37,59
2017,7,23,1,17,39,56
2017,7,23,2,15,28,43
2017,7,23,3,10,14,24
2017,7,23,4,10,15,25
2017,7,23,5,12,15,27
2017,7,23,6,26,9,35
2017,7,23,7,27,44,71
2017,7,23,8,70,56,126
2017,7,23,9,77,71,148
2017,7,23,10,88,110,198
2017,7,23,11,90,103,193
2017,7,23,12,114,124,238
2017,7,23,13,114,121,235
2017,7,23,14,107,167,274
2017,7,23,15,102,123,225
2017,7,23,16,106,112,218
2017,7,23,17,78,85,163
2017,7,23,18,119,135,254
2017,7,23,19,93,121,214
2017,7,23,20,69,90,159
2017,7,23,21,38,56,94
2017,7,23,22,20,32,52
2017,7,23,23,18,23,41
2017,7,24,0,6,18,24
2017,7,24,1,12,14,26
2017,7,24,2,15,14,29
2017,7,24,3,9,16,25
2017,7,24,4,75,38,113
2017,7,24,5,113,93,206
2017,7,24,6,140,80,220
2017,7,24,7,147,116,263
2017,7,24,8,132,126,258
2017,7,24,9,149,128,277
2017,7,24,10,153,158,311
2017,7,24,11,158,174,332
2017,7,24,12,181,208,389
2017,7,24,13,137,198,335
2017,7,24,14,152,165,317
2017,7,24,15,107,169,276
2017,7,24,16,112,116,228
2017,7,24,17,104,129,233
2017,7,24,18,80,93,173
2017,7,24,19,54,81,135
2017,7,24,20,48,67,115
2017,7,24,21,35,45,80
2017,7,24,22,19,25,44
2017,7,24,23,12,13,25
2017,7,25,0,4,14,18
2017,7,25,1,7,11,18
2017,7,25,2,12,8,20
2017,7,25,3,8,12,20
2017,7,25,4,68,30,98
2017,7,25,5,106,71,177
2017,7,25,6,121,85,206
2017,7,25,7,143,104,247
2017,7,25,8,133,111,244
2017,7,25,9,160,143,303
2017,7,25,10,136,141,277
2017,7,25,11,127,178,305
2017,7,25,12,147,193,340
2017,7,25,13,140,204,344
2017,7,25,14,138,171,309
2017,7,25,15,115,146,261
2017,7,25,16,109,111,220
2017,7,25,17,82,105,187
2017,7,25,18,87,104,191
2017,7,25,19,71,92,163
2017,7,25,20,51,73,124
2017,7,25,21,27,39,66
2017,7,25,22,16,24,40
2017,7,25,23,12,23,35
2017,7,26,0,8,12,20
2017,7,26,1,5,9,14
2017,7,26,2,11,15,26
2017,7,26,3,6,15,21
2017,7,26,4,63,29,92
2017,7,26,5,127,78,205
2017,7,26,6,139,83,222
2017,7,26,7,116,102,218
2017,7,26,8,135,103,238
2017,7,26,9,138,136,274
2017,7,26,10,169,163,332
2017,7,26,11,158,179,337
2017,7,26,12,165,202,367
2017,7,26,13,141,236,377
2017,7,26,14,158,185,343
2017,7,26,15,128,153,281
2017,7,26,16,131,129,260
2017,7,26,17,100,117,217
2017,7,26,18,82,107,189
2017,7,26,19,55,90,145
2017,7,26,20,55,57,112
2017,7,26,21,36,39,75
2017,7,26,22,22,32,54
2017,7,26,23,12,25,37
2017,7,27,0,10,26,36
2017,7,27,1,8,6,14
2017,7,27,2,8,16,24
2017,7,27,3,13,17,30
2017,7,27,4,62,31,93
2017,7,27,5,122,92,214
2017,7,27,6,146,92,238
2017,7,27,7,123,90,213
2017,7,27,8,139,105,244
2017,7,27,9,146,121,267
2017,7,27,10,181,161,342
2017,7,27,11,150,158,308
2017,7,27,12,162,193,355
2017,7,27,13,166,248,414
2017,7,27,14,145,224,369
2017,7,27,15,119,156,275
2017,7,27,16,130,132,262
2017,7,27,17,106,133,239
2017,7,27,18,89,103,192
2017,7,27,19,73,89,162
2017,7,27,20,63,71,134
2017,7,27,21,39,71,110
2017,7,27,22,37,80,117
2017,7,27,23,12,37,49
2017,7,28,0,9,20,29
2017,7,28,1,8,16,24
2017,7,28,2,15,18,33
2017,7,28,3,15,18,33
2017,7,28,4,68,28,96
2017,7,28,5,134,87,221
2017,7,28,6,118,88,206
2017,7,28,7,122,102,224
2017,7,28,8,128,113,241
2017,7,28,9,174,139,313
2017,7,28,10,187,143,330
2017,7,28,11,156,167,323
2017,7,28,12,163,203,366
2017,7,28,13,172,227,399
2017,7,28,14,151,168,319
2017,7,28,15,127,158,285
2017,7,28,16,117,105,222
2017,7,28,17,115,103,218
2017,7,28,18,69,95,164
2017,7,28,19,63,73,136
2017,7,28,20,54,66,120
2017,7,28,21,33,49,82
2017,7,28,22,21,41,62
2017,7,28,23,12,23,35
2017,7,29,0,15,22,37
2017,7,29,1,8,25,33
2017,7,29,2,11,24,35
2017,7,29,3,10,7,17
2017,7,29,4,15,9,24
2017,7,29,5,24,26,50
2017,7,29,6,30,29,59
2017,7,29,7,40,46,86
2017,7,29,8,70,61,131
2017,7,29,9,110,100,210
2017,7,29,10,106,105,211
2017,7,29,11,133,129,262
2017,7,29,12,96,109,205
2017,7,29,13,105,143,248
2017,7,29,14,91,124,215
2017,7,29,15,88,107,195
2017,7,29,16,112,117,229
2017,7,29,17,86,118,204
2017,7,29,18,60,73,133
2017,7,29,19,52,70,122
2017,7,29,20,53,69,122
2017,7,29,21,40,56,96
2017,7,29,22,20,53,73
2017,7,29,23,22,43,65
2017,7,30,0,15,22,37
2017,7,30,1,18,47,65
2017,7,30,2,21,31,52
2017,7,30,3,11,14,25
2017,7,30,4,17,12,29
2017,7,30,5,16,11,27
2017,7,30,6,35,17,52
2017,7,30,7,30,41,71
2017,7,30,8,76,58,134
2017,7,30,9,74,67,141
2017,7,30,10,108,119,227
2017,7,30,11,109,123,232
2017,7,30,12,114,142,256
2017,7,30,13,125,161,286
2017,7,30,14,134,187,321
2017,7,30,15,144,153,297
2017,7,30,16,120,116,236
2017,7,30,17,93,123,216
2017,7,30,18,97,130,227
2017,7,30,19,80,101,181
2017,7,30,20,54,75,129
2017,7,30,21,46,43,89
2017,7,30,22,17,25,42
2017,7,30,23,13,17,30
2017,7,31,0,10,13,23
2017,7,31,1,5,16,21
2017,7,31,2,8,10,18
2017,7,31,3,13,7,20
2017,7,31,4,77,27,104
2017,7,31,5,164,100,264
2017,7,31,6,194,138,332
2017,7,31,7,203,154,357
2017,7,31,8,149,127,276
2017,7,31,9,190,143,333
2017,7,31,10,190,202,392
2017,7,31,11,184,197,381
2017,7,31,12,187,252,439
2017,7,31,13,198,271,469
2017,7,31,14,174,219,393
2017,7,31,15,162,190,352
2017,7,31,16,119,147,266
2017,7,31,17,104,108,212
2017,7,31,18,86,100,186
2017,7,31,19,74,81,155
2017,7,31,20,66,81,147
2017,7,31,21,58,49,107
2017,7,31,22,17,29,46
2017,7,31,23,14,16,30
2017,8,1,0,7,4,11
2017,8,1,1,6,15,21
2017,8,1,2,5,11,16
2017,8,1,3,12,10,22
2017,8,1,4,86,33,119
2017,8,1,5,174,105,279
2017,8,1,6,192,134,326
2017,8,1,7,154,115,269
2017,8,1,8,171,151,322
2017,8,1,9,164,151,315
2017,8,1,10,188,175,363
2017,8,1,11,212,188,400
2017,8,1,12,180,272,452
2017,8,1,13,165,262,427
2017,8,1,14,196,238,434
2017,8,1,15,150,180,330
2017,8,1,16,137,144,281
2017,8,1,17,114,162,276
2017,8,1,18,104,147,251
2017,8,1,19,72,115,187
2017,8,1,20,71,85,156
2017,8,1,21,45,51,96
2017,8,1,22,24,18,42
2017,8,1,23,11,21,32
2017,8,2,0,6,14,20
2017,8,2,1,11,12,23
2017,8,2,2,10,12,22
2017,8,2,3,11,12,23
2017,8,2,4,84,33,117
2017,8,2,5,147,112,259
2017,8,2,6,189,99,288
2017,8,2,7,163,123,286
2017,8,2,8,169,139,308
2017,8,2,9,181,156,337
2017,8,2,10,205,169,374
2017,8,2,11,188,176,364
2017,8,2,12,166,232,398
2017,8,2,13,169,318,487
2017,8,2,14,170,232,402
2017,8,2,15,136,181,317
2017,8,2,16,121,137,258
2017,8,2,17,115,136,251
2017,8,2,18,95,109,204
2017,8,2,19,74,104,178
2017,8,2,20,58,71,129
2017,8,2,21,33,45,78
2017,8,2,22,24,16,40
2017,8,2,23,14,13,27
2017,8,3,0,8,9,17
2017,8,3,1,6,15,21
2017,8,3,2,5,8,13
2017,8,3,3,15,10,25
2017,8,3,4,74,32,106
2017,8,3,5,144,88,232
2017,8,3,6,186,109,295
2017,8,3,7,186,151,337
2017,8,3,8,152,120,272
2017,8,3,9,210,149,359
2017,8,3,10,171,199,370
2017,8,3,11,208,198,406
2017,8,3,12,177,235,412
2017,8,3,13,187,259,446
2017,8,3,14,197,229,426
2017,8,3,15,132,162,294
2017,8,3,16,135,136,271
2017,8,3,17,113,127,240
2017,8,3,18,98,121,219
2017,8,3,19,70,94,164
2017,8,3,20,68,66,134
2017,8,3,21,41,38,79
2017,8,3,22,18,30,48
2017,8,3,23,23,22,45
2017,8,4,0,11,22,33
2017,8,4,1,7,23,30
2017,8,4,2,4,15,19
2017,8,4,3,16,6,22
2017,8,4,4,66,30,96
2017,8,4,5,174,100,274
2017,8,4,6,189,122,311
2017,8,4,7,186,114,300
2017,8,4,8,187,139,326
2017,8,4,9,204,181,385
2017,8,4,10,195,194,389
2017,8,4,11,201,201,402
2017,8,4,12,192,233,425
2017,8,4,13,208,298,506
2017,8,4,14,165,206,371
2017,8,4,15,159,172,331
2017,8,4,16,120,130,250
2017,8,4,17,109,117,226
2017,8,4,18,76,102,178
2017,8,4,19,65,84,149
2017,8,4,20,69,60,129
2017,8,4,21,42,59,101
2017,8,4,22,29,37,66
2017,8,4,23,28,35,63
2017,8,5,0,18,30,48
2017,8,5,1,18,49,67
2017,8,5,2,15,27,42
2017,8,5,3,12,18,30
2017,8,5,4,25,14,39
2017,8,5,5,27,21,48
2017,8,5,6,41,38,79
2017,8,5,7,50,53,103
2017,8,5,8,83,64,147
2017,8,5,9,110,103,213
2017,8,5,10,165,115,280
2017,8,5,11,130,130,260
2017,8,5,12,139,164,303
2017,8,5,13,139,161,300
2017,8,5,14,132,192,324
2017,8,5,15,90,153,243
2017,8,5,16,116,119,235
2017,8,5,17,86,127,213
2017,8,5,18,85,88,173
2017,8,5,19,73,70,143
2017,8,5,20,58,78,136
2017,8,5,21,41,47,88
2017,8,5,22,39,46,85
2017,8,5,23,25,31,56
2017,8,6,0,27,41,68
2017,8,6,1,22,62,84
2017,8,6,2,22,46,68
2017,8,6,3,11,18,29
2017,8,6,4,12,5,17
2017,8,6,5,16,16,32
2017,8,6,6,33,20,53
2017,8,6,7,57,42,99
2017,8,6,8,73,47,120
2017,8,6,9,79,67,146
2017,8,6,10,142,118,260
2017,8,6,11,151,145,296
2017,8,6,12,161,161,322
2017,8,6,13,143,192,335
2017,8,6,14,134,192,326
2017,8,6,15,130,175,305
2017,8,6,16,142,150,292
2017,8,6,17,136,147,283
2017,8,6,18,105,133,238
2017,8,6,19,99,105,204
2017,8,6,20,62,89,151
2017,8,6,21,37,54,91
2017,8,6,22,18,25,43
2017,8,6,23,15,14,29
2017,8,7,0,7,9,16
2017,8,7,1,10,19,29
2017,8,7,2,8,9,17
2017,8,7,3,19,6,25
2017,8,7,4,109,53,162
2017,8,7,5,191,135,326
2017,8,7,6,273,148,421
2017,8,7,7,229,162,391
2017,8,7,8,212,146,358
2017,8,7,9,190,179,369
2017,8,7,10,207,212,419
2017,8,7,11,196,196,392
2017,8,7,12,186,253,439
2017,8,7,13,221,350,571
2017,8,7,14,183,233,416
2017,8,7,15,171,181,352
2017,8,7,16,156,141,297
2017,8,7,17,119,123,242
2017,8,7,18,103,98,201
2017,8,7,19,91,138,229
2017,8,7,20,70,70,140
2017,8,7,21,38,37,75
2017,8,7,22,15,30,45
2017,8,7,23,16,19,35
2017,8,8,0,8,10,18
2017,8,8,1,1,6,7
2017,8,8,2,7,7,14
2017,8,8,3,14,17,31
2017,8,8,4,111,44,155
2017,8,8,5,216,133,349
2017,8,8,6,294,144,438
2017,8,8,7,211,156,367
2017,8,8,8,207,170,377
2017,8,8,9,213,181,394
2017,8,8,10,205,173,378
2017,8,8,11,220,224,444
2017,8,8,12,239,274,513
2017,8,8,13,226,356,582
2017,8,8,14,209,251,460
2017,8,8,15,143,194,337
2017,8,8,16,159,156,315
2017,8,8,17,133,159,292
2017,8,8,18,117,136,253
2017,8,8,19,102,119,221
2017,8,8,20,61,307,368
2017,8,8,21,44,226,270
2017,8,8,22,18,78,96
2017,8,8,23,18,27,45
2017,8,9,0,21,22,43
2017,8,9,1,14,12,26
2017,8,9,2,5,8,13
2017,8,9,3,17,15,32
2017,8,9,4,98,51,149
2017,8,9,5,216,138,354
2017,8,9,6,280,162,442
2017,8,9,7,245,174,419
2017,8,9,8,188,159,347
2017,8,9,9,186,182,368
2017,8,9,10,207,197,404
2017,8,9,11,215,217,432
2017,8,9,12,219,261,480
2017,8,9,13,228,334,562
2017,8,9,14,211,286,497
2017,8,9,15,153,182,335
2017,8,9,16,149,149,298
2017,8,9,17,111,132,243
2017,8,9,18,105,118,223
2017,8,9,19,105,124,229
2017,8,9,20,67,88,155
2017,8,9,21,46,47,93
2017,8,9,22,20,26,46
2017,8,9,23,13,20,33
2017,8,10,0,10,15,25
2017,8,10,1,3,17,20
2017,8,10,2,8,6,14
2017,8,10,3,14,10,24
2017,8,10,4,97,47,144
2017,8,10,5,227,126,353
2017,8,10,6,258,173,431
2017,8,10,7,225,133,358
2017,8,10,8,180,152,332
2017,8,10,9,189,173,362
2017,8,10,10,197,199,396
2017,8,10,11,218,201,419
2017,8,10,12,204,259,463
2017,8,10,13,232,329,561
2017,8,10,14,222,274,496
2017,8,10,15,146,219,365
2017,8,10,16,145,138,283
2017,8,10,17,121,142,263
2017,8,10,18,116,141,257
2017,8,10,19,99,97,196
2017,8,10,20,71,87,158
2017,8,10,21,48,54,102
2017,8,10,22,23,30,53
2017,8,10,23,15,19,34
2017,8,11,0,13,21,34
2017,8,11,1,23,23,46
2017,8,11,2,10,24,34
2017,8,11,3,16,11,27
2017,8,11,4,127,57,184
2017,8,11,5,203,113,316
2017,8,11,6,269,141,410
2017,8,11,7,236,149,385
2017,8,11,8,188,161,349
2017,8,11,9,222,193,415
2017,8,11,10,218,195,413
2017,8,11,11,230,228,458
2017,8,11,12,276,309,585
2017,8,11,13,268,433,701
2017,8,11,14,338,373,711
2017,8,11,15,163,221,384
2017,8,11,16,138,166,304
2017,8,11,17,144,130,274
2017,8,11,18,121,122,243
2017,8,11,19,94,98,192
2017,8,11,20,80,92,172
2017,8,11,21,58,74,132
2017,8,11,22,29,43,72
2017,8,11,23,29,40,69
2017,8,12,0,20,25,45
2017,8,12,1,16,34,50
2017,8,12,2,9,20,29
2017,8,12,3,12,16,28
2017,8,12,4,19,18,37
2017,8,12,5,27,29,56
2017,8,12,6,24,35,59
2017,8,12,7,76,57,133
2017,8,12,8,97,67,164
2017,8,12,9,112,98,210
2017,8,12,10,162,149,311
2017,8,12,11,169,171,340
2017,8,12,12,169,170,339
2017,8,12,13,173,157,330
2017,8,12,14,174,210,384
2017,8,12,15,135,177,312
2017,8,12,16,119,168,287
2017,8,12,17,108,126,234
2017,8,12,18,103,109,212
2017,8,12,19,84,118,202
2017,8,12,20,59,74,133
2017,8,12,21,36,65,101
2017,8,12,22,36,63,99
2017,8,12,23,20,46,66
2017,8,13,0,19,42,61
2017,8,13,1,24,43,67
2017,8,13,2,21,28,49
2017,8,13,3,20,21,41
2017,8,13,4,21,20,41
2017,8,13,5,15,11,26
2017,8,13,6,27,20,47
2017,8,13,7,54,52,106
2017,8,13,8,83,69,152
2017,8,13,9,93,86,179
2017,8,13,10,136,147,283
2017,8,13,11,145,165,310
2017,8,13,12,181,193,374
2017,8,13,13,177,202,379
2017,8,13,14,152,231,383
2017,8,13,15,169,200,369
2017,8,13,16,160,164,324
2017,8,13,17,148,155,303
2017,8,13,18,173,172,345
2017,8,13,19,96,117,213
2017,8,13,20,67,93,160
2017,8,13,21,35,35,70
2017,8,13,22,22,24,46
2017,8,13,23,18,29,47
2017,8,14,0,8,10,18
2017,8,14,1,10,19,29
2017,8,14,2,7,11,18
2017,8,14,3,14,8,22
2017,8,14,4,120,68,188
2017,8,14,5,242,150,392
2017,8,14,6,362,191,553
2017,8,14,7,259,212,471
2017,8,14,8,221,177,398
2017,8,14,9,219,170,389
2017,8,14,10,215,173,388
2017,8,14,11,218,220,438
2017,8,14,12,237,298,535
2017,8,14,13,260,397,657
2017,8,14,14,225,315,540
2017,8,14,15,153,182,335
2017,8,14,16,167,140,307
2017,8,14,17,145,176,321
2017,8,14,18,99,147,246
2017,8,14,19,101,125,226
2017,8,14,20,78,70,148
2017,8,14,21,45,55,100
2017,8,14,22,29,27,56
2017,8,14,23,19,34,53
2017,8,15,0,12,28,40
2017,8,15,1,15,19,34
2017,8,15,2,3,11,14
2017,8,15,3,19,8,27
2017,8,15,4,140,57,197
2017,8,15,5,252,145,397
2017,8,15,6,324,162,486
2017,8,15,7,256,183,439
2017,8,15,8,221,161,382
2017,8,15,9,248,220,468
2017,8,15,10,251,230,481
2017,8,15,11,215,211,426
2017,8,15,12,220,295,515
2017,8,15,13,248,350,598
2017,8,15,14,223,305,528
2017,8,15,15,141,203,344
2017,8,15,16,166,152,318
2017,8,15,17,135,160,295
2017,8,15,18,123,159,282
2017,8,15,19,96,130,226
2017,8,15,20,52,103,155
2017,8,15,21,47,53,100
2017,8,15,22,25,26,51
2017,8,15,23,18,38,56
2017,8,16,0,15,39,54
2017,8,16,1,9,26,35
2017,8,16,2,9,10,19
2017,8,16,3,17,12,29
2017,8,16,4,123,56,179
2017,8,16,5,238,128,366
2017,8,16,6,335,180,515
2017,8,16,7,263,152,415
2017,8,16,8,206,197,403
2017,8,16,9,226,197,423
2017,8,16,10,209,199,408
2017,8,16,11,217,230,447
2017,8,16,12,237,290,527
2017,8,16,13,254,341,595
2017,8,16,14,195,283,478
2017,8,16,15,151,188,339
2017,8,16,16,160,157,317
2017,8,16,17,123,169,292
2017,8,16,18,120,150,270
2017,8,16,19,96,150,246
2017,8,16,20,71,79,150
2017,8,16,21,41,43,84
2017,8,16,22,23,30,53
2017,8,16,23,12,39,51
2017,8,17,0,17,36,53
2017,8,17,1,6,27,33
2017,8,17,2,11,14,25
2017,8,17,3,14,10,24
2017,8,17,4,136,46,182
2017,8,17,5,205,145,350
2017,8,17,6,375,189,564
2017,8,17,7,255,159,414
2017,8,17,8,221,220,441
2017,8,17,9,219,191,410
2017,8,17,10,257,208,465
2017,8,17,11,196,218,414
2017,8,17,12,241,303,544
2017,8,17,13,244,380,624
2017,8,17,14,211,275,486
2017,8,17,15,177,188,365
2017,8,17,16,144,155,299
2017,8,17,17,147,158,305
2017,8,17,18,143,161,304
2017,8,17,19,83,114,197
2017,8,17,20,68,82,150
2017,8,17,21,43,63,106
2017,8,17,22,29,34,63
2017,8,17,23,19,34,53
2017,8,18,0,13,32,45
2017,8,18,1,9,36,45
2017,8,18,2,7,18,25
2017,8,18,3,15,11,26
2017,8,18,4,118,53,171
2017,8,18,5,238,142,380
2017,8,18,6,338,182,520
2017,8,18,7,227,153,380
2017,8,18,8,218,183,401
2017,8,18,9,203,223,426
2017,8,18,10,237,232,469
2017,8,18,11,227,219,446
2017,8,18,12,206,316,522
2017,8,18,13,278,353,631
2017,8,18,14,224,268,492
2017,8,18,15,166,209,375
2017,8,18,16,197,174,371
2017,8,18,17,139,165,304
2017,8,18,18,95,134,229
2017,8,18,19,71,94,165
2017,8,18,20,66,80,146
2017,8,18,21,48,60,108
2017,8,18,22,31,56,87
2017,8,18,23,44,53,97
2017,8,19,0,23,44,67
2017,8,19,1,20,42,62
2017,8,19,2,13,31,44
2017,8,19,3,11,16,27
2017,8,19,4,29,20,49
2017,8,19,5,37,27,64
2017,8,19,6,35,43,78
2017,8,19,7,76,62,138
2017,8,19,8,125,84,209
2017,8,19,9,129,111,240
2017,8,19,10,158,123,281
2017,8,19,11,163,147,310
2017,8,19,12,181,165,346
2017,8,19,13,150,196,346
2017,8,19,14,154,192,346
2017,8,19,15,126,168,294
2017,8,19,16,143,151,294
2017,8,19,17,123,136,259
2017,8,19,18,108,112,220
2017,8,19,19,71,109,180
2017,8,19,20,58,56,114
2017,8,19,21,61,95,156
2017,8,19,22,45,86,131
2017,8,19,23,47,69,116
2017,8,20,0,22,46,68
2017,8,20,1,22,37,59
2017,8,20,2,27,44,71
2017,8,20,3,11,16,27
2017,8,20,4,19,8,27
2017,8,20,5,19,22,41
2017,8,20,6,33,21,54
2017,8,20,7,38,48,86
2017,8,20,8,88,78,166
2017,8,20,9,121,95,216
2017,8,20,10,123,136,259
2017,8,20,11,161,180,341
2017,8,20,12,185,195,380
2017,8,20,13,160,205,365
2017,8,20,14,137,205,342
2017,8,20,15,179,167,346
2017,8,20,16,159,151,310
2017,8,20,17,181,181,362
2017,8,20,18,152,175,327
2017,8,20,19,98,107,205
2017,8,20,20,63,97,160
2017,8,20,21,27,48,75
2017,8,20,22,19,24,43
2017,8,20,23,14,19,33
2017,8,21,0,8,7,15
2017,8,21,1,4,6,10
2017,8,21,2,8,6,14
2017,8,21,3,14,13,27
2017,8,21,4,135,55,190
2017,8,21,5,260,164,424
2017,8,21,6,425,216,641
2017,8,21,7,264,180,444
2017,8,21,8,220,178,398
2017,8,21,9,194,168,362
2017,8,21,10,226,200,426
2017,8,21,11,242,224,466
2017,8,21,12,237,327,564
2017,8,21,13,234,360,594
2017,8,21,14,224,301,525
2017,8,21,15,174,211,385
2017,8,21,16,198,165,363
2017,8,21,17,139,141,280
2017,8,21,18,112,130,242
2017,8,21,19,99,142,241
2017,8,21,20,39,83,122
2017,8,21,21,35,48,83
2017,8,21,22,14,27,41
2017,8,21,23,10,14,24
2017,8,22,0,4,9,13
2017,8,22,1,7,9,16
2017,8,22,2,4,9,13
2017,8,22,3,16,12,28
2017,8,22,4,122,52,174
2017,8,22,5,273,168,441
2017,8,22,6,410,191,601
2017,8,22,7,262,172,434
2017,8,22,8,210,196,406
2017,8,22,9,222,228,450
2017,8,22,10,200,219,419
2017,8,22,11,247,209,456
2017,8,22,12,210,324,534
2017,8,22,13,294,368,662
2017,8,22,14,223,309,532
2017,8,22,15,166,208,374
2017,8,22,16,177,186,363
2017,8,22,17,130,157,287
2017,8,22,18,140,165,305
2017,8,22,19,95,143,238
2017,8,22,20,56,91,147
2017,8,22,21,38,40,78
2017,8,22,22,23,35,58
2017,8,22,23,11,22,33
2017,8,23,0,9,30,39
2017,8,23,1,8,12,20
2017,8,23,2,4,19,23
2017,8,23,3,15,15,30
2017,8,23,4,126,48,174
2017,8,23,5,246,154,400
2017,8,23,6,412,209,621
2017,8,23,7,243,175,418
2017,8,23,8,225,184,409
2017,8,23,9,227,226,453
2017,8,23,10,231,189,420
2017,8,23,11,227,196,423
2017,8,23,12,235,268,503
2017,8,23,13,280,378,658
2017,8,23,14,229,300,529
2017,8,23,15,161,211,372
2017,8,23,16,155,158,313
2017,8,23,17,124,147,271
2017,8,23,18,121,138,259
2017,8,23,19,95,144,239
2017,8,23,20,86,81,167
2017,8,23,21,40,45,85
2017,8,23,22,16,30,46
2017,8,23,23,8,25,33
2017,8,24,0,8,17,25
2017,8,24,1,11,16,27
2017,8,24,2,13,20,33
2017,8,24,3,14,12,26
2017,8,24,4,115,50,165
2017,8,24,5,264,147,411
2017,8,24,6,384,208,592
2017,8,24,7,226,178,404
2017,8,24,8,214,164,378
2017,8,24,9,215,184,399
2017,8,24,10,208,208,416
2017,8,24,11,192,228,420
2017,8,24,12,237,260,497
2017,8,24,13,260,369,629
2017,8,24,14,212,284,496
2017,8,24,15,183,209,392
2017,8,24,16,192,153,345
2017,8,24,17,144,211,355
2017,8,24,18,101,162,263
2017,8,24,19,86,135,221
2017,8,24,20,83,67,150
2017,8,24,21,41,53,94
2017,8,24,22,27,37,64
2017,8,24,23,16,77,93
2017,8,25,0,14,69,83
2017,8,25,1,9,51,60
2017,8,25,2,9,19,28
2017,8,25,3,14,14,28
2017,8,25,4,116,53,169
2017,8,25,5,241,129,370
2017,8,25,6,370,202,572
2017,8,25,7,244,189,433
2017,8,25,8,221,174,395
2017,8,25,9,238,200,438
2017,8,25,10,228,230,458
2017,8,25,11,214,268,482
2017,8,25,12,229,336,565
2017,8,25,13,274,406,680
2017,8,25,14,200,282,482
2017,8,25,15,140,179,319
2017,8,25,16,148,152,300
2017,8,25,17,112,141,253
2017,8,25,18,110,119,229
2017,8,25,19,84,123,207
2017,8,25,20,49,91,140
2017,8,25,21,60,81,141
2017,8,25,22,29,57,86
2017,8,25,23,24,41,65
2017,8,26,0,23,32,55
2017,8,26,1,16,38,54
2017,8,26,2,11,28,39
2017,8,26,3,8,15,23
2017,8,26,4,27,16,43
2017,8,26,5,32,22,54
2017,8,26,6,33,35,68
2017,8,26,7,63,65,128
2017,8,26,8,126,92,218
2017,8,26,9,149,131,280
2017,8,26,10,138,120,258
2017,8,26,11,161,147,308
2017,8,26,12,150,153,303
2017,8,26,13,129,197,326
2017,8,26,14,158,162,320
2017,8,26,15,138,171,309
2017,8,26,16,128,140,268
2017,8,26,17,96,99,195
2017,8,26,18,87,111,198
2017,8,26,19,62,131,193
2017,8,26,20,53,62,115
2017,8,26,21,39,78,117
2017,8,26,22,38,52,90
2017,8,26,23,33,53,86
2017,8,27,0,36,54,90
2017,8,27,1,29,49,78
2017,8,27,2,16,51,67
2017,8,27,3,13,17,30
2017,8,27,4,19,16,35
2017,8,27,5,16,35,51
2017,8,27,6,35,25,60
2017,8,27,7,64,54,118
2017,8,27,8,90,77,167
2017,8,27,9,98,78,176
2017,8,27,10,112,117,229
2017,8,27,11,134,162,296
2017,8,27,12,145,160,305
2017,8,27,13,162,183,345
2017,8,27,14,136,191,327
2017,8,27,15,179,185,364
2017,8,27,16,175,152,327
2017,8,27,17,162,175,337
2017,8,27,18,128,173,301
2017,8,27,19,94,138,232
2017,8,27,20,62,88,150
2017,8,27,21,28,54,82
2017,8,27,22,22,20,42
2017,8,27,23,15,20,35
2017,8,28,0,4,14,18
2017,8,28,1,8,11,19
2017,8,28,2,4,7,11
2017,8,28,3,9,15,24
2017,8,28,4,109,51,160
2017,8,28,5,248,139,387
2017,8,28,6,399,182,581
2017,8,28,7,270,161,431
2017,8,28,8,252,180,432
2017,8,28,9,247,201,448
2017,8,28,10,184,227,411
2017,8,28,11,231,220,451
2017,8,28,12,223,282,505
2017,8,28,13,224,369,593
2017,8,28,14,226,301,527
2017,8,28,15,185,201,386
2017,8,28,16,163,148,311
2017,8,28,17,153,165,318
2017,8,28,18,102,125,227
2017,8,28,19,89,127,216
2017,8,28,20,57,72,129
2017,8,28,21,31,27,58
2017,8,28,22,11,14,25
2017,8,28,23,4,14,18
2017,8,29,0,7,12,19
2017,8,29,1,5,14,19
2017,8,29,2,4,8,12
2017,8,29,3,16,9,25
2017,8,29,4,110,54,164
2017,8,29,5,250,139,389
2017,8,29,6,405,191,596
2017,8,29,7,241,178,419
2017,8,29,8,225,178,403
2017,8,29,9,217,191,408
2017,8,29,10,211,201,412
2017,8,29,11,238,239,477
2017,8,29,12,237,263,500
2017,8,29,13,234,351,585
2017,8,29,14,229,263,492
2017,8,29,15,175,197,372
2017,8,29,16,215,180,395
2017,8,29,17,161,177,338
2017,8,29,18,131,164,295
2017,8,29,19,84,129,213
2017,8,29,20,57,100,157
2017,8,29,21,28,45,73
2017,8,29,22,13,22,35
2017,8,29,23,16,23,39
2017,8,30,0,5,16,21
2017,8,30,1,9,11,20
2017,8,30,2,5,11,16
2017,8,30,3,18,14,32
2017,8,30,4,124,59,183
2017,8,30,5,240,147,387
2017,8,30,6,382,197,579
2017,8,30,7,238,164,402
2017,8,30,8,211,177,388
2017,8,30,9,190,179,369
2017,8,30,10,207,189,396
2017,8,30,11,210,208,418
2017,8,30,12,216,259,475
2017,8,30,13,233,424,657
2017,8,30,14,275,399,674
2017,8,30,15,239,232,471
2017,8,30,16,167,173,340
2017,8,30,17,124,152,276
2017,8,30,18,131,146,277
2017,8,30,19,81,104,185
2017,8,30,20,92,112,204
2017,8,30,21,32,55,87
2017,8,30,22,15,24,39
2017,8,30,23,8,22,30
2017,8,31,0,7,18,25
2017,8,31,1,4,17,21
2017,8,31,2,7,15,22
2017,8,31,3,17,18,35
2017,8,31,4,136,63,199
2017,8,31,5,215,155,370
2017,8,31,6,398,202,600
2017,8,31,7,247,183,430
2017,8,31,8,233,180,413
2017,8,31,9,262,185,447
2017,8,31,10,201,207,408
2017,8,31,11,250,226,476
2017,8,31,12,213,278,491
2017,8,31,13,253,328,581
2017,8,31,14,265,298,563
2017,8,31,15,193,224,417
2017,8,31,16,184,171,355
2017,8,31,17,166,171,337
2017,8,31,18,118,144,262
2017,8,31,19,84,123,207
2017,8,31,20,61,116,177
2017,8,31,21,39,60,99
2017,8,31,22,21,30,51
2017,8,31,23,13,23,36
2017,9,1,0,9,26,35
2017,9,1,1,13,17,30
2017,9,1,2,10,17,27
2017,9,1,3,13,15,28
2017,9,1,4,115,54,169
2017,9,1,5,239,151,390
2017,9,1,6,413,184,597
2017,9,1,7,261,198,459
2017,9,1,8,257,169,426
2017,9,1,9,277,223,500
2017,9,1,10,211,226,437
2017,9,1,11,211,236,447
2017,9,1,12,250,300,550
2017,9,1,13,275,365,640
2017,9,1,14,217,276,493
2017,9,1,15,135,169,304
2017,9,1,16,138,173,311
2017,9,1,17,125,139,264
2017,9,1,18,116,123,239
2017,9,1,19,84,89,173
2017,9,1,20,71,73,144
2017,9,1,21,49,66,115
2017,9,1,22,47,61,108
2017,9,1,23,25,36,61
2017,9,2,0,21,45,66
2017,9,2,1,18,31,49
2017,9,2,2,6,19,25
2017,9,2,3,9,9,18
2017,9,2,4,26,15,41
2017,9,2,5,26,17,43
2017,9,2,6,41,46,87
2017,9,2,7,60,58,118
2017,9,2,8,105,82,187
2017,9,2,9,133,110,243
2017,9,2,10,146,125,271
2017,9,2,11,144,160,304
2017,9,2,12,134,141,275
2017,9,2,13,141,164,305
2017,9,2,14,132,170,302
2017,9,2,15,110,143,253
2017,9,2,16,115,127,242
2017,9,2,17,108,120,228
2017,9,2,18,78,109,187
2017,9,2,19,61,85,146
2017,9,2,20,42,74,116
2017,9,2,21,38,60,98
2017,9,2,22,35,59,94
2017,9,2,23,30,46,76
2017,9,3,0,30,42,72
2017,9,3,1,18,48,66
2017,9,3,2,13,28,41
2017,9,3,3,13,18,31
2017,9,3,4,16,16,32
2017,9,3,5,16,14,30
2017,9,3,6,39,16,55
2017,9,3,7,41,48,89
2017,9,3,8,75,74,149
2017,9,3,9,107,92,199
2017,9,3,10,173,134,307
2017,9,3,11,140,169,309
2017,9,3,12,158,181,339
2017,9,3,13,142,198,340
2017,9,3,14,153,214,367
2017,9,3,15,141,213,354
2017,9,3,16,177,159,336
2017,9,3,17,179,180,359
2017,9,3,18,139,174,313
2017,9,3,19,99,156,255
2017,9,3,20,53,75,128
2017,9,3,21,36,41,77
2017,9,3,22,12,24,36
2017,9,3,23,9,16,25
2017,9,4,0,9,10,19
2017,9,4,1,7,17,24
2017,9,4,2,4,4,8
2017,9,4,3,19,11,30
2017,9,4,4,115,55,170
2017,9,4,5,233,146,379
2017,9,4,6,416,200,616
2017,9,4,7,243,164,407
2017,9,4,8,220,175,395
2017,9,4,9,218,206,424
2017,9,4,10,221,184,405
2017,9,4,11,216,238,454
2017,9,4,12,220,287,507
2017,9,4,13,254,440,694
2017,9,4,14,217,349,566
2017,9,4,15,161,199,360
2017,9,4,16,157,165,322
2017,9,4,17,138,167,305
2017,9,4,18,131,151,282
2017,9,4,19,99,139,238
2017,9,4,20,51,102,153
2017,9,4,21,25,36,61
2017,9,4,22,18,16,34
2017,9,4,23,10,13,23
2017,9,5,0,6,12,18
2017,9,5,1,5,17,22
2017,9,5,2,13,12,25
2017,9,5,3,19,8,27
2017,9,5,4,129,49,178
2017,9,5,5,262,172,434
2017,9,5,6,399,205,604
2017,9,5,7,262,175,437
2017,9,5,8,204,180,384
2017,9,5,9,193,192,385
2017,9,5,10,210,220,430
2017,9,5,11,219,231,450
2017,9,5,12,229,246,475
2017,9,5,13,256,342,598
2017,9,5,14,258,413,671
2017,9,5,15,200,221,421
2017,9,5,16,178,161,339
2017,9,5,17,130,150,280
2017,9,5,18,122,138,260
2017,9,5,19,82,113,195
2017,9,5,20,60,80,140
2017,9,5,21,32,30,62
2017,9,5,22,18,25,43
2017,9,5,23,15,18,33
2017,9,6,0,8,27,35
2017,9,6,1,3,27,30
2017,9,6,2,7,19,26
2017,9,6,3,11,24,35
2017,9,6,4,128,62,190
2017,9,6,5,267,145,412
2017,9,6,6,368,190,558
2017,9,6,7,280,173,453
2017,9,6,8,240,166,406
2017,9,6,9,222,191,413
2017,9,6,10,239,205,444
2017,9,6,11,209,232,441
2017,9,6,12,205,280,485
2017,9,6,13,267,335,602
2017,9,6,14,239,298,537
2017,9,6,15,176,213,389
2017,9,6,16,190,170,360
2017,9,6,17,148,153,301
2017,9,6,18,115,130,245
2017,9,6,19,98,146,244
2017,9,6,20,60,104,164
2017,9,6,21,23,64,87
2017,9,6,22,15,32,47
2017,9,6,23,10,23,33
2017,9,7,0,3,19,22
2017,9,7,1,6,16,22
2017,9,7,2,3,13,16
2017,9,7,3,16,14,30
2017,9,7,4,123,59,182
2017,9,7,5,231,156,387
2017,9,7,6,401,199,600
2017,9,7,7,215,176,391
2017,9,7,8,217,177,394
2017,9,7,9,211,186,397
2017,9,7,10,222,243,465
2017,9,7,11,200,206,406
2017,9,7,12,241,277,518
2017,9,7,13,269,336,605
2017,9,7,14,249,300,549
2017,9,7,15,186,219,405
2017,9,7,16,175,187,362
2017,9,7,17,143,167,310
2017,9,7,18,121,140,261
2017,9,7,19,99,124,223
2017,9,7,20,62,91,153
2017,9,7,21,37,56,93
2017,9,7,22,18,27,45
2017,9,7,23,9,33,42
2017,9,8,0,3,25,28
2017,9,8,1,7,25,32
2017,9,8,2,7,13,20
2017,9,8,3,15,13,28
2017,9,8,4,114,52,166
2017,9,8,5,262,148,410
2017,9,8,6,380,185,565
2017,9,8,7,266,199,465
2017,9,8,8,253,196,449
2017,9,8,9,252,208,460
2017,9,8,10,242,229,471
2017,9,8,11,223,248,471
2017,9,8,12,214,309,523
2017,9,8,13,254,359,613
2017,9,8,14,188,274,462
2017,9,8,15,159,178,337
2017,9,8,16,181,168,349
2017,9,8,17,146,136,282
2017,9,8,18,133,114,247
2017,9,8,19,67,95,162
2017,9,8,20,55,107,162
2017,9,8,21,55,73,128
2017,9,8,22,34,58,92
2017,9,8,23,25,41,66
2017,9,9,0,16,38,54
2017,9,9,1,21,46,67
2017,9,9,2,9,25,34
2017,9,9,3,10,18,28
2017,9,9,4,27,15,42
2017,9,9,5,34,23,57
2017,9,9,6,37,36,73
2017,9,9,7,76,62,138
2017,9,9,8,119,78,197
2017,9,9,9,156,114,270
2017,9,9,10,195,155,350
2017,9,9,11,180,158,338
2017,9,9,12,189,239,428
2017,9,9,13,165,197,362
2017,9,9,14,134,224,358
2017,9,9,15,126,209,335
2017,9,9,16,154,143,297
2017,9,9,17,110,162,272
2017,9,9,18,151,123,274
2017,9,9,19,63,81,144
2017,9,9,20,44,62,106
2017,9,9,21,51,70,121
2017,9,9,22,45,58,103
2017,9,9,23,34,57,91
2017,9,10,0,30,61,91
2017,9,10,1,22,47,69
2017,9,10,2,21,37,58
2017,9,10,3,14,17,31
2017,9,10,4,10,7,17
2017,9,10,5,23,20,43
2017,9,10,6,47,24,71
2017,9,10,7,72,48,120
2017,9,10,8,117,60,177
2017,9,10,9,119,115,234
2017,9,10,10,193,145,338
2017,9,10,11,167,186,353
2017,9,10,12,212,227,439
2017,9,10,13,206,238,444
2017,9,10,14,148,252,400
2017,9,10,15,149,195,344
2017,9,10,16,155,160,315
2017,9,10,17,152,187,339
2017,9,10,18,123,151,274
2017,9,10,19,92,130,222
2017,9,10,20,34,74,108
2017,9,10,21,31,53,84
2017,9,10,22,24,19,43
2017,9,10,23,8,16,24
2017,9,11,0,9,11,20
2017,9,11,1,6,9,15
2017,9,11,2,5,13,18
2017,9,11,3,11,10,21
2017,9,11,4,134,68,202
2017,9,11,5,240,133,373
2017,9,11,6,388,209,597
2017,9,11,7,285,154,439
2017,9,11,8,235,191,426
2017,9,11,9,235,200,435
2017,9,11,10,224,227,451
2017,9,11,11,225,207,432
2017,9,11,12,217,315,532
2017,9,11,13,240,354,594
2017,9,11,14,247,315,562
2017,9,11,15,212,209,421
2017,9,11,16,162,166,328
2017,9,11,17,159,162,321
2017,9,11,18,110,130,240
2017,9,11,19,85,103,188
2017,9,11,20,93,165,258
2017,9,11,21,60,104,164
2017,9,11,22,35,53,88
2017,9,11,23,19,39,58
2017,9,12,0,11,21,32
2017,9,12,1,4,12,16
2017,9,12,2,8,6,14
2017,9,12,3,18,9,27
2017,9,12,4,124,58,182
2017,9,12,5,277,158,435
2017,9,12,6,426,184,610
2017,9,12,7,262,199,461
2017,9,12,8,249,217,466
2017,9,12,9,204,225,429
2017,9,12,10,234,218,452
2017,9,12,11,207,215,422
2017,9,12,12,193,270,463
2017,9,12,13,254,339,593
2017,9,12,14,229,315,544
2017,9,12,15,182,175,357
2017,9,12,16,209,165,374
2017,9,12,17,150,158,308
2017,9,12,18,133,152,285
2017,9,12,19,76,102,178
2017,9,12,20,60,91,151
2017,9,12,21,36,122,158
2017,9,12,22,27,30,57
2017,9,12,23,17,19,36
2017,9,13,0,18,20,38
2017,9,13,1,10,18,28
2017,9,13,2,6,15,21
2017,9,13,3,12,13,25
2017,9,13,4,137,56,193
2017,9,13,5,254,148,402
2017,9,13,6,409,198,607
2017,9,13,7,260,158,418
2017,9,13,8,226,198,424
2017,9,13,9,202,185,387
2017,9,13,10,204,207,411
2017,9,13,11,198,249,447
2017,9,13,12,247,285,532
2017,9,13,13,238,329,567
2017,9,13,14,232,296,528
2017,9,13,15,208,228,436
2017,9,13,16,170,164,334
2017,9,13,17,161,179,340
2017,9,13,18,140,171,311
2017,9,13,19,84,110,194
2017,9,13,20,58,121,179
2017,9,13,21,34,152,186
2017,9,13,22,21,38,59
2017,9,13,23,14,15,29
2017,9,14,0,12,24,36
2017,9,14,1,17,22,39
2017,9,14,2,13,7,20
2017,9,14,3,20,21,41
2017,9,14,4,144,61,205
2017,9,14,5,266,133,399
2017,9,14,6,450,203,653
2017,9,14,7,284,189,473
2017,9,14,8,226,160,386
2017,9,14,9,245,186,431
2017,9,14,10,217,226,443
2017,9,14,11,249,222,471
2017,9,14,12,205,268,473
2017,9,14,13,254,328,582
2017,9,14,14,201,305,506
2017,9,14,15,190,228,418
2017,9,14,16,174,179,353
2017,9,14,17,161,172,333
2017,9,14,18,118,157,275
2017,9,14,19,98,121,219
2017,9,14,20,55,90,145
2017,9,14,21,35,41,76
2017,9,14,22,26,32,58
2017,9,14,23,9,27,36
2017,9,15,0,9,25,34
2017,9,15,1,16,28,44
2017,9,15,2,7,23,30
2017,9,15,3,19,13,32
2017,9,15,4,135,48,183
2017,9,15,5,259,143,402
2017,9,15,6,340,175,515
2017,9,15,7,233,170,403
2017,9,15,8,208,152,360
2017,9,15,9,225,174,399
2017,9,15,10,247,211,458
2017,9,15,11,197,224,421
2017,9,15,12,221,268,489
2017,9,15,13,219,273,492
2017,9,15,14,190,212,402
2017,9,15,15,138,151,289
2017,9,15,16,148,120,268
2017,9,15,17,142,109,251
2017,9,15,18,87,124,211
2017,9,15,19,76,90,166
2017,9,15,20,81,85,166
2017,9,15,21,45,54,99
2017,9,15,22,41,59,100
2017,9,15,23,24,57,81
2017,9,16,0,21,44,65
2017,9,16,1,16,39,55
2017,9,16,2,12,29,41
2017,9,16,3,15,16,31
2017,9,16,4,24,17,41
2017,9,16,5,36,22,58
2017,9,16,6,48,33,81
2017,9,16,7,138,43,181
2017,9,16,8,188,55,243
2017,9,16,9,231,74,305
2017,9,16,10,257,99,356
2017,9,16,11,233,101,334
2017,9,16,12,217,85,302
2017,9,16,13,143,86,229
2017,9,16,14,134,73,207
2017,9,16,15,120,80,200
2017,9,16,16,119,120,239
2017,9,16,17,116,82,198
2017,9,16,18,105,74,179
2017,9,16,19,63,53,116
2017,9,16,20,50,46,96
2017,9,16,21,49,54,103
2017,9,16,22,53,56,109
2017,9,16,23,31,48,79
2017,9,17,0,28,47,75
2017,9,17,1,25,42,67
2017,9,17,2,22,38,60
2017,9,17,3,12,31,43
2017,9,17,4,22,17,39
2017,9,17,5,23,15,38
2017,9,17,6,47,26,73
2017,9,17,7,63,47,110
2017,9,17,8,97,37,134
2017,9,17,9,113,48,161
2017,9,17,10,124,72,196
2017,9,17,11,138,89,227
2017,9,17,12,161,93,254
2017,9,17,13,162,117,279
2017,9,17,14,147,93,240
2017,9,17,15,146,100,246
2017,9,17,16,131,113,244
2017,9,17,17,177,111,288
2017,9,17,18,135,108,243
2017,9,17,19,104,104,208
2017,9,17,20,74,74,148
2017,9,17,21,33,37,70
2017,9,17,22,15,17,32
2017,9,17,23,11,18,29
2017,9,18,0,8,11,19
2017,9,18,1,14,14,28
2017,9,18,2,12,16,28
2017,9,18,3,29,23,52
2017,9,18,4,120,50,170
2017,9,18,5,217,115,332
2017,9,18,6,280,129,409
2017,9,18,7,317,115,432
2017,9,18,8,322,106,428
2017,9,18,9,325,143,468
2017,9,18,10,326,134,460
2017,9,18,11,272,170,442
2017,9,18,12,271,160,431
2017,9,18,13,275,230,505
2017,9,18,14,302,184,486
2017,9,18,15,270,150,420
2017,9,18,16,220,152,372
2017,9,18,17,153,124,277
2017,9,18,18,115,95,210
2017,9,18,19,104,97,201
2017,9,18,20,70,58,128
2017,9,18,21,29,32,61
2017,9,18,22,17,17,34
2017,9,18,23,10,12,22
2017,9,19,0,11,17,28
2017,9,19,1,8,10,18
2017,9,19,2,17,13,30
2017,9,19,3,25,15,40
2017,9,19,4,113,48,161
2017,9,19,5,268,130,398
2017,9,19,6,367,148,515
2017,9,19,7,355,110,465
2017,9,19,8,352,125,477
2017,9,19,9,358,124,482
2017,9,19,10,383,166,549
2017,9,19,11,319,176,495
2017,9,19,12,349,226,575
2017,9,19,13,275,257,532
2017,9,19,14,328,225,553
2017,9,19,15,356,179,535
2017,9,19,16,368,151,519
2017,9,19,17,199,171,370
2017,9,19,18,160,107,267
2017,9,19,19,103,95,198
2017,9,19,20,86,93,179
2017,9,19,21,39,56,95
2017,9,19,22,29,20,49
2017,9,19,23,9,17,26
2017,9,20,0,8,20,28
2017,9,20,1,14,15,29
2017,9,20,2,9,17,26
2017,9,20,3,14,19,33
2017,9,20,4,129,55,184
2017,9,20,5,281,110,391
2017,9,20,6,400,150,550
2017,9,20,7,461,125,586
2017,9,20,8,427,137,564
2017,9,20,9,458,141,599
2017,9,20,10,410,168,578
2017,9,20,11,403,159,562
2017,9,20,12,328,242,570
2017,9,20,13,321,255,576
2017,9,20,14,315,200,515
2017,9,20,15,282,181,463
2017,9,20,16,317,179,496
2017,9,20,17,296,194,490
2017,9,20,18,117,96,213
2017,9,20,19,110,104,214
2017,9,20,20,64,62,126
2017,9,20,21,39,26,65
2017,9,20,22,27,25,52
2017,9,20,23,20,27,47
2017,9,21,0,13,25,38
2017,9,21,1,10,27,37
2017,9,21,2,14,19,33
2017,9,21,3,15,14,29
2017,9,21,4,116,53,169
2017,9,21,5,260,112,372
2017,9,21,6,418,148,566
2017,9,21,7,471,112,583
2017,9,21,8,467,153,620
2017,9,21,9,525,185,710
2017,9,21,10,467,195,662
2017,9,21,11,443,192,635
2017,9,21,12,334,256,590
2017,9,21,13,279,155,434
2017,9,21,14,332,263,595
2017,9,21,15,426,225,651
2017,9,21,16,479,210,689
2017,9,21,17,388,178,566
2017,9,21,18,198,210,408
2017,9,21,19,139,135,274
2017,9,21,20,94,82,176
2017,9,21,21,52,67,119
2017,9,21,22,30,38,68
2017,9,21,23,15,30,45
2017,9,22,0,10,34,44
2017,9,22,1,19,27,46
2017,9,22,2,13,18,31
2017,9,22,3,19,23,42
2017,9,22,4,126,39,165
2017,9,22,5,240,108,348
2017,9,22,6,398,165,563
2017,9,22,7,445,142,587
2017,9,22,8,464,163,627
2017,9,22,9,439,194,633
2017,9,22,10,466,187,653
2017,9,22,11,388,221,609
2017,9,22,12,395,277,672
2017,9,22,13,344,253,597
2017,9,22,14,337,236,573
2017,9,22,15,355,157,512
2017,9,22,16,331,214,545
2017,9,22,17,378,163,541
2017,9,22,18,169,117,286
2017,9,22,19,103,67,170
2017,9,22,20,84,39,123
2017,9,22,21,63,48,111
2017,9,22,22,59,40,99
2017,9,22,23,50,26,76
2017,9,23,0,41,24,65
2017,9,23,1,25,16,41
2017,9,23,2,19,31,50
2017,9,23,3,20,24,44
2017,9,23,4,42,26,68
2017,9,23,5,41,34,75
2017,9,23,6,87,46,133
2017,9,23,7,172,59,231
2017,9,23,8,304,77,381
2017,9,23,9,345,101,446
2017,9,23,10,423,109,532
2017,9,23,11,423,141,564
2017,9,23,12,373,158,531
2017,9,23,13,351,170,521
2017,9,23,14,321,153,474
2017,9,23,15,317,134,451
2017,9,23,16,387,235,622
2017,9,23,17,268,152,420
2017,9,23,18,120,120,240
2017,9,23,19,78,75,153
2017,9,23,20,75,72,147
2017,9,23,21,64,71,135
2017,9,23,22,60,54,114
2017,9,23,23,41,39,80
2017,9,24,0,44,48,92
2017,9,24,1,36,39,75
2017,9,24,2,32,29,61
2017,9,24,3,13,36,49
2017,9,24,4,25,17,42
2017,9,24,5,37,28,65
2017,9,24,6,92,36,128
2017,9,24,7,181,60,241
2017,9,24,8,263,51,314
2017,9,24,9,373,71,444
2017,9,24,10,499,114,613
2017,9,24,11,486,117,603
2017,9,24,12,475,131,606
2017,9,24,13,353,153,506
2017,9,24,14,250,149,399
2017,9,24,15,279,371,650
2017,9,24,16,343,266,609
2017,9,24,17,290,170,460
2017,9,24,18,158,91,249
2017,9,24,19,123,92,215
2017,9,24,20,81,72,153
2017,9,24,21,32,35,67
2017,9,24,22,23,30,53
2017,9,24,23,14,14,28
2017,9,25,0,11,15,26
2017,9,25,1,7,18,25
2017,9,25,2,11,16,27
2017,9,25,3,31,16,47
2017,9,25,4,118,65,183
2017,9,25,5,289,168,457
2017,9,25,6,426,230,656
2017,9,25,7,287,195,482
2017,9,25,8,293,236,529
2017,9,25,9,268,231,499
2017,9,25,10,248,284,532
2017,9,25,11,217,287,504
2017,9,25,12,237,380,617
2017,9,25,13,294,506,800
2017,9,25,14,257,425,682
2017,9,25,15,213,209,422
2017,9,25,16,185,194,379
2017,9,25,17,146,176,322
2017,9,25,18,133,163,296
2017,9,25,19,99,121,220
2017,9,25,20,39,125,164
2017,9,25,21,20,47,67
2017,9,25,22,15,20,35
2017,9,25,23,6,12,18
2017,9,26,0,4,11,15
2017,9,26,1,5,10,15
2017,9,26,2,6,4,10
2017,9,26,3,11,16,27
2017,9,26,4,124,53,177
2017,9,26,5,264,166,430
2017,9,26,6,381,187,568
2017,9,26,7,263,169,432
2017,9,26,8,239,173,412
2017,9,26,9,219,177,396
2017,9,26,10,215,188,403
2017,9,26,11,236,231,467
2017,9,26,12,216,295,511
2017,9,26,13,252,326,578
2017,9,26,14,201,284,485
2017,9,26,15,179,198,377
2017,9,26,16,200,161,361
2017,9,26,17,163,187,350
2017,9,26,18,134,159,293
2017,9,26,19,95,132,227
2017,9,26,20,59,100,159
2017,9,26,21,34,53,87
2017,9,26,22,25,25,50
2017,9,26,23,15,23,38
2017,9,27,0,7,16,23
2017,9,27,1,11,19,30
2017,9,27,2,2,11,13
2017,9,27,3,10,7,17
2017,9,27,4,111,51,162
2017,9,27,5,240,165,405
2017,9,27,6,391,170,561
2017,9,27,7,258,172,430
2017,9,27,8,220,179,399
2017,9,27,9,204,179,383
2017,9,27,10,214,188,402
2017,9,27,11,232,239,471
2017,9,27,12,227,283,510
2017,9,27,13,267,326,593
2017,9,27,14,242,277,519
2017,9,27,15,202,217,419
2017,9,27,16,182,187,369
2017,9,27,17,152,169,321
2017,9,27,18,121,156,277
2017,9,27,19,99,122,221
2017,9,27,20,50,93,143
2017,9,27,21,20,51,71
2017,9,27,22,25,27,52
2017,9,27,23,13,27,40
2017,9,28,0,6,24,30
2017,9,28,1,6,16,22
2017,9,28,2,9,12,21
2017,9,28,3,9,18,27
2017,9,28,4,116,42,158
2017,9,28,5,219,149,368
2017,9,28,6,405,183,588
2017,9,28,7,239,190,429
2017,9,28,8,209,197,406
2017,9,28,9,205,176,381
2017,9,28,10,222,185,407
2017,9,28,11,208,220,428
2017,9,28,12,233,250,483
2017,9,28,13,264,354,618
2017,9,28,14,214,317,531
2017,9,28,15,192,198,390
2017,9,28,16,183,182,365
2017,9,28,17,148,171,319
2017,9,28,18,126,142,268
2017,9,28,19,90,111,201
2017,9,28,20,59,105,164
2017,9,28,21,36,59,95
2017,9,28,22,22,42,64
2017,9,28,23,17,40,57
2017,9,29,0,8,75,83
2017,9,29,1,10,52,62
2017,9,29,2,6,39,45
2017,9,29,3,17,12,29
2017,9,29,4,115,56,171
2017,9,29,5,237,141,378
2017,9,29,6,370,191,561
2017,9,29,7,222,165,387
2017,9,29,8,228,188,416
2017,9,29,9,222,212,434
2017,9,29,10,242,222,464
2017,9,29,11,231,235,466
2017,9,29,12,251,313,564
2017,9,29,13,253,315,568
2017,9,29,14,209,283,492
2017,9,29,15,184,223,407
2017,9,29,16,160,192,352
2017,9,29,17,122,134,256
2017,9,29,18,95,150,245
2017,9,29,19,96,104,200
2017,9,29,20,56,96,152
2017,9,29,21,50,74,124
2017,9,29,22,46,69,115
2017,9,29,23,22,54,76
2017,9,30,0,18,55,73
2017,9,30,1,24,39,63
2017,9,30,2,12,26,38
2017,9,30,3,9,11,20
2017,9,30,4,20,15,35
2017,9,30,5,22,25,47
2017,9,30,6,41,29,70
2017,9,30,7,63,46,109
2017,9,30,8,118,90,208
2017,9,30,9,149,109,258
2017,9,30,10,176,134,310
2017,9,30,11,173,180,353
2017,9,30,12,178,196,374
2017,9,30,13,170,236,406
2017,9,30,14,154,192,346
2017,9,30,15,135,191,326
2017,9,30,16,153,162,315
2017,9,30,17,132,128,260
2017,9,30,18,89,97,186
2017,9,30,19,59,77,136
2017,9,30,20,56,78,134
2017,9,30,21,39,80,119
2017,9,30,22,44,60,104
2017,9,30,23,26,64,90
2017,10,1,0,18,49,67
2017,10,1,1,23,52,75
2017,10,1,2,14,29,43
2017,10,1,3,15,16,31
2017,10,1,4,21,11,32
2017,10,1,5,17,13,30
2017,10,1,6,54,24,78
2017,10,1,7,99,48,147
2017,10,1,8,131,64,195
2017,10,1,9,129,107,236
2017,10,1,10,188,198,386
2017,10,1,11,180,202,382
2017,10,1,12,213,226,439
2017,10,1,13,191,260,451
2017,10,1,14,169,217,386
2017,10,1,15,164,215,379
2017,10,1,16,162,167,329
2017,10,1,17,144,172,316
2017,10,1,18,112,162,274
2017,10,1,19,91,118,209
2017,10,1,20,67,62,129
2017,10,1,21,26,57,83
2017,10,1,22,20,26,46
2017,10,1,23,11,17,28
2017,10,2,0,9,13,22
2017,10,2,1,6,9,15
2017,10,2,2,6,6,12
2017,10,2,3,19,11,30
2017,10,2,4,135,47,182
2017,10,2,5,242,161,403
2017,10,2,6,414,203,617
2017,10,2,7,241,176,417
2017,10,2,8,254,191,445
2017,10,2,9,208,191,399
2017,10,2,10,229,185,414
2017,10,2,11,211,218,429
2017,10,2,12,215,296,511
2017,10,2,13,252,331,583
2017,10,2,14,228,324,552
2017,10,2,15,218,177,395
2017,10,2,16,167,168,335
2017,10,2,17,139,140,279
2017,10,2,18,108,125,233
2017,10,2,19,76,112,188
2017,10,2,20,48,80,128
2017,10,2,21,29,39,68
2017,10,2,22,17,17,34
2017,10,2,23,13,8,21
2017,10,3,0,10,12,22
2017,10,3,1,3,7,10
2017,10,3,2,8,8,16
2017,10,3,3,14,14,28
2017,10,3,4,128,55,183
2017,10,3,5,235,126,361
2017,10,3,6,428,224,652
2017,10,3,7,277,197,474
2017,10,3,8,224,163,387
2017,10,3,9,214,197,411
2017,10,3,10,217,186,403
2017,10,3,11,226,223,449
2017,10,3,12,234,275,509
2017,10,3,13,247,347,594
2017,10,3,14,231,302,533
2017,10,3,15,195,219,414
2017,10,3,16,165,183,348
2017,10,3,17,155,132,287
2017,10,3,18,123,157,280
2017,10,3,19,77,118,195
2017,10,3,20,52,109,161
2017,10,3,21,40,52,92
2017,10,3,22,18,24,42
2017,10,3,23,7,22,29
2017,10,4,0,7,12,19
2017,10,4,1,11,18,29
2017,10,4,2,10,7,17
2017,10,4,3,18,15,33
2017,10,4,4,126,53,179
2017,10,4,5,231,147,378
2017,10,4,6,455,194,649
2017,10,4,7,252,149,401
2017,10,4,8,239,178,417
2017,10,4,9,229,178,407
2017,10,4,10,224,208,432
2017,10,4,11,215,206,421
2017,10,4,12,218,274,492
2017,10,4,13,248,373,621
2017,10,4,14,271,369,640
2017,10,4,15,235,227,462
2017,10,4,16,165,193,358
2017,10,4,17,139,153,292
2017,10,4,18,112,119,231
2017,10,4,19,89,127,216
2017,10,4,20,59,97,156
2017,10,4,21,36,47,83
2017,10,4,22,18,28,46
2017,10,4,23,7,15,22
2017,10,5,0,10,20,30
2017,10,5,1,4,17,21
2017,10,5,2,6,20,26
2017,10,5,3,15,14,29
2017,10,5,4,114,60,174
2017,10,5,5,252,126,378
2017,10,5,6,401,200,601
2017,10,5,7,236,169,405
2017,10,5,8,213,165,378
2017,10,5,9,203,187,390
2017,10,5,10,217,203,420
2017,10,5,11,228,218,446
2017,10,5,12,223,269,492
2017,10,5,13,272,358,630
2017,10,5,14,244,351,595
2017,10,5,15,209,196,405
2017,10,5,16,187,148,335
2017,10,5,17,172,172,344
2017,10,5,18,94,132,226
2017,10,5,19,85,138,223
2017,10,5,20,58,105,163
2017,10,5,21,42,63,105
2017,10,5,22,21,25,46
2017,10,5,23,10,15,25
2017,10,6,0,18,26,44
2017,10,6,1,5,26,31
2017,10,6,2,10,16,26
2017,10,6,3,18,17,35
2017,10,6,4,116,50,166
2017,10,6,5,254,141,395
2017,10,6,6,391,196,587
2017,10,6,7,266,204,470
2017,10,6,8,213,174,387
2017,10,6,9,226,202,428
2017,10,6,10,238,249,487
2017,10,6,11,249,268,517
2017,10,6,12,224,289,513
2017,10,6,13,250,340,590
2017,10,6,14,223,303,526
2017,10,6,15,179,193,372
2017,10,6,16,143,147,290
2017,10,6,17,111,134,245
2017,10,6,18,65,102,167
2017,10,6,19,63,100,163
2017,10,6,20,44,71,115
2017,10,6,21,29,62,91
2017,10,6,22,36,60,96
2017,10,6,23,27,41,68
2017,10,7,0,23,41,64
2017,10,7,1,26,41,67
2017,10,7,2,10,26,36
2017,10,7,3,6,15,21
2017,10,7,4,20,17,37
2017,10,7,5,26,28,54
2017,10,7,6,27,29,56
2017,10,7,7,55,45,100
2017,10,7,8,99,71,170
2017,10,7,9,104,89,193
2017,10,7,10,146,128,274
2017,10,7,11,154,147,301
2017,10,7,12,157,134,291
2017,10,7,13,140,169,309
2017,10,7,14,132,189,321
2017,10,7,15,136,139,275
2017,10,7,16,123,141,264
2017,10,7,17,89,113,202
2017,10,7,18,67,83,150
2017,10,7,19,53,84,137
2017,10,7,20,54,76,130
2017,10,7,21,50,60,110
2017,10,7,22,35,66,101
2017,10,7,23,32,54,86
2017,10,8,0,29,59,88
2017,10,8,1,32,64,96
2017,10,8,2,17,46,63
2017,10,8,3,10,16,26
2017,10,8,4,11,17,28
2017,10,8,5,13,15,28
2017,10,8,6,26,13,39
2017,10,8,7,43,31,74
2017,10,8,8,81,50,131
2017,10,8,9,115,83,198
2017,10,8,10,144,129,273
2017,10,8,11,124,153,277
2017,10,8,12,140,181,321
2017,10,8,13,160,190,350
2017,10,8,14,117,167,284
2017,10,8,15,143,185,328
2017,10,8,16,149,143,292
2017,10,8,17,138,153,291
2017,10,8,18,104,126,230
2017,10,8,19,88,96,184
2017,10,8,20,51,81,132
2017,10,8,21,33,50,83
2017,10,8,22,18,27,45
2017,10,8,23,8,18,26
2017,10,9,0,3,10,13
2017,10,9,1,6,15,21
2017,10,9,2,7,10,17
2017,10,9,3,16,19,35
2017,10,9,4,95,47,142
2017,10,9,5,214,120,334
2017,10,9,6,312,160,472
2017,10,9,7,234,175,409
2017,10,9,8,203,140,343
2017,10,9,9,221,171,392
2017,10,9,10,218,194,412
2017,10,9,11,205,222,427
2017,10,9,12,224,230,454
2017,10,9,13,242,300,542
2017,10,9,14,192,252,444
2017,10,9,15,162,172,334
2017,10,9,16,143,168,311
2017,10,9,17,110,127,237
2017,10,9,18,91,106,197
2017,10,9,19,65,97,162
2017,10,9,20,48,74,122
2017,10,9,21,27,40,67
2017,10,9,22,16,16,32
2017,10,9,23,10,13,23
2017,10,10,0,6,11,17
2017,10,10,1,6,7,13
2017,10,10,2,6,6,12
2017,10,10,3,25,17,42
2017,10,10,4,123,52,175
2017,10,10,5,219,146,365
2017,10,10,6,341,182,523
2017,10,10,7,219,160,379
2017,10,10,8,213,162,375
2017,10,10,9,204,168,372
2017,10,10,10,209,179,388
2017,10,10,11,206,212,418
2017,10,10,12,236,273,509
2017,10,10,13,213,301,514
2017,10,10,14,216,274,490
2017,10,10,15,180,190,370
2017,10,10,16,180,166,346
2017,10,10,17,121,152,273
2017,10,10,18,98,169,267
2017,10,10,19,78,109,187
2017,10,10,20,72,89,161
2017,10,10,21,30,48,78
2017,10,10,22,19,21,40
2017,10,10,23,5,14,19
2017,10,11,0,9,17,26
2017,10,11,1,10,19,29
2017,10,11,2,10,10,20
2017,10,11,3,18,14,32
2017,10,11,4,113,51,164
2017,10,11,5,229,132,361
2017,10,11,6,306,162,468
2017,10,11,7,242,164,406
2017,10,11,8,230,147,377
2017,10,11,9,223,176,399
2017,10,11,10,244,191,435
2017,10,11,11,194,232,426
2017,10,11,12,204,294,498
2017,10,11,13,227,323,550
2017,10,11,14,201,319,520
2017,10,11,15,170,200,370
2017,10,11,16,149,162,311
2017,10,11,17,112,130,242
2017,10,11,18,91,99,190
2017,10,11,19,101,99,200
2017,10,11,20,61,96,157
2017,10,11,21,50,46,96
2017,10,11,22,16,27,43
2017,10,11,23,13,17,30
2017,10,12,0,6,14,20
2017,10,12,1,6,13,19
2017,10,12,2,6,16,22
2017,10,12,3,18,11,29
2017,10,12,4,130,44,174
2017,10,12,5,217,131,348
2017,10,12,6,277,158,435
2017,10,12,7,235,148,383
2017,10,12,8,241,149,390
2017,10,12,9,228,178,406
2017,10,12,10,241,204,445
2017,10,12,11,192,246,438
2017,10,12,12,195,300,495
2017,10,12,13,208,308,516
2017,10,12,14,206,252,458
2017,10,12,15,181,188,369
2017,10,12,16,132,157,289
2017,10,12,17,111,118,229
2017,10,12,18,94,129,223
2017,10,12,19,84,97,181
2017,10,12,20,43,76,119
2017,10,12,21,35,61,96
2017,10,12,22,16,22,38
2017,10,12,23,15,19,34
2017,10,13,0,4,26,30
2017,10,13,1,13,29,42
2017,10,13,2,12,20,32
2017,10,13,3,13,12,25
2017,10,13,4,114,43,157
2017,10,13,5,209,113,322
2017,10,13,6,255,151,406
2017,10,13,7,225,147,372
2017,10,13,8,219,165,384
2017,10,13,9,231,141,372
2017,10,13,10,239,179,418
2017,10,13,11,233,240,473
2017,10,13,12,233,275,508
2017,10,13,13,230,321,551
2017,10,13,14,183,261,444
2017,10,13,15,167,168,335
2017,10,13,16,135,132,267
2017,10,13,17,111,122,233
2017,10,13,18,103,107,210
2017,10,13,19,69,104,173
2017,10,13,20,48,87,135
2017,10,13,21,47,59,106
2017,10,13,22,45,51,96
2017,10,13,23,22,48,70
2017,10,14,0,30,46,76
2017,10,14,1,15,30,45
2017,10,14,2,13,34,47
2017,10,14,3,9,11,20
2017,10,14,4,24,17,41
2017,10,14,5,26,12,38
2017,10,14,6,32,34,66
2017,10,14,7,63,56,119
2017,10,14,8,109,68,177
2017,10,14,9,128,103,231
2017,10,14,10,180,141,321
2017,10,14,11,147,175,322
2017,10,14,12,141,141,282
2017,10,14,13,104,149,253
2017,10,14,14,126,156,282
2017,10,14,15,124,160,284
2017,10,14,16,121,134,255
2017,10,14,17,100,102,202
2017,10,14,18,75,113,188
2017,10,14,19,54,82,136
2017,10,14,20,48,62,110
2017,10,14,21,39,68,107
2017,10,14,22,29,55,84
2017,10,14,23,23,51,74
2017,10,15,0,22,57,79
2017,10,15,1,28,60,88
2017,10,15,2,22,48,70
2017,10,15,3,12,20,32
2017,10,15,4,16,18,34
2017,10,15,5,16,16,32
2017,10,15,6,20,16,36
2017,10,15,7,51,32,83
2017,10,15,8,92,58,150
2017,10,15,9,111,85,196
2017,10,15,10,144,114,258
2017,10,15,11,161,177,338
2017,10,15,12,182,182,364
2017,10,15,13,153,225,378
2017,10,15,14,156,216,372
2017,10,15,15,144,151,295
2017,10,15,16,151,120,271
2017,10,15,17,147,142,289
2017,10,15,18,112,126,238
2017,10,15,19,71,104,175
2017,10,15,20,69,82,151
2017,10,15,21,27,32,59
2017,10,15,22,22,26,48
2017,10,15,23,9,16,25
2017,10,16,0,6,14,20
2017,10,16,1,5,6,11
2017,10,16,2,4,7,11
2017,10,16,3,18,11,29
2017,10,16,4,144,54,198
2017,10,16,5,248,128,376
2017,10,16,6,401,214,615
2017,10,16,7,270,181,451
2017,10,16,8,228,175,403
2017,10,16,9,223,186,409
2017,10,16,10,246,217,463
2017,10,16,11,194,235,429
2017,10,16,12,201,233,434
2017,10,16,13,245,335,580
2017,10,16,14,240,260,500
2017,10,16,15,192,201,393
2017,10,16,16,176,188,364
2017,10,16,17,139,142,281
2017,10,16,18,108,133,241
2017,10,16,19,80,128,208
2017,10,16,20,49,71,120
2017,10,16,21,32,43,75
2017,10,16,22,14,23,37
2017,10,16,23,17,13,30
2017,10,17,0,1,10,11
2017,10,17,1,6,7,13
2017,10,17,2,10,7,17
2017,10,17,3,21,14,35
2017,10,17,4,133,49,182
2017,10,17,5,271,157,428
2017,10,17,6,436,202,638
2017,10,17,7,273,167,440
2017,10,17,8,230,185,415
2017,10,17,9,251,180,431
2017,10,17,10,206,236,442
2017,10,17,11,230,204,434
2017,10,17,12,248,275,523
2017,10,17,13,264,391,655
2017,10,17,14,241,300,541
2017,10,17,15,231,198,429
2017,10,17,16,196,156,352
2017,10,17,17,131,149,280
2017,10,17,18,132,161,293
2017,10,17,19,75,122,197
2017,10,17,20,57,89,146
2017,10,17,21,36,46,82
2017,10,17,22,9,14,23
2017,10,17,23,14,18,32
2017,10,18,0,6,15,21
2017,10,18,1,9,21,30
2017,10,18,2,9,8,17
2017,10,18,3,21,20,41
2017,10,18,4,122,50,172
2017,10,18,5,262,148,410
2017,10,18,6,421,218,639
2017,10,18,7,244,158,402
2017,10,18,8,208,174,382
2017,10,18,9,207,211,418
2017,10,18,10,217,193,410
2017,10,18,11,224,222,446
2017,10,18,12,227,286,513
2017,10,18,13,241,321,562
2017,10,18,14,238,276,514
2017,10,18,15,217,180,397
2017,10,18,16,174,190,364
2017,10,18,17,123,146,269
2017,10,18,18,120,144,264
2017,10,18,19,90,117,207
2017,10,18,20,59,77,136
2017,10,18,21,36,46,82
2017,10,18,22,22,33,55
2017,10,18,23,13,14,27
2017,10,19,0,8,12,20
2017,10,19,1,4,8,12
2017,10,19,2,6,17,23
2017,10,19,3,21,10,31
2017,10,19,4,109,50,159
2017,10,19,5,232,140,372
2017,10,19,6,396,208,604
2017,10,19,7,251,175,426
2017,10,19,8,196,190,386
2017,10,19,9,224,189,413
2017,10,19,10,217,227,444
2017,10,19,11,215,268,483
2017,10,19,12,226,250,476
2017,10,19,13,276,341,617
2017,10,19,14,249,293,542
2017,10,19,15,243,192,435
2017,10,19,16,176,191,367
2017,10,19,17,153,162,315
2017,10,19,18,101,163,264
2017,10,19,19,83,125,208
2017,10,19,20,62,83,145
2017,10,19,21,38,54,92
2017,10,19,22,17,38,55
2017,10,19,23,19,43,62
2017,10,20,0,13,47,60
2017,10,20,1,12,35,47
2017,10,20,2,10,22,32
2017,10,20,3,15,25,40
2017,10,20,4,111,50,161
2017,10,20,5,224,130,354
2017,10,20,6,355,199,554
2017,10,20,7,245,166,411
2017,10,20,8,218,178,396
2017,10,20,9,218,196,414
2017,10,20,10,237,212,449
2017,10,20,11,244,234,478
2017,10,20,12,263,287,550
2017,10,20,13,265,371,636
2017,10,20,14,210,259,469
2017,10,20,15,154,154,308
2017,10,20,16,155,166,321
2017,10,20,17,125,160,285
2017,10,20,18,87,90,177
2017,10,20,19,69,86,155
2017,10,20,20,55,72,127
2017,10,20,21,43,81,124
2017,10,20,22,46,62,108
2017,10,20,23,18,43,61
2017,10,21,0,29,41,70
2017,10,21,1,17,47,64
2017,10,21,2,13,32,45
2017,10,21,3,12,14,26
2017,10,21,4,21,17,38
2017,10,21,5,29,30,59
2017,10,21,6,57,39,96
2017,10,21,7,61,50,111
2017,10,21,8,121,81,202
2017,10,21,9,129,122,251
2017,10,21,10,183,141,324
2017,10,21,11,167,140,307
2017,10,21,12,156,178,334
2017,10,21,13,143,186,329
2017,10,21,14,130,176,306
2017,10,21,15,128,159,287
2017,10,21,16,128,144,272
2017,10,21,17,110,110,220
2017,10,21,18,80,84,164
2017,10,21,19,59,76,135
2017,10,21,20,42,72,114
2017,10,21,21,36,55,91
2017,10,21,22,36,55,91
2017,10,21,23,31,66,97
2017,10,22,0,30,47,77
2017,10,22,1,21,57,78
2017,10,22,2,13,29,42
2017,10,22,3,17,26,43
2017,10,22,4,10,10,20
2017,10,22,5,23,22,45
2017,10,22,6,30,15,45
2017,10,22,7,52,36,88
2017,10,22,8,105,58,163
2017,10,22,9,118,107,225
2017,10,22,10,162,153,315
2017,10,22,11,167,191,358
2017,10,22,12,198,211,409
2017,10,22,13,205,215,420
2017,10,22,14,169,251,420
2017,10,22,15,162,197,359
2017,10,22,16,148,168,316
2017,10,22,17,128,165,293
2017,10,22,18,108,151,259
2017,10,22,19,68,110,178
2017,10,22,20,131,86,217
2017,10,22,21,55,40,95
2017,10,22,22,15,25,40
2017,10,22,23,14,24,38
2017,10,23,0,13,11,24
2017,10,23,1,16,16,32
2017,10,23,2,12,10,22
2017,10,23,3,24,13,37
2017,10,23,4,132,56,188
2017,10,23,5,254,163,417
2017,10,23,6,403,198,601
2017,10,23,7,262,161,423
2017,10,23,8,208,160,368
2017,10,23,9,210,179,389
2017,10,23,10,193,184,377
2017,10,23,11,225,204,429
2017,10,23,12,223,271,494
2017,10,23,13,253,325,578
2017,10,23,14,211,273,484
2017,10,23,15,185,165,350
2017,10,23,16,171,190,361
2017,10,23,17,135,158,293
2017,10,23,18,96,140,236
2017,10,23,19,91,137,228
2017,10,23,20,67,88,155
2017,10,23,21,32,37,69
2017,10,23,22,11,17,28
2017,10,23,23,16,21,37
2017,10,24,0,6,11,17
2017,10,24,1,10,6,16
2017,10,24,2,8,8,16
2017,10,24,3,21,9,30
2017,10,24,4,119,51,170
2017,10,24,5,248,161,409
2017,10,24,6,430,180,610
2017,10,24,7,273,191,464
2017,10,24,8,238,189,427
2017,10,24,9,207,187,394
2017,10,24,10,205,177,382
2017,10,24,11,223,220,443
2017,10,24,12,207,254,461
2017,10,24,13,244,382,626
2017,10,24,14,226,315,541
2017,10,24,15,186,167,353
2017,10,24,16,208,189,397
2017,10,24,17,140,150,290
2017,10,24,18,119,142,261
2017,10,24,19,83,101,184
2017,10,24,20,59,87,146
2017,10,24,21,29,28,57
2017,10,24,22,12,25,37
2017,10,24,23,16,22,38
2017,10,25,0,11,30,41
2017,10,25,1,12,28,40
2017,10,25,2,8,31,39
2017,10,25,3,23,27,50
2017,10,25,4,102,53,155
2017,10,25,5,244,140,384
2017,10,25,6,399,217,616
2017,10,25,7,267,149,416
2017,10,25,8,242,200,442
2017,10,25,9,230,189,419
2017,10,25,10,215,221,436
2017,10,25,11,199,213,412
2017,10,25,12,253,267,520
2017,10,25,13,255,332,587
2017,10,25,14,234,300,534
2017,10,25,15,216,197,413
2017,10,25,16,172,162,334
2017,10,25,17,140,171,311
2017,10,25,18,114,135,249
2017,10,25,19,86,109,195
2017,10,25,20,53,99,152
2017,10,25,21,33,49,82
2017,10,25,22,17,26,43
2017,10,25,23,12,17,29
2017,10,26,0,5,17,22
2017,10,26,1,7,25,32
2017,10,26,2,9,15,24
2017,10,26,3,17,12,29
2017,10,26,4,117,45,162
2017,10,26,5,223,153,376
2017,10,26,6,415,189,604
2017,10,26,7,271,144,415
2017,10,26,8,243,185,428
2017,10,26,9,240,183,423
2017,10,26,10,211,209,420
2017,10,26,11,193,186,379
2017,10,26,12,197,270,467
2017,10,26,13,267,355,622
2017,10,26,14,240,307,547
2017,10,26,15,184,218,402
2017,10,26,16,182,170,352
2017,10,26,17,133,179,312
2017,10,26,18,124,134,258
2017,10,26,19,89,144,233
2017,10,26,20,52,94,146
2017,10,26,21,30,66,96
2017,10,26,22,26,34,60
2017,10,26,23,15,39,54
2017,10,27,0,8,21,29
2017,10,27,1,7,21,28
2017,10,27,2,13,19,32
2017,10,27,3,21,16,37
2017,10,27,4,119,52,171
2017,10,27,5,229,124,353
2017,10,27,6,408,190,598
2017,10,27,7,254,157,411
2017,10,27,8,225,171,396
2017,10,27,9,211,190,401
2017,10,27,10,235,255,490
2017,10,27,11,237,254,491
2017,10,27,12,229,287,516
2017,10,27,13,275,345,620
2017,10,27,14,188,274,462
2017,10,27,15,188,170,358
2017,10,27,16,146,154,300
2017,10,27,17,120,161,281
2017,10,27,18,84,96,180
2017,10,27,19,65,74,139
2017,10,27,20,59,69,128
2017,10,27,21,51,58,109
2017,10,27,22,42,48,90
2017,10,27,23,29,46,75
2017,10,28,0,29,28,57
2017,10,28,1,20,40,60
2017,10,28,2,13,30,43
2017,10,28,3,12,8,20
2017,10,28,4,19,9,28
2017,10,28,5,24,20,44
2017,10,28,6,50,33,83
2017,10,28,7,78,66,144
2017,10,28,8,117,86,203
2017,10,28,9,176,99,275
2017,10,28,10,199,140,339
2017,10,28,11,175,176,351
2017,10,28,12,171,199,370
2017,10,28,13,134,225,359
2017,10,28,14,200,175,375
2017,10,28,15,158,168,326
2017,10,28,16,147,183,330
2017,10,28,17,142,118,260
2017,10,28,18,79,102,181
2017,10,28,19,61,93,154
2017,10,28,20,56,76,132
2017,10,28,21,38,83,121
2017,10,28,22,47,63,110
2017,10,28,23,36,56,92
2017,10,29,0,29,73,102
2017,10,29,1,27,64,91
2017,10,29,2,25,47,72
2017,10,29,3,6,19,25
2017,10,29,4,9,11,20
2017,10,29,5,16,11,27
2017,10,29,6,19,19,38
2017,10,29,7,33,19,52
2017,10,29,8,53,34,87
2017,10,29,9,137,79,216
2017,10,29,10,152,103,255
2017,10,29,11,183,173,356
2017,10,29,12,196,214,410
2017,10,29,13,201,217,418
2017,10,29,14,180,253,433
2017,10,29,15,190,246,436
2017,10,29,16,166,183,349
2017,10,29,17,137,194,331
2017,10,29,18,145,156,301
2017,10,29,19,98,136,234
2017,10,29,20,82,106,188
2017,10,29,21,52,57,109
2017,10,29,22,23,38,61
2017,10,29,23,23,24,47
2017,10,30,0,11,11,22
2017,10,30,1,10,12,22
2017,10,30,2,6,18,24
2017,10,30,3,12,8,20
2017,10,30,4,19,14,33
2017,10,30,5,128,54,182
2017,10,30,6,258,152,410
2017,10,30,7,386,224,610
2017,10,30,8,302,192,494
2017,10,30,9,219,185,404
2017,10,30,10,226,180,406
2017,10,30,11,211,176,387
2017,10,30,12,227,254,481
2017,10,30,13,213,267,480
2017,10,30,14,248,330,578
2017,10,30,15,256,296,552
2017,10,30,16,214,199,413
2017,10,30,17,179,160,339
2017,10,30,18,134,143,277
2017,10,30,19,107,124,231
2017,10,30,20,79,117,196
2017,10,30,21,44,97,141
2017,10,30,22,21,37,58
2017,10,30,23,9,17,26
2017,10,31,0,11,14,25
2017,10,31,1,5,11,16
2017,10,31,2,7,12,19
2017,10,31,3,10,11,21
2017,10,31,4,24,15,39
2017,10,31,5,126,53,179
2017,10,31,6,288,151,439
2017,10,31,7,404,190,594
2017,10,31,8,256,171,427
2017,10,31,9,222,179,401
2017,10,31,10,237,204,441
2017,10,31,11,216,240,456
2017,10,31,12,196,208,404
2017,10,31,13,263,286,549
2017,10,31,14,245,366,611
2017,10,31,15,230,306,536
2017,10,31,16,232,200,432
2017,10,31,17,177,142,319
2017,10,31,18,141,145,286
2017,10,31,19,98,123,221
2017,10,31,20,79,116,195
2017,10,31,21,46,91,137
2017,10,31,22,27,58,85
2017,10,31,23,19,19,38
2017,11,1,0,4,26,30
2017,11,1,1,9,26,35
2017,11,1,2,11,18,29
2017,11,1,3,10,14,24
2017,11,1,4,21,14,35
2017,11,1,5,118,64,182
2017,11,1,6,223,165,388
2017,11,1,7,415,211,626
2017,11,1,8,271,167,438
2017,11,1,9,238,159,397
2017,11,1,10,216,203,419
2017,11,1,11,239,200,439
2017,11,1,12,217,205,422
2017,11,1,13,247,256,503
2017,11,1,14,239,363,602
2017,11,1,15,263,309,572
2017,11,1,16,243,216,459
2017,11,1,17,193,187,380
2017,11,1,18,153,152,305
2017,11,1,19,107,150,257
2017,11,1,20,90,131,221
2017,11,1,21,62,76,138
2017,11,1,22,35,47,82
2017,11,1,23,16,28,44
2017,11,2,0,6,9,15
2017,11,2,1,4,8,12
2017,11,2,2,6,17,23
2017,11,2,3,12,9,21
2017,11,2,4,22,11,33
2017,11,2,5,124,52,176
2017,11,2,6,244,168,412
2017,11,2,7,428,218,646
2017,11,2,8,240,161,401
2017,11,2,9,198,161,359
2017,11,2,10,265,176,441
2017,11,2,11,247,239,486
2017,11,2,12,236,222,458
2017,11,2,13,228,301,529
2017,11,2,14,233,343,576
2017,11,2,15,270,319,589
2017,11,2,16,191,215,406
2017,11,2,17,176,192,368
2017,11,2,18,147,180,327
2017,11,2,19,104,187,291
2017,11,2,20,89,114,203
2017,11,2,21,67,87,154
2017,11,2,22,25,55,80
2017,11,2,23,26,26,52
2017,11,3,0,10,30,40
2017,11,3,1,9,17,26
2017,11,3,2,6,25,31
2017,11,3,3,13,22,35
2017,11,3,4,16,14,30
2017,11,3,5,127,59,186
2017,11,3,6,265,153,418
2017,11,3,7,393,186,579
2017,11,3,8,247,163,410
2017,11,3,9,204,205,409
2017,11,3,10,225,181,406
2017,11,3,11,248,208,456
2017,11,3,12,227,234,461
2017,11,3,13,299,276,575
2017,11,3,14,237,394,631
2017,11,3,15,215,296,511
2017,11,3,16,168,185,353
2017,11,3,17,154,162,316
2017,11,3,18,139,119,258
2017,11,3,19,88,135,223
2017,11,3,20,84,83,167
2017,11,3,21,69,93,162
2017,11,3,22,42,64,106
2017,11,3,23,40,43,83
2017,11,4,0,24,38,62
2017,11,4,1,15,48,63
2017,11,4,2,13,38,51
2017,11,4,3,11,28,39
2017,11,4,4,14,15,29
2017,11,4,5,21,15,36
2017,11,4,6,29,14,43
2017,11,4,7,62,38,100
2017,11,4,8,81,59,140
2017,11,4,9,163,89,252
2017,11,4,10,146,112,258
2017,11,4,11,196,144,340
2017,11,4,12,180,176,356
2017,11,4,13,177,221,398
2017,11,4,14,154,251,405
2017,11,4,15,144,187,331
2017,11,4,16,119,160,279
2017,11,4,17,126,138,264
2017,11,4,18,126,107,233
2017,11,4,19,74,104,178
2017,11,4,20,54,90,144
2017,11,4,21,45,76,121
2017,11,4,22,44,73,117
2017,11,4,23,34,64,98
2017,11,5,0,34,43,77
2017,11,5,1,31,52,83
2017,11,5,2,22,45,67
2017,11,5,3,9,55,64
2017,11,5,4,17,21,38
2017,11,5,5,18,12,30
2017,11,5,6,18,10,28
2017,11,5,7,31,17,48
2017,11,5,8,60,45,105
2017,11,5,9,103,60,163
2017,11,5,10,152,113,265
2017,11,5,11,177,197,374
2017,11,5,12,181,221,402
2017,11,5,13,246,212,458
2017,11,5,14,192,221,413
2017,11,5,15,195,253,448
2017,11,5,16,252,211,463
2017,11,5,17,172,201,373
2017,11,5,18,135,206,341
2017,11,5,19,148,156,304
2017,11,5,20,81,94,175
2017,11,5,21,59,58,117
2017,11,5,22,29,40,69
2017,11,5,23,20,17,37
2017,11,6,0,10,18,28
2017,11,6,1,5,10,15
2017,11,6,2,6,12,18
2017,11,6,3,7,6,13
2017,11,6,4,16,12,28
2017,11,6,5,126,57,183
2017,11,6,6,236,168,404
2017,11,6,7,375,200,575
2017,11,6,8,275,187,462
2017,11,6,9,259,186,445
2017,11,6,10,236,188,424
2017,11,6,11,205,170,375
2017,11,6,12,211,195,406
2017,11,6,13,203,231,434
2017,11,6,14,237,337,574
2017,11,6,15,229,276,505
2017,11,6,16,238,213,451
2017,11,6,17,201,161,362
2017,11,6,18,121,158,279
2017,11,6,19,129,135,264
2017,11,6,20,77,133,210
2017,11,6,21,66,106,172
2017,11,6,22,29,41,70
2017,11,6,23,16,26,42
2017,11,7,0,6,10,16
2017,11,7,1,9,18,27
2017,11,7,2,4,11,15
2017,11,7,3,10,11,21
2017,11,7,4,17,17,34
2017,11,7,5,123,64,187
2017,11,7,6,212,145,357
2017,11,7,7,414,224,638
2017,11,7,8,254,156,410
2017,11,7,9,264,186,450
2017,11,7,10,217,191,408
2017,11,7,11,209,218,427
2017,11,7,12,205,221,426
2017,11,7,13,224,251,475
2017,11,7,14,260,331,591
2017,11,7,15,187,315,502
2017,11,7,16,219,189,408
2017,11,7,17,192,143,335
2017,11,7,18,151,141,292
2017,11,7,19,131,128,259
2017,11,7,20,78,147,225
2017,11,7,21,66,78,144
2017,11,7,22,40,32,72
2017,11,7,23,12,20,32
2017,11,8,0,11,16,27
2017,11,8,1,3,15,18
2017,11,8,2,10,15,25
2017,11,8,3,8,6,14
2017,11,8,4,17,16,33
2017,11,8,5,136,58,194
2017,11,8,6,245,173,418
2017,11,8,7,416,212,628
2017,11,8,8,287,175,462
2017,11,8,9,238,164,402
2017,11,8,10,226,172,398
2017,11,8,11,228,226,454
2017,11,8,12,213,219,432
2017,11,8,13,264,276,540
2017,11,8,14,256,367,623
2017,11,8,15,233,297,530
2017,11,8,16,212,212,424
2017,11,8,17,211,165,376
2017,11,8,18,131,153,284
2017,11,8,19,101,132,233
2017,11,8,20,96,123,219
2017,11,8,21,59,100,159
2017,11,8,22,30,58,88
2017,11,8,23,15,28,43
2017,11,9,0,18,19,37
2017,11,9,1,6,21,27
2017,11,9,2,4,14,18
2017,11,9,3,11,12,23
2017,11,9,4,13,17,30
2017,11,9,5,136,51,187
2017,11,9,6,273,152,425
2017,11,9,7,392,214,606
2017,11,9,8,294,165,459
2017,11,9,9,263,169,432
2017,11,9,10,207,191,398
2017,11,9,11,226,219,445
2017,11,9,12,221,212,433
2017,11,9,13,267,259,526
2017,11,9,14,254,357,611
2017,11,9,15,258,289,547
2017,11,9,16,222,207,429
2017,11,9,17,211,166,377
2017,11,9,18,174,181,355
2017,11,9,19,127,135,262
2017,11,9,20,101,133,234
2017,11,9,21,69,107,176
2017,11,9,22,35,213,248
2017,11,9,23,21,82,103
2017,11,10,0,8,24,32
2017,11,10,1,10,25,35
2017,11,10,2,9,30,39
2017,11,10,3,9,13,22
2017,11,10,4,15,14,29
2017,11,10,5,122,57,179
2017,11,10,6,255,162,417
2017,11,10,7,368,184,552
2017,11,10,8,252,159,411
2017,11,10,9,242,157,399
2017,11,10,10,236,193,429
2017,11,10,11,257,220,477
2017,11,10,12,228,247,475
2017,11,10,13,260,323,583
2017,11,10,14,307,395,702
2017,11,10,15,214,291,505
2017,11,10,16,177,198,375
2017,11,10,17,153,148,301
2017,11,10,18,138,120,258
2017,11,10,19,105,101,206
2017,11,10,20,62,83,145
2017,11,10,21,68,94,162
2017,11,10,22,49,59,108
2017,11,10,23,34,46,80
2017,11,11,0,35,44,79
2017,11,11,1,22,37,59
2017,11,11,2,19,46,65
2017,11,11,3,9,33,42
2017,11,11,4,13,23,36
2017,11,11,5,21,20,41
2017,11,11,6,50,17,67
2017,11,11,7,80,41,121
2017,11,11,8,81,57,138
2017,11,11,9,126,85,211
2017,11,11,10,165,124,289
2017,11,11,11,201,171,372
2017,11,11,12,187,174,361
2017,11,11,13,173,220,393
2017,11,11,14,169,216,385
2017,11,11,15,143,239,382
2017,11,11,16,160,182,342
2017,11,11,17,129,145,274
2017,11,11,18,127,119,246
2017,11,11,19,73,108,181
2017,11,11,20,49,84,133
2017,11,11,21,45,54,99
2017,11,11,22,48,71,119
2017,11,11,23,44,77,121
2017,11,12,0,28,62,90
2017,11,12,1,33,42,75
2017,11,12,2,26,52,78
2017,11,12,3,19,43,62
2017,11,12,4,15,29,44
2017,11,12,5,17,16,33
2017,11,12,6,18,14,32
2017,11,12,7,30,18,48
2017,11,12,8,54,40,94
2017,11,12,9,80,77,157
2017,11,12,10,129,98,227
2017,11,12,11,187,137,324
2017,11,12,12,162,175,337
2017,11,12,13,187,240,427
2017,11,12,14,194,237,431
2017,11,12,15,169,220,389
2017,11,12,16,209,215,424
2017,11,12,17,161,147,308
2017,11,12,18,164,167,331
2017,11,12,19,124,142,266
2017,11,12,20,69,120,189
2017,11,12,21,53,71,124
2017,11,12,22,27,44,71
2017,11,12,23,16,27,43
2017,11,13,0,11,21,32
2017,11,13,1,4,9,13
2017,11,13,2,6,15,21
2017,11,13,3,7,13,20
2017,11,13,4,15,19,34
2017,11,13,5,121,50,171
2017,11,13,6,233,150,383
2017,11,13,7,357,199,556
2017,11,13,8,287,157,444
2017,11,13,9,224,168,392
2017,11,13,10,229,162,391
2017,11,13,11,202,212,414
2017,11,13,12,256,209,465
2017,11,13,13,223,229,452
2017,11,13,14,235,330,565
2017,11,13,15,286,297,583
2017,11,13,16,197,203,400
2017,11,13,17,166,163,329
2017,11,13,18,145,137,282
2017,11,13,19,98,114,212
2017,11,13,20,80,116,196
2017,11,13,21,51,84,135
2017,11,13,22,27,45,72
2017,11,13,23,20,26,46
2017,11,14,0,12,12,24
2017,11,14,1,7,7,14
2017,11,14,2,8,11,19
2017,11,14,3,5,5,10
2017,11,14,4,17,14,31
2017,11,14,5,125,57,182
2017,11,14,6,266,148,414
2017,11,14,7,443,196,639
2017,11,14,8,256,170,426
2017,11,14,9,252,236,488
2017,11,14,10,228,177,405
2017,11,14,11,212,203,415
2017,11,14,12,238,215,453
2017,11,14,13,224,275,499
2017,11,14,14,252,326,578
2017,11,14,15,257,317,574
2017,11,14,16,203,198,401
2017,11,14,17,184,179,363
2017,11,14,18,144,148,292
2017,11,14,19,118,137,255
2017,11,14,20,79,114,193
2017,11,14,21,64,85,149
2017,11,14,22,28,42,70
2017,11,14,23,17,30,47
2017,11,15,0,8,13,21
2017,11,15,1,6,12,18
2017,11,15,2,4,14,18
2017,11,15,3,11,7,18
2017,11,15,4,17,16,33
2017,11,15,5,122,53,175
2017,11,15,6,247,146,393
2017,11,15,7,405,195,600
2017,11,15,8,260,156,416
2017,11,15,9,257,199,456
2017,11,15,10,248,194,442
2017,11,15,11,265,228,493
2017,11,15,12,218,218,436
2017,11,15,13,237,280,517
2017,11,15,14,264,354,618
2017,11,15,15,242,306,548
2017,11,15,16,204,216,420
2017,11,15,17,185,175,360
2017,11,15,18,141,140,281
2017,11,15,19,118,121,239
2017,11,15,20,88,122,210
2017,11,15,21,55,90,145
2017,11,15,22,30,145,175
2017,11,15,23,21,38,59
2017,11,16,0,10,17,27
2017,11,16,1,4,25,29
2017,11,16,2,9,15,24
2017,11,16,3,9,9,18
2017,11,16,4,15,17,32
2017,11,16,5,107,47,154
2017,11,16,6,240,143,383
2017,11,16,7,395,225,620
2017,11,16,8,260,197,457
2017,11,16,9,236,165,401
2017,11,16,10,238,175,413
2017,11,16,11,224,206,430
2017,11,16,12,241,196,437
2017,11,16,13,227,284,511
2017,11,16,14,254,401,655
2017,11,16,15,286,342,628
2017,11,16,16,231,205,436
2017,11,16,17,168,167,335
2017,11,16,18,148,172,320
2017,11,16,19,104,144,248
2017,11,16,20,92,131,223
2017,11,16,21,67,112,179
2017,11,16,22,38,71,109
2017,11,16,23,24,39,63
2017,11,17,0,11,26,37
2017,11,17,1,7,15,22
2017,11,17,2,7,24,31
2017,11,17,3,11,13,24
2017,11,17,4,20,14,34
2017,11,17,5,117,53,170
2017,11,17,6,248,137,385
2017,11,17,7,435,217,652
2017,11,17,8,280,174,454
2017,11,17,9,226,170,396
2017,11,17,10,237,172,409
2017,11,17,11,227,245,472
2017,11,17,12,217,219,436
2017,11,17,13,268,301,569
2017,11,17,14,280,387,667
2017,11,17,15,227,285,512
2017,11,17,16,182,196,378
2017,11,17,17,197,158,355
2017,11,17,18,129,142,271
2017,11,17,19,106,126,232
2017,11,17,20,63,99,162
2017,11,17,21,78,85,163
2017,11,17,22,42,62,104
2017,11,17,23,47,58,105
2017,11,18,0,28,44,72
2017,11,18,1,23,45,68
2017,11,18,2,13,41,54
2017,11,18,3,12,32,44
2017,11,18,4,10,15,25
2017,11,18,5,19,20,39
2017,11,18,6,31,21,52
2017,11,18,7,44,36,80
2017,11,18,8,58,43,101
2017,11,18,9,98,80,178
2017,11,18,10,162,130,292
2017,11,18,11,209,157,366
2017,11,18,12,185,177,362
2017,11,18,13,176,207,383
2017,11,18,14,176,175,351
2017,11,18,15,153,173,326
2017,11,18,16,157,151,308
2017,11,18,17,154,176,330
2017,11,18,18,101,118,219
2017,11,18,19,97,95,192
2017,11,18,20,44,88,132
2017,11,18,21,57,77,134
2017,11,18,22,51,68,119
2017,11,18,23,48,70,118
2017,11,19,0,42,66,108
2017,11,19,1,22,51,73
2017,11,19,2,36,66,102
2017,11,19,3,22,55,77
2017,11,19,4,13,23,36
2017,11,19,5,13,12,25
2017,11,19,6,24,17,41
2017,11,19,7,39,23,62
2017,11,19,8,54,44,98
2017,11,19,9,117,64,181
2017,11,19,10,120,90,210
2017,11,19,11,148,141,289
2017,11,19,12,172,198,370
2017,11,19,13,171,180,351
2017,11,19,14,169,214,383
2017,11,19,15,186,244,430
2017,11,19,16,180,186,366
2017,11,19,17,157,172,329
2017,11,19,18,156,158,314
2017,11,19,19,114,144,258
2017,11,19,20,82,107,189
2017,11,19,21,44,60,104
2017,11,19,22,36,58,94
2017,11,19,23,18,32,50
2017,11,20,0,10,25,35
2017,11,20,1,7,9,16
2017,11,20,2,4,11,15
2017,11,20,3,17,5,22
2017,11,20,4,16,18,34
2017,11,20,5,123,49,172
2017,11,20,6,241,161,402
2017,11,20,7,388,215,603
2017,11,20,8,297,175,472
2017,11,20,9,255,169,424
2017,11,20,10,248,176,424
2017,11,20,11,248,203,451
2017,11,20,12,210,212,422
2017,11,20,13,261,281,542
2017,11,20,14,242,335,577
2017,11,20,15,278,285,563
2017,11,20,16,193,181,374
2017,11,20,17,160,153,313
2017,11,20,18,127,138,265
2017,11,20,19,107,113,220
2017,11,20,20,86,119,205
2017,11,20,21,71,74,145
2017,11,20,22,33,45,78
2017,11,20,23,28,29,57
2017,11,21,0,11,17,28
2017,11,21,1,7,5,12
2017,11,21,2,6,4,10
2017,11,21,3,10,12,22
2017,11,21,4,22,18,40
2017,11,21,5,116,51,167
2017,11,21,6,252,164,416
2017,11,21,7,369,234,603
2017,11,21,8,262,169,431
2017,11,21,9,253,178,431
2017,11,21,10,238,186,424
2017,11,21,11,203,201,404
2017,11,21,12,210,176,386
2017,11,21,13,224,244,468
2017,11,21,14,259,309,568
2017,11,21,15,235,305,540
2017,11,21,16,186,195,381
2017,11,21,17,199,165,364
2017,11,21,18,134,156,290
2017,11,21,19,108,120,228
2017,11,21,20,84,107,191
2017,11,21,21,74,106,180
2017,11,21,22,38,43,81
2017,11,21,23,19,31,50
2017,11,22,0,17,21,38
2017,11,22,1,8,23,31
2017,11,22,2,16,20,36
2017,11,22,3,14,14,28
2017,11,22,4,20,18,38
2017,11,22,5,121,57,178
2017,11,22,6,233,153,386
2017,11,22,7,387,231,618
2017,11,22,8,299,178,477
2017,11,22,9,223,170,393
2017,11,22,10,207,193,400
2017,11,22,11,219,207,426
2017,11,22,12,233,209,442
2017,11,22,13,217,276,493
2017,11,22,14,258,311,569
2017,11,22,15,248,307,555
2017,11,22,16,213,198,411
2017,11,22,17,171,157,328
2017,11,22,18,143,156,299
2017,11,22,19,91,151,242
2017,11,22,20,84,113,197
2017,11,22,21,89,93,182
2017,11,22,22,41,56,97
2017,11,22,23,29,27,56
2017,11,23,0,14,22,36
2017,11,23,1,17,15,32
2017,11,23,2,13,14,27
2017,11,23,3,9,7,16
2017,11,23,4,22,16,38
2017,11,23,5,125,63,188
2017,11,23,6,282,167,449
2017,11,23,7,406,247,653
2017,11,23,8,278,186,464
2017,11,23,9,247,156,403
2017,11,23,10,207,187,394
2017,11,23,11,220,195,415
2017,11,23,12,207,237,444
2017,11,23,13,249,272,521
2017,11,23,14,275,353,628
2017,11,23,15,260,303,563
2017,11,23,16,201,204,405
2017,11,23,17,170,163,333
2017,11,23,18,158,155,313
2017,11,23,19,101,139,240
2017,11,23,20,96,129,225
2017,11,23,21,77,79,156
2017,11,23,22,39,59,98
2017,11,23,23,22,33,55
2017,11,24,0,10,17,27
2017,11,24,1,16,19,35
2017,11,24,2,9,24,33
2017,11,24,3,14,13,27
2017,11,24,4,23,14,37
2017,11,24,5,125,64,189
2017,11,24,6,249,163,412
2017,11,24,7,393,212,605
2017,11,24,8,274,145,419
2017,11,24,9,255,174,429
2017,11,24,10,268,177,445
2017,11,24,11,204,216,420
2017,11,24,12,254,231,485
2017,11,24,13,273,300,573
2017,11,24,14,254,380,634
2017,11,24,15,242,317,559
2017,11,24,16,209,204,413
2017,11,24,17,160,173,333
2017,11,24,18,153,181,334
2017,11,24,19,79,108,187
2017,11,24,20,61,84,145
2017,11,24,21,65,87,152
2017,11,24,22,62,65,127
2017,11,24,23,49,54,103
2017,11,25,0,19,36,55
2017,11,25,1,21,41,62
2017,11,25,2,28,58,86
2017,11,25,3,17,37,54
2017,11,25,4,11,13,24
2017,11,25,5,31,18,49
2017,11,25,6,33,21,54
2017,11,25,7,41,36,77
2017,11,25,8,55,49,104
2017,11,25,9,122,74,196
2017,11,25,10,142,111,253
2017,11,25,11,147,138,285
2017,11,25,12,168,139,307
2017,11,25,13,180,202,382
2017,11,25,14,173,186,359
2017,11,25,15,152,160,312
2017,11,25,16,155,195,350
2017,11,25,17,147,178,325
2017,11,25,18,118,126,244
2017,11,25,19,80,120,200
2017,11,25,20,54,79,133
2017,11,25,21,56,77,133
2017,11,25,22,46,76,122
2017,11,25,23,53,60,113
2017,11,26,0,32,45,77
2017,11,26,1,31,56,87
2017,11,26,2,27,61,88
2017,11,26,3,24,44,68
2017,11,26,4,20,17,37
2017,11,26,5,12,12,24
2017,11,26,6,27,16,43
2017,11,26,7,27,16,43
2017,11,26,8,54,40,94
2017,11,26,9,109,50,159
2017,11,26,10,117,85,202
2017,11,26,11,138,147,285
2017,11,26,12,161,180,341
2017,11,26,13,204,188,392
2017,11,26,14,174,214,388
2017,11,26,15,207,218,425
2017,11,26,16,164,207,371
2017,11,26,17,149,149,298
2017,11,26,18,139,177,316
2017,11,26,19,138,129,267
2017,11,26,20,97,100,197
2017,11,26,21,62,60,122
2017,11,26,22,32,36,68
2017,11,26,23,25,25,50
2017,11,27,0,6,20,26
2017,11,27,1,5,10,15
2017,11,27,2,11,14,25
2017,11,27,3,8,7,15
2017,11,27,4,21,13,34
2017,11,27,5,129,64,193
2017,11,27,6,243,167,410
2017,11,27,7,376,206,582
2017,11,27,8,283,164,447
2017,11,27,9,200,166,366
2017,11,27,10,238,183,421
2017,11,27,11,241,215,456
2017,11,27,12,235,221,456
2017,11,27,13,230,274,504
2017,11,27,14,255,342,597
2017,11,27,15,249,307,556
2017,11,27,16,191,188,379
2017,11,27,17,175,155,330
2017,11,27,18,131,147,278
2017,11,27,19,108,130,238
2017,11,27,20,80,97,177
2017,11,27,21,60,84,144
2017,11,27,22,33,54,87
2017,11,27,23,17,15,32
2017,11,28,0,7,16,23
2017,11,28,1,10,8,18
2017,11,28,2,7,3,10
2017,11,28,3,9,9,18
2017,11,28,4,24,17,41
2017,11,28,5,117,59,176
2017,11,28,6,233,133,366
2017,11,28,7,369,213,582
2017,11,28,8,258,161,419
2017,11,28,9,230,163,393
2017,11,28,10,221,162,383
2017,11,28,11,234,210,444
2017,11,28,12,237,231,468
2017,11,28,13,260,271,531
2017,11,28,14,258,305,563
2017,11,28,15,230,302,532
2017,11,28,16,205,182,387
2017,11,28,17,177,173,350
2017,11,28,18,141,132,273
2017,11,28,19,114,147,261
2017,11,28,20,84,122,206
2017,11,28,21,74,84,158
2017,11,28,22,31,49,80
2017,11,28,23,20,35,55
2017,11,29,0,13,14,27
2017,11,29,1,6,14,20
2017,11,29,2,4,14,18
2017,11,29,3,14,8,22
2017,11,29,4,15,15,30
2017,11,29,5,122,57,179
2017,11,29,6,244,145,389
2017,11,29,7,420,221,641
2017,11,29,8,265,157,422
2017,11,29,9,188,158,346
2017,11,29,10,238,176,414
2017,11,29,11,230,190,420
2017,11,29,12,207,222,429
2017,11,29,13,244,238,482
2017,11,29,14,244,334,578
2017,11,29,15,237,315,552
2017,11,29,16,192,175,367
2017,11,29,17,177,179,356
2017,11,29,18,137,161,298
2017,11,29,19,109,129,238
2017,11,29,20,93,104,197
2017,11,29,21,53,110,163
2017,11,29,22,41,76,117
2017,11,29,23,13,29,42
2017,11,30,0,6,19,25
2017,11,30,1,10,25,35
2017,11,30,2,8,20,28
2017,11,30,3,9,20,29
2017,11,30,4,14,16,30
2017,11,30,5,130,54,184
2017,11,30,6,236,155,391
2017,11,30,7,402,224,626
2017,11,30,8,243,150,393
2017,11,30,9,233,200,433
2017,11,30,10,237,185,422
2017,11,30,11,227,224,451
2017,11,30,12,224,221,445
2017,11,30,13,278,245,523
2017,11,30,14,260,345,605
2017,11,30,15,269,294,563
2017,11,30,16,219,188,407
2017,11,30,17,201,208,409
2017,11,30,18,155,174,329
2017,11,30,19,106,137,243
2017,11,30,20,90,130,220
2017,11,30,21,64,125,189
2017,11,30,22,38,77,115
2017,11,30,23,23,110,133
2017,12,1,0,15,35,50
2017,12,1,1,14,17,31
2017,12,1,2,11,24,35
2017,12,1,3,10,18,28
2017,12,1,4,12,19,31
2017,12,1,5,117,53,170
2017,12,1,6,234,133,367
2017,12,1,7,381,210,591
2017,12,1,8,255,144,399
2017,12,1,9,224,178,402
2017,12,1,10,241,192,433
2017,12,1,11,256,218,474
2017,12,1,12,246,202,448
2017,12,1,13,280,306,586
2017,12,1,14,271,384,655
2017,12,1,15,215,299,514
2017,12,1,16,198,211,409
2017,12,1,17,198,194,392
2017,12,1,18,137,156,293
2017,12,1,19,93,120,213
2017,12,1,20,63,88,151
2017,12,1,21,65,97,162
2017,12,1,22,65,90,155
2017,12,1,23,53,78,131
2017,12,2,0,32,54,86
2017,12,2,1,16,43,59
2017,12,2,2,19,37,56
2017,12,2,3,12,28,40
2017,12,2,4,8,18,26
2017,12,2,5,22,13,35
2017,12,2,6,31,23,54
2017,12,2,7,58,32,90
2017,12,2,8,60,59,119
2017,12,2,9,127,72,199
2017,12,2,10,129,124,253
2017,12,2,11,156,142,298
2017,12,2,12,184,153,337
2017,12,2,13,209,170,379
2017,12,2,14,251,195,446
2017,12,2,15,222,184,406
2017,12,2,16,142,378,520
2017,12,2,17,139,165,304
2017,12,2,18,102,170,272
2017,12,2,19,89,103,192
2017,12,2,20,72,91,163
2017,12,2,21,50,65,115
2017,12,2,22,44,68,112
2017,12,2,23,38,69,107
2017,12,3,0,40,48,88
2017,12,3,1,18,46,64
2017,12,3,2,17,57,74
2017,12,3,3,21,40,61
2017,12,3,4,16,26,42
2017,12,3,5,15,18,33
2017,12,3,6,15,13,28
2017,12,3,7,39,18,57
2017,12,3,8,49,44,93
2017,12,3,9,107,64,171
2017,12,3,10,127,98,225
2017,12,3,11,154,168,322
2017,12,3,12,171,166,337
2017,12,3,13,217,189,406
2017,12,3,14,165,215,380
2017,12,3,15,182,228,410
2017,12,3,16,165,215,380
2017,12,3,17,154,185,339
2017,12,3,18,114,150,264
2017,12,3,19,119,147,266
2017,12,3,20,78,113,191
2017,12,3,21,64,85,149
2017,12,3,22,31,46,77
2017,12,3,23,23,28,51
2017,12,4,0,6,18,24
2017,12,4,1,8,19,27
2017,12,4,2,5,16,21
2017,12,4,3,15,13,28
2017,12,4,4,17,18,35
2017,12,4,5,131,54,185
2017,12,4,6,242,152,394
2017,12,4,7,411,229,640
2017,12,4,8,276,187,463
2017,12,4,9,226,140,366
2017,12,4,10,238,177,415
2017,12,4,11,229,209,438
2017,12,4,12,216,218,434
2017,12,4,13,206,283,489
2017,12,4,14,267,351,618
2017,12,4,15,327,423,750
2017,12,4,16,237,207,444
2017,12,4,17,176,189,365
2017,12,4,18,124,137,261
2017,12,4,19,98,124,222
2017,12,4,20,78,129,207
2017,12,4,21,60,263,323
2017,12,4,22,33,173,206
2017,12,4,23,15,60,75
2017,12,5,0,13,43,56
2017,12,5,1,8,27,35
2017,12,5,2,6,26,32
2017,12,5,3,10,30,40
2017,12,5,4,18,17,35
2017,12,5,5,134,56,190
2017,12,5,6,239,166,405
2017,12,5,7,393,244,637
2017,12,5,8,304,144,448
2017,12,5,9,206,172,378
2017,12,5,10,209,196,405
2017,12,5,11,237,195,432
2017,12,5,12,194,223,417
2017,12,5,13,223,252,475
2017,12,5,14,252,321,573
2017,12,5,15,234,284,518
2017,12,5,16,209,184,393
2017,12,5,17,220,176,396
2017,12,5,18,152,160,312
2017,12,5,19,122,133,255
2017,12,5,20,72,115,187
2017,12,5,21,56,83,139
2017,12,5,22,44,96,140
2017,12,5,23,21,23,44
2017,12,6,0,13,17,30
2017,12,6,1,4,12,16
2017,12,6,2,5,12,17
2017,12,6,3,7,8,15
2017,12,6,4,17,13,30
2017,12,6,5,125,59,184
2017,12,6,6,239,153,392
2017,12,6,7,389,200,589
2017,12,6,8,302,177,479
2017,12,6,9,221,181,402
2017,12,6,10,226,184,410
2017,12,6,11,254,209,463
2017,12,6,12,229,231,460
2017,12,6,13,243,247,490
2017,12,6,14,260,341,601
2017,12,6,15,245,300,545
2017,12,6,16,182,175,357
2017,12,6,17,177,159,336
2017,12,6,18,152,139,291
2017,12,6,19,111,121,232
2017,12,6,20,103,146,249
2017,12,6,21,68,128,196
2017,12,6,22,30,57,87
2017,12,6,23,20,40,60
2017,12,7,0,19,22,41
2017,12,7,1,6,18,24
2017,12,7,2,11,28,39
2017,12,7,3,7,11,18
2017,12,7,4,15,13,28
2017,12,7,5,114,50,164
2017,12,7,6,257,170,427
2017,12,7,7,445,326,771
2017,12,7,8,287,223,510
2017,12,7,9,244,167,411
2017,12,7,10,256,199,455
2017,12,7,11,212,222,434
2017,12,7,12,245,225,470
2017,12,7,13,251,260,511
2017,12,7,14,275,379,654
2017,12,7,15,246,327,573
2017,12,7,16,229,197,426
2017,12,7,17,202,195,397
2017,12,7,18,151,171,322
2017,12,7,19,125,137,262
2017,12,7,20,84,132,216
2017,12,7,21,73,380,453
2017,12,7,22,31,73,104
2017,12,7,23,18,29,47
2017,12,8,0,18,36,54
2017,12,8,1,10,25,35
2017,12,8,2,11,23,34
2017,12,8,3,9,15,24
2017,12,8,4,24,19,43
2017,12,8,5,106,60,166
2017,12,8,6,257,147,404
2017,12,8,7,394,228,622
2017,12,8,8,284,215,499
2017,12,8,9,272,169,441
2017,12,8,10,233,200,433
2017,12,8,11,239,199,438
2017,12,8,12,250,261,511
2017,12,8,13,290,311,601
2017,12,8,14,353,444,797
2017,12,8,15,267,342,609
2017,12,8,16,200,199,399
2017,12,8,17,195,179,374
2017,12,8,18,141,175,316
2017,12,8,19,95,159,254
2017,12,8,20,82,87,169
2017,12,8,21,67,80,147
2017,12,8,22,50,91,141
2017,12,8,23,48,72,120
2017,12,9,0,36,59,95
2017,12,9,1,31,44,75
2017,12,9,2,25,37,62
2017,12,9,3,19,44,63
2017,12,9,4,20,21,41
2017,12,9,5,11,8,19
2017,12,9,6,31,19,50
2017,12,9,7,47,34,81
2017,12,9,8,76,66,142
2017,12,9,9,116,85,201
2017,12,9,10,170,97,267
2017,12,9,11,189,137,326
2017,12,9,12,198,180,378
2017,12,9,13,189,206,395
2017,12,9,14,159,229,388
2017,12,9,15,148,199,347
2017,12,9,16,148,170,318
2017,12,9,17,143,173,316
2017,12,9,18,115,133,248
2017,12,9,19,80,105,185
2017,12,9,20,50,88,138
2017,12,9,21,67,73,140
2017,12,9,22,53,57,110
2017,12,9,23,45,68,113
2017,12,10,0,43,59,102
2017,12,10,1,34,52,86
2017,12,10,2,36,46,82
2017,12,10,3,20,43,63
2017,12,10,4,17,24,41
2017,12,10,5,18,11,29
2017,12,10,6,21,27,48
2017,12,10,7,29,21,50
2017,12,10,8,47,40,87
2017,12,10,9,92,62,154
2017,12,10,10,120,89,209
2017,12,10,11,153,111,264
2017,12,10,12,177,161,338
2017,12,10,13,219,173,392
2017,12,10,14,152,158,310
2017,12,10,15,138,177,315
2017,12,10,16,145,165,310
2017,12,10,17,136,158,294
2017,12,10,18,145,150,295
2017,12,10,19,102,129,231
2017,12,10,20,60,98,158
2017,12,10,21,46,80,126
2017,12,10,22,44,48,92
2017,12,10,23,20,29,49
2017,12,11,0,10,18,28
2017,12,11,1,10,22,32
2017,12,11,2,8,14,22
2017,12,11,3,22,12,34
2017,12,11,4,20,11,31
2017,12,11,5,117,66,183
2017,12,11,6,258,151,409
2017,12,11,7,384,197,581
2017,12,11,8,275,175,450
2017,12,11,9,227,189,416
2017,12,11,10,196,183,379
2017,12,11,11,229,203,432
2017,12,11,12,224,181,405
2017,12,11,13,225,253,478
2017,12,11,14,237,325,562
2017,12,11,15,233,319,552
2017,12,11,16,217,192,409
2017,12,11,17,191,161,352
2017,12,11,18,127,143,270
2017,12,11,19,111,138,249
2017,12,11,20,66,120,186
2017,12,11,21,79,103,182
2017,12,11,22,47,70,117
2017,12,11,23,16,24,40
2017,12,12,0,13,13,26
2017,12,12,1,9,17,26
2017,12,12,2,13,12,25
2017,12,12,3,14,13,27
2017,12,12,4,17,16,33
2017,12,12,5,113,56,169
2017,12,12,6,235,155,390
2017,12,12,7,413,200,613
2017,12,12,8,250,185,435
2017,12,12,9,226,165,391
2017,12,12,10,243,203,446
2017,12,12,11,235,210,445
2017,12,12,12,260,227,487
2017,12,12,13,212,246,458
2017,12,12,14,249,333,582
2017,12,12,15,252,277,529
2017,12,12,16,192,182,374
2017,12,12,17,181,167,348
2017,12,12,18,152,156,308
2017,12,12,19,124,133,257
2017,12,12,20,88,140,228
2017,12,12,21,66,379,445
2017,12,12,22,31,267,298
2017,12,12,23,16,60,76
2017,12,13,0,18,20,38
2017,12,13,1,12,34,46
2017,12,13,2,11,24,35
2017,12,13,3,18,16,34
2017,12,13,4,14,21,35
2017,12,13,5,107,44,151
2017,12,13,6,244,162,406
2017,12,13,7,374,183,557
2017,12,13,8,306,174,480
2017,12,13,9,251,184,435
2017,12,13,10,235,194,429
2017,12,13,11,253,197,450
2017,12,13,12,244,245,489
2017,12,13,13,235,274,509
2017,12,13,14,265,307,572
2017,12,13,15,221,292,513
2017,12,13,16,206,188,394
2017,12,13,17,179,171,350
2017,12,13,18,157,161,318
2017,12,13,19,123,121,244
2017,12,13,20,62,119,181
2017,12,13,21,69,124,193
2017,12,13,22,41,74,115
2017,12,13,23,27,49,76
2017,12,14,0,15,31,46
2017,12,14,1,10,32,42
2017,12,14,2,13,30,43
2017,12,14,3,12,16,28
2017,12,14,4,19,19,38
2017,12,14,5,101,54,155
2017,12,14,6,259,139,398
2017,12,14,7,427,190,617
2017,12,14,8,269,178,447
2017,12,14,9,252,216,468
2017,12,14,10,247,191,438
2017,12,14,11,264,247,511
2017,12,14,12,236,235,471
2017,12,14,13,272,264,536
2017,12,14,14,264,366,630
2017,12,14,15,290,351,641
2017,12,14,16,216,225,441
2017,12,14,17,203,174,377
2017,12,14,18,149,166,315
2017,12,14,19,129,152,281
2017,12,14,20,88,119,207
2017,12,14,21,64,117,181
2017,12,14,22,48,91,139
2017,12,14,23,30,60,90
2017,12,15,0,25,49,74
2017,12,15,1,19,39,58
2017,12,15,2,13,34,47
2017,12,15,3,13,20,33
2017,12,15,4,17,16,33
2017,12,15,5,112,52,164
2017,12,15,6,217,149,366
2017,12,15,7,356,199,555
2017,12,15,8,294,180,474
2017,12,15,9,259,183,442
2017,12,15,10,265,206,471
2017,12,15,11,275,256,531
2017,12,15,12,288,266,554
2017,12,15,13,304,292,596
2017,12,15,14,280,384,664
2017,12,15,15,240,294,534
2017,12,15,16,191,204,395
2017,12,15,17,165,171,336
2017,12,15,18,148,167,315
2017,12,15,19,133,156,289
2017,12,15,20,50,103,153
2017,12,15,21,64,99,163
2017,12,15,22,41,84,125
2017,12,15,23,38,64,102
2017,12,16,0,35,41,76
2017,12,16,1,27,51,78
2017,12,16,2,21,43,64
2017,12,16,3,14,33,47
2017,12,16,4,14,19,33
2017,12,16,5,23,14,37
2017,12,16,6,33,19,52
2017,12,16,7,31,30,61
2017,12,16,8,50,37,87
2017,12,16,9,106,76,182
2017,12,16,10,137,113,250
2017,12,16,11,202,153,355
2017,12,16,12,345,198,543
2017,12,16,13,384,218,602
2017,12,16,14,284,249,533
2017,12,16,15,174,227,401
2017,12,16,16,148,201,349
2017,12,16,17,135,145,280
2017,12,16,18,102,166,268
2017,12,16,19,98,125,223
2017,12,16,20,69,95,164
2017,12,16,21,52,73,125
2017,12,16,22,54,70,124
2017,12,16,23,42,75,117
2017,12,17,0,43,59,102
2017,12,17,1,31,46,77
2017,12,17,2,28,54,82
2017,12,17,3,26,48,74
2017,12,17,4,18,23,41
2017,12,17,5,20,18,38
2017,12,17,6,15,13,28
2017,12,17,7,28,14,42
2017,12,17,8,61,38,99
2017,12,17,9,81,57,138
2017,12,17,10,130,80,210
2017,12,17,11,172,168,340
2017,12,17,12,231,185,416
2017,12,17,13,204,175,379
2017,12,17,14,174,168,342
2017,12,17,15,182,240,422
2017,12,17,16,160,165,325
2017,12,17,17,102,118,220
2017,12,17,18,148,174,322
2017,12,17,19,135,152,287
2017,12,17,20,89,111,200
2017,12,17,21,72,79,151
2017,12,17,22,34,37,71
2017,12,17,23,26,25,51
2017,12,18,0,9,15,24
2017,12,18,1,9,11,20
2017,12,18,2,4,10,14
2017,12,18,3,6,11,17
2017,12,18,4,19,16,35
2017,12,18,5,95,58,153
2017,12,18,6,222,138,360
2017,12,18,7,412,191,603
2017,12,18,8,272,162,434
2017,12,18,9,241,195,436
2017,12,18,10,231,197,428
2017,12,18,11,238,234,472
2017,12,18,12,236,213,449
2017,12,18,13,251,266,517
2017,12,18,14,265,351,616
2017,12,18,15,261,393,654
2017,12,18,16,187,206,393
2017,12,18,17,156,148,304
2017,12,18,18,115,148,263
2017,12,18,19,121,128,249
2017,12,18,20,85,107,192
2017,12,18,21,64,63,127
2017,12,18,22,29,65,94
2017,12,18,23,26,68,94
2017,12,19,0,16,26,42
2017,12,19,1,18,21,39
2017,12,19,2,4,11,15
2017,12,19,3,16,12,28
2017,12,19,4,22,11,33
2017,12,19,5,111,55,166
2017,12,19,6,222,141,363
2017,12,19,7,380,189,569
2017,12,19,8,278,149,427
2017,12,19,9,231,186,417
2017,12,19,10,277,219,496
2017,12,19,11,224,236,460
2017,12,19,12,238,257,495
2017,12,19,13,275,294,569
2017,12,19,14,279,396,675
2017,12,19,15,262,333,595
2017,12,19,16,187,182,369
2017,12,19,17,161,164,325
2017,12,19,18,135,151,286
2017,12,19,19,109,189,298
2017,12,19,20,81,123,204
2017,12,19,21,71,85,156
2017,12,19,22,36,51,87
2017,12,19,23,30,27,57
2017,12,20,0,18,25,43
2017,12,20,1,13,22,35
2017,12,20,2,6,21,27
2017,12,20,3,16,15,31
2017,12,20,4,20,18,38
2017,12,20,5,109,46,155
2017,12,20,6,243,136,379
2017,12,20,7,366,178,544
2017,12,20,8,278,148,426
2017,12,20,9,244,215,459
2017,12,20,10,250,213,463
2017,12,20,11,274,233,507
2017,12,20,12,259,270,529
2017,12,20,13,283,366,649
2017,12,20,14,267,369,636
2017,12,20,15,282,340,622
2017,12,20,16,195,225,420
2017,12,20,17,166,175,341
2017,12,20,18,146,153,299
2017,12,20,19,110,202,312
2017,12,20,20,100,106,206
2017,12,20,21,69,89,158
2017,12,20,22,45,71,116
2017,12,20,23,33,40,73
2017,12,21,0,21,42,63
2017,12,21,1,13,45,58
2017,12,21,2,14,32,46
2017,12,21,3,16,21,37
2017,12,21,4,14,23,37
2017,12,21,5,96,45,141
2017,12,21,6,209,120,329
2017,12,21,7,262,155,417
2017,12,21,8,257,144,401
2017,12,21,9,278,202,480
2017,12,21,10,280,213,493
2017,12,21,11,286,242,528
2017,12,21,12,275,262,537
2017,12,21,13,304,325,629
2017,12,21,14,284,392,676
2017,12,21,15,238,344,582
2017,12,21,16,219,235,454
2017,12,21,17,181,191,372
2017,12,21,18,134,191,325
2017,12,21,19,129,168,297
2017,12,21,20,103,114,217
2017,12,21,21,85,471,556
2017,12,21,22,34,478,512
2017,12,21,23,38,167,205
2017,12,22,0,22,33,55
2017,12,22,1,13,24,37
2017,12,22,2,12,32,44
2017,12,22,3,15,22,37
2017,12,22,4,19,18,37
2017,12,22,5,90,40,130
2017,12,22,6,171,109,280
2017,12,22,7,223,121,344
2017,12,22,8,213,147,360
2017,12,22,9,211,185,396
2017,12,22,10,277,213,490
2017,12,22,11,264,254,518
2017,12,22,12,290,236,526
2017,12,22,13,289,335,624
2017,12,22,14,353,391,744
2017,12,22,15,195,289,484
2017,12,22,16,170,171,341
2017,12,22,17,154,143,297
2017,12,22,18,139,140,279
2017,12,22,19,96,121,217
2017,12,22,20,69,92,161
2017,12,22,21,56,63,119
2017,12,22,22,52,67,119
2017,12,22,23,41,59,100
2017,12,23,0,26,31,57
2017,12,23,1,23,29,52
2017,12,23,2,18,38,56
2017,12,23,3,21,31,52
2017,12,23,4,15,20,35
2017,12,23,5,20,15,35
2017,12,23,6,20,22,42
2017,12,23,7,22,33,55
2017,12,23,8,50,44,94
2017,12,23,9,83,78,161
2017,12,23,10,115,105,220
2017,12,23,11,176,162,338
2017,12,23,12,179,150,329
2017,12,23,13,180,177,357
2017,12,23,14,170,175,345
2017,12,23,15,124,135,259
2017,12,23,16,123,130,253
2017,12,23,17,111,122,233
2017,12,23,18,80,94,174
2017,12,23,19,82,74,156
2017,12,23,20,61,71,132
2017,12,23,21,55,63,118
2017,12,23,22,36,44,80
2017,12,23,23,17,37,54
2017,12,24,0,13,22,35
2017,12,24,1,12,11,23
2017,12,24,2,8,12,20
2017,12,24,3,7,10,17
2017,12,24,4,8,6,14
2017,12,24,5,12,4,16
2017,12,24,6,13,15,28
2017,12,24,7,22,12,34
2017,12,24,8,28,35,63
2017,12,24,9,73,50,123
2017,12,24,10,110,89,199
2017,12,24,11,108,127,235
2017,12,24,12,152,111,263
2017,12,24,13,152,130,282
2017,12,24,14,163,137,300
2017,12,24,15,154,139,293
2017,12,24,16,83,80,163
2017,12,24,17,49,42,91
2017,12,24,18,25,37,62
2017,12,24,19,59,40,99
2017,12,24,20,44,61,105
2017,12,24,21,76,125,201
2017,12,24,22,87,64,151
2017,12,24,23,66,62,128
2017,12,25,0,27,36,63
2017,12,25,1,12,18,30
2017,12,25,2,7,9,16
2017,12,25,3,8,6,14
2017,12,25,4,4,5,9
2017,12,25,5,10,7,17
2017,12,25,6,11,12,23
2017,12,25,7,11,11,22
2017,12,25,8,10,10,20
2017,12,25,9,30,23,53
2017,12,25,10,45,30,75
2017,12,25,11,59,93,152
2017,12,25,12,95,100,195
2017,12,25,13,137,124,261
2017,12,25,14,111,97,208
2017,12,25,15,82,125,207
2017,12,25,16,98,78,176
2017,12,25,17,80,80,160
2017,12,25,18,71,69,140
2017,12,25,19,66,86,152
2017,12,25,20,62,68,130
2017,12,25,21,45,69,114
2017,12,25,22,28,31,59
2017,12,25,23,14,25,39
2017,12,26,0,16,24,40
2017,12,26,1,19,17,36
2017,12,26,2,10,16,26
2017,12,26,3,5,16,21
2017,12,26,4,6,7,13
2017,12,26,5,10,13,23
2017,12,26,6,14,10,24
2017,12,26,7,13,15,28
2017,12,26,8,22,21,43
2017,12,26,9,33,28,61
2017,12,26,10,68,58,126
2017,12,26,11,75,94,169
2017,12,26,12,97,105,202
2017,12,26,13,109,131,240
2017,12,26,14,121,137,258
2017,12,26,15,108,111,219
2017,12,26,16,90,104,194
2017,12,26,17,102,99,201
2017,12,26,18,113,132,245
2017,12,26,19,120,117,237
2017,12,26,20,84,100,184
2017,12,26,21,61,58,119
2017,12,26,22,35,52,87
2017,12,26,23,26,44,70
2017,12,27,0,22,33,55
2017,12,27,1,22,44,66
2017,12,27,2,18,38,56
2017,12,27,3,19,43,62
2017,12,27,4,21,29,50
2017,12,27,5,53,33,86
2017,12,27,6,73,66,139
2017,12,27,7,99,67,166
2017,12,27,8,119,70,189
2017,12,27,9,120,80,200
2017,12,27,10,134,95,229
2017,12,27,11,167,149,316
2017,12,27,12,193,154,347
2017,12,27,13,193,206,399
2017,12,27,14,183,169,352
2017,12,27,15,150,159,309
2017,12,27,16,126,156,282
2017,12,27,17,119,95,214
2017,12,27,18,91,89,180
2017,12,27,19,88,100,188
2017,12,27,20,59,79,138
2017,12,27,21,44,68,112
2017,12,27,22,41,50,91
2017,12,27,23,26,38,64
2017,12,28,0,16,18,34
2017,12,28,1,14,25,39
2017,12,28,2,11,17,28
2017,12,28,3,7,21,28
2017,12,28,4,16,16,32
2017,12,28,5,42,21,63
2017,12,28,6,89,56,145
2017,12,28,7,92,72,164
2017,12,28,8,115,78,193
2017,12,28,9,111,71,182
2017,12,28,10,165,109,274
2017,12,28,11,143,115,258
2017,12,28,12,172,148,320
2017,12,28,13,201,169,370
2017,12,28,14,156,194,350
2017,12,28,15,146,147,293
2017,12,28,16,155,137,292
2017,12,28,17,112,118,230
2017,12,28,18,126,115,241
2017,12,28,19,68,132,200
2017,12,28,20,70,88,158
2017,12,28,21,36,63,99
2017,12,28,22,37,45,82
2017,12,28,23,26,35,61
2017,12,29,0,22,37,59
2017,12,29,1,15,18,33
2017,12,29,2,12,24,36
2017,12,29,3,8,16,24
2017,12,29,4,13,14,27
2017,12,29,5,47,19,66
2017,12,29,6,72,53,125
2017,12,29,7,94,64,158
2017,12,29,8,112,75,187
2017,12,29,9,129,87,216
2017,12,29,10,149,114,263
2017,12,29,11,165,156,321
2017,12,29,12,197,162,359
2017,12,29,13,178,177,355
2017,12,29,14,166,176,342
2017,12,29,15,105,140,245
2017,12,29,16,129,101,230
2017,12,29,17,107,87,194
2017,12,29,18,110,88,198
2017,12,29,19,76,87,163
2017,12,29,20,53,86,139
2017,12,29,21,48,82,130
2017,12,29,22,37,60,97
2017,12,29,23,26,32,58
2017,12,30,0,24,42,66
2017,12,30,1,24,31,55
2017,12,30,2,22,37,59
2017,12,30,3,10,29,39
2017,12,30,4,8,11,19
2017,12,30,5,13,12,25
2017,12,30,6,21,22,43
2017,12,30,7,21,20,41
2017,12,30,8,38,27,65
2017,12,30,9,59,50,109
2017,12,30,10,86,59,145
2017,12,30,11,99,95,194
2017,12,30,12,134,94,228
2017,12,30,13,107,117,224
2017,12,30,14,125,142,267
2017,12,30,15,111,123,234
2017,12,30,16,132,100,232
2017,12,30,17,96,86,182
2017,12,30,18,88,82,170
2017,12,30,19,67,97,164
2017,12,30,20,67,65,132
2017,12,30,21,42,60,102
2017,12,30,22,44,55,99
2017,12,30,23,29,61,90
2017,12,31,0,19,28,47
2017,12,31,1,17,26,43
2017,12,31,2,22,39,61
2017,12,31,3,8,19,27
2017,12,31,4,7,7,14
2017,12,31,5,9,8,17
2017,12,31,6,6,12,18
2017,12,31,7,22,13,35
2017,12,31,8,23,32,55
2017,12,31,9,42,39,81
2017,12,31,10,39,42,81
2017,12,31,11,92,107,199
2017,12,31,12,130,113,243
2017,12,31,13,137,125,262
2017,12,31,14,126,148,274
2017,12,31,15,126,155,281
2017,12,31,16,127,125,252
2017,12,31,17,114,100,214
2017,12,31,18,80,94,174
2017,12,31,19,80,81,161
2017,12,31,20,63,71,134
2017,12,31,21,62,71,133
2017,12,31,22,61,44,105
2017,12,31,23,48,96,144
2018,1,1,0,71,81,152
2018,1,1,1,68,73,141
2018,1,1,2,41,61,102
2018,1,1,3,35,46,81
2018,1,1,4,22,31,53
2018,1,1,5,23,30,53
2018,1,1,6,20,28,48
2018,1,1,7,15,12,27
2018,1,1,8,19,13,32
2018,1,1,9,26,12,38
2018,1,1,10,32,34,66
2018,1,1,11,57,66,123
2018,1,1,12,77,73,150
2018,1,1,13,120,93,213
2018,1,1,14,112,140,252
2018,1,1,15,126,129,255
2018,1,1,16,117,115,232
2018,1,1,17,110,109,219
2018,1,1,18,104,110,214
2018,1,1,19,87,94,181
2018,1,1,20,80,79,159
2018,1,1,21,37,48,85
2018,1,1,22,26,22,48
2018,1,1,23,19,18,37
2018,1,2,0,12,22,34
2018,1,2,1,9,17,26
2018,1,2,2,8,5,13
2018,1,2,3,4,5,9
2018,1,2,4,22,6,28
2018,1,2,5,117,53,170
2018,1,2,6,228,138,366
2018,1,2,7,351,174,525
2018,1,2,8,199,127,326
2018,1,2,9,180,131,311
2018,1,2,10,178,129,307
2018,1,2,11,208,153,361
2018,1,2,12,195,172,367
2018,1,2,13,180,223,403
2018,1,2,14,204,320,524
2018,1,2,15,207,257,464
2018,1,2,16,121,165,286
2018,1,2,17,144,107,251
2018,1,2,18,108,115,223
2018,1,2,19,86,96,182
2018,1,2,20,73,80,153
2018,1,2,21,61,66,127
2018,1,2,22,34,45,79
2018,1,2,23,16,23,39
2018,1,3,0,12,24,36
2018,1,3,1,7,10,17
2018,1,3,2,1,7,8
2018,1,3,3,9,9,18
2018,1,3,4,23,13,36
2018,1,3,5,106,38,144
2018,1,3,6,233,131,364
2018,1,3,7,379,183,562
2018,1,3,8,210,132,342
2018,1,3,9,202,141,343
2018,1,3,10,216,174,390
2018,1,3,11,191,204,395
2018,1,3,12,218,185,403
2018,1,3,13,230,240,470
2018,1,3,14,205,329,534
2018,1,3,15,207,269,476
2018,1,3,16,139,169,308
2018,1,3,17,145,134,279
2018,1,3,18,110,134,244
2018,1,3,19,92,114,206
2018,1,3,20,82,99,181
2018,1,3,21,53,64,117
2018,1,3,22,25,40,65
2018,1,3,23,17,27,44
2018,1,4,0,19,21,40
2018,1,4,1,7,9,16
2018,1,4,2,3,13,16
2018,1,4,3,8,9,17
2018,1,4,4,10,10,20
2018,1,4,5,97,43,140
2018,1,4,6,238,132,370
2018,1,4,7,392,172,564
2018,1,4,8,231,159,390
2018,1,4,9,207,144,351
2018,1,4,10,215,138,353
2018,1,4,11,199,176,375
2018,1,4,12,203,206,409
2018,1,4,13,223,261,484
2018,1,4,14,205,331,536
2018,1,4,15,196,292,488
2018,1,4,16,184,183,367
2018,1,4,17,172,137,309
2018,1,4,18,109,128,237
2018,1,4,19,105,127,232
2018,1,4,20,74,129,203
2018,1,4,21,51,80,131
2018,1,4,22,30,53,83
2018,1,4,23,20,26,46
2018,1,5,0,13,23,36
2018,1,5,1,11,23,34
2018,1,5,2,5,20,25
2018,1,5,3,7,12,19
2018,1,5,4,19,13,32
2018,1,5,5,101,44,145
2018,1,5,6,231,138,369
2018,1,5,7,367,168,535
2018,1,5,8,270,169,439
2018,1,5,9,217,151,368
2018,1,5,10,215,163,378
2018,1,5,11,182,190,372
2018,1,5,12,214,204,418
2018,1,5,13,245,267,512
2018,1,5,14,253,373,626
2018,1,5,15,205,278,483
2018,1,5,16,150,172,322
2018,1,5,17,138,137,275
2018,1,5,18,120,109,229
2018,1,5,19,80,103,183
2018,1,5,20,76,63,139
2018,1,5,21,46,53,99
2018,1,5,22,58,63,121
2018,1,5,23,26,50,76
2018,1,6,0,16,28,44
2018,1,6,1,23,49,72
2018,1,6,2,16,35,51
2018,1,6,3,19,16,35
2018,1,6,4,8,7,15
2018,1,6,5,12,13,25
2018,1,6,6,24,18,42
2018,1,6,7,37,32,69
2018,1,6,8,44,33,77
2018,1,6,9,84,59,143
2018,1,6,10,113,82,195
2018,1,6,11,126,117,243
2018,1,6,12,138,145,283
2018,1,6,13,156,130,286
2018,1,6,14,161,170,331
2018,1,6,15,150,140,290
2018,1,6,16,112,135,247
2018,1,6,17,141,156,297
2018,1,6,18,111,120,231
2018,1,6,19,81,84,165
2018,1,6,20,73,69,142
2018,1,6,21,52,62,114
2018,1,6,22,60,71,131
2018,1,6,23,42,64,106
2018,1,7,0,33,38,71
2018,1,7,1,32,52,84
2018,1,7,2,30,53,83
2018,1,7,3,20,48,68
2018,1,7,4,15,8,23
2018,1,7,5,14,18,32
2018,1,7,6,11,16,27
2018,1,7,7,21,13,34
2018,1,7,8,42,21,63
2018,1,7,9,79,37,116
2018,1,7,10,89,57,146
2018,1,7,11,117,103,220
2018,1,7,12,130,112,242
2018,1,7,13,161,151,312
2018,1,7,14,174,193,367
2018,1,7,15,182,220,402
2018,1,7,16,138,167,305
2018,1,7,17,134,144,278
2018,1,7,18,145,158,303
2018,1,7,19,100,132,232
2018,1,7,20,81,96,177
2018,1,7,21,43,64,107
2018,1,7,22,27,44,71
2018,1,7,23,14,18,32
2018,1,8,0,5,20,25
2018,1,8,1,4,10,14
2018,1,8,2,9,9,18
2018,1,8,3,11,9,20
2018,1,8,4,16,17,33
2018,1,8,5,129,46,175
2018,1,8,6,250,144,394
2018,1,8,7,401,199,600
2018,1,8,8,244,161,405
2018,1,8,9,209,151,360
2018,1,8,10,200,175,375
2018,1,8,11,198,195,393
2018,1,8,12,218,218,436
2018,1,8,13,206,238,444
2018,1,8,14,230,313,543
2018,1,8,15,234,317,551
2018,1,8,16,185,190,375
2018,1,8,17,147,135,282
2018,1,8,18,121,126,247
2018,1,8,19,104,126,230
2018,1,8,20,86,113,199
2018,1,8,21,51,87,138
2018,1,8,22,26,43,69
2018,1,8,23,19,31,50
2018,1,9,0,7,16,23
2018,1,9,1,3,11,14
2018,1,9,2,4,14,18
2018,1,9,3,7,9,16
2018,1,9,4,18,15,33
2018,1,9,5,105,46,151
2018,1,9,6,242,158,400
2018,1,9,7,393,207,600
2018,1,9,8,246,159,405
2018,1,9,9,200,161,361
2018,1,9,10,230,182,412
2018,1,9,11,203,201,404
2018,1,9,12,231,173,404
2018,1,9,13,219,264,483
2018,1,9,14,236,369,605
2018,1,9,15,244,304,548
2018,1,9,16,173,191,364
2018,1,9,17,160,148,308
2018,1,9,18,137,127,264
2018,1,9,19,105,130,235
2018,1,9,20,79,116,195
2018,1,9,21,47,110,157
2018,1,9,22,35,48,83
2018,1,9,23,16,19,35
2018,1,10,0,10,18,28
2018,1,10,1,8,20,28
2018,1,10,2,3,17,20
2018,1,10,3,6,11,17
2018,1,10,4,18,17,35
2018,1,10,5,103,48,151
2018,1,10,6,269,156,425
2018,1,10,7,374,199,573
2018,1,10,8,242,150,392
2018,1,10,9,205,174,379
2018,1,10,10,218,190,408
2018,1,10,11,218,184,402
2018,1,10,12,205,207,412
2018,1,10,13,233,229,462
2018,1,10,14,214,360,574
2018,1,10,15,235,322,557
2018,1,10,16,185,183,368
2018,1,10,17,176,157,333
2018,1,10,18,130,120,250
2018,1,10,19,117,121,238
2018,1,10,20,79,124,203
2018,1,10,21,70,80,150
2018,1,10,22,37,82,119
2018,1,10,23,11,61,72
2018,1,11,0,13,29,42
2018,1,11,1,3,11,14
2018,1,11,2,12,11,23
2018,1,11,3,7,13,20
2018,1,11,4,21,15,36
2018,1,11,5,105,39,144
2018,1,11,6,240,156,396
2018,1,11,7,369,197,566
2018,1,11,8,253,148,401
2018,1,11,9,207,179,386
2018,1,11,10,219,191,410
2018,1,11,11,198,212,410
2018,1,11,12,206,235,441
2018,1,11,13,235,242,477
2018,1,11,14,244,318,562
2018,1,11,15,221,281,502
2018,1,11,16,173,173,346
2018,1,11,17,178,153,331
2018,1,11,18,147,141,288
2018,1,11,19,101,137,238
2018,1,11,20,82,104,186
2018,1,11,21,69,99,168
2018,1,11,22,49,62,111
2018,1,11,23,27,27,54
2018,1,12,0,11,14,25
2018,1,12,1,9,21,30
2018,1,12,2,12,15,27
2018,1,12,3,13,16,29
2018,1,12,4,17,17,34
2018,1,12,5,111,41,152
2018,1,12,6,250,137,387
2018,1,12,7,342,189,531
2018,1,12,8,242,169,411
2018,1,12,9,231,178,409
2018,1,12,10,222,139,361
2018,1,12,11,244,215,459
2018,1,12,12,240,235,475
2018,1,12,13,230,264,494
2018,1,12,14,223,316,539
2018,1,12,15,213,273,486
2018,1,12,16,169,177,346
2018,1,12,17,154,156,310
2018,1,12,18,127,121,248
2018,1,12,19,82,95,177
2018,1,12,20,83,73,156
2018,1,12,21,56,103,159
2018,1,12,22,59,60,119
2018,1,12,23,33,40,73
2018,1,13,0,20,37,57
2018,1,13,1,25,46,71
2018,1,13,2,18,47,65
2018,1,13,3,12,26,38
2018,1,13,4,8,13,21
2018,1,13,5,22,12,34
2018,1,13,6,35,19,54
2018,1,13,7,43,36,79
2018,1,13,8,54,58,112
2018,1,13,9,90,70,160
2018,1,13,10,95,79,174
2018,1,13,11,144,107,251
2018,1,13,12,151,127,278
2018,1,13,13,126,141,267
2018,1,13,14,147,194,341
2018,1,13,15,132,157,289
2018,1,13,16,122,138,260
2018,1,13,17,143,160,303
2018,1,13,18,100,127,227
2018,1,13,19,75,82,157
2018,1,13,20,61,79,140
2018,1,13,21,32,73,105
2018,1,13,22,50,75,125
2018,1,13,23,40,73,113
2018,1,14,0,40,45,85
2018,1,14,1,21,47,68
2018,1,14,2,28,63,91
2018,1,14,3,19,50,69
2018,1,14,4,9,22,31
2018,1,14,5,15,13,28
2018,1,14,6,16,11,27
2018,1,14,7,24,10,34
2018,1,14,8,42,33,75
2018,1,14,9,90,68,158
2018,1,14,10,127,72,199
2018,1,14,11,124,133,257
2018,1,14,12,158,161,319
2018,1,14,13,181,211,392
2018,1,14,14,157,173,330
2018,1,14,15,163,225,388
2018,1,14,16,161,185,346
2018,1,14,17,142,125,267
2018,1,14,18,161,162,323
2018,1,14,19,112,157,269
2018,1,14,20,75,104,179
2018,1,14,21,67,91,158
2018,1,14,22,26,48,74
2018,1,14,23,14,18,32
2018,1,15,0,6,13,19
2018,1,15,1,5,7,12
2018,1,15,2,6,7,13
2018,1,15,3,11,11,22
2018,1,15,4,19,13,32
2018,1,15,5,129,58,187
2018,1,15,6,276,168,444
2018,1,15,7,393,222,615
2018,1,15,8,294,161,455
2018,1,15,9,229,179,408
2018,1,15,10,225,178,403
2018,1,15,11,195,205,400
2018,1,15,12,240,204,444
2018,1,15,13,262,250,512
2018,1,15,14,250,351,601
2018,1,15,15,217,325,542
2018,1,15,16,195,211,406
2018,1,15,17,209,166,375
2018,1,15,18,124,162,286
2018,1,15,19,101,133,234
2018,1,15,20,83,117,200
2018,1,15,21,62,72,134
2018,1,15,22,41,55,96
2018,1,15,23,20,27,47
2018,1,16,0,7,13,20
2018,1,16,1,5,9,14
2018,1,16,2,1,7,8
2018,1,16,3,6,7,13
2018,1,16,4,13,15,28
2018,1,16,5,108,43,151
2018,1,16,6,276,140,416
2018,1,16,7,392,196,588
2018,1,16,8,253,161,414
2018,1,16,9,223,214,437
2018,1,16,10,260,164,424
2018,1,16,11,219,171,390
2018,1,16,12,213,209,422
2018,1,16,13,221,266,487
2018,1,16,14,259,340,599
2018,1,16,15,204,289,493
2018,1,16,16,180,235,415
2018,1,16,17,183,153,336
2018,1,16,18,145,150,295
2018,1,16,19,101,131,232
2018,1,16,20,86,120,206
2018,1,16,21,72,94,166
2018,1,16,22,26,72,98
2018,1,16,23,16,45,61
2018,1,17,0,18,20,38
2018,1,17,1,15,22,37
2018,1,17,2,11,12,23
2018,1,17,3,7,9,16
2018,1,17,4,20,10,30
2018,1,17,5,120,48,168
2018,1,17,6,248,154,402
2018,1,17,7,382,196,578
2018,1,17,8,250,179,429
2018,1,17,9,239,142,381
2018,1,17,10,217,199,416
2018,1,17,11,221,207,428
2018,1,17,12,218,218,436
2018,1,17,13,219,250,469
2018,1,17,14,240,311,551
2018,1,17,15,206,285,491
2018,1,17,16,186,189,375
2018,1,17,17,176,150,326
2018,1,17,18,149,134,283
2018,1,17,19,96,127,223
2018,1,17,20,74,106,180
2018,1,17,21,75,254,329
2018,1,17,22,38,201,239
2018,1,17,23,14,75,89
2018,1,18,0,16,41,57
2018,1,18,1,11,42,53
2018,1,18,2,7,22,29
2018,1,18,3,18,18,36
2018,1,18,4,18,17,35
2018,1,18,5,110,54,164
2018,1,18,6,251,137,388
2018,1,18,7,362,192,554
2018,1,18,8,259,181,440
2018,1,18,9,227,177,404
2018,1,18,10,217,190,407
2018,1,18,11,183,219,402
2018,1,18,12,187,194,381
2018,1,18,13,243,231,474
2018,1,18,14,286,418,704
2018,1,18,15,268,383,651
2018,1,18,16,167,178,345
2018,1,18,17,168,161,329
2018,1,18,18,141,141,282
2018,1,18,19,106,107,213
2018,1,18,20,84,116,200
2018,1,18,21,57,90,147
2018,1,18,22,40,61,101
2018,1,18,23,16,34,50
2018,1,19,0,15,32,47
2018,1,19,1,14,26,40
2018,1,19,2,16,23,39
2018,1,19,3,14,28,42
2018,1,19,4,18,14,32
2018,1,19,5,110,62,172
2018,1,19,6,251,154,405
2018,1,19,7,397,194,591
2018,1,19,8,258,150,408
2018,1,19,9,224,164,388
2018,1,19,10,233,168,401
2018,1,19,11,213,205,418
2018,1,19,12,224,193,417
2018,1,19,13,270,303,573
2018,1,19,14,265,335,600
2018,1,19,15,195,331,526
2018,1,19,16,162,164,326
2018,1,19,17,139,146,285
2018,1,19,18,103,112,215
2018,1,19,19,112,92,204
2018,1,19,20,63,89,152
2018,1,19,21,53,82,135
2018,1,19,22,53,77,130
2018,1,19,23,29,65,94
2018,1,20,0,29,55,84
2018,1,20,1,20,51,71
2018,1,20,2,15,47,62
2018,1,20,3,8,24,32
2018,1,20,4,15,13,28
2018,1,20,5,22,16,38
2018,1,20,6,32,18,50
2018,1,20,7,55,27,82
2018,1,20,8,63,42,105
2018,1,20,9,101,70,171
2018,1,20,10,127,113,240
2018,1,20,11,140,117,257
2018,1,20,12,148,124,272
2018,1,20,13,159,145,304
2018,1,20,14,141,196,337
2018,1,20,15,137,135,272
2018,1,20,16,127,132,259
2018,1,20,17,139,119,258
2018,1,20,18,117,105,222
2018,1,20,19,93,108,201
2018,1,20,20,42,63,105
2018,1,20,21,50,57,107
2018,1,20,22,41,85,126
2018,1,20,23,44,57,101
2018,1,21,0,26,53,79
2018,1,21,1,28,56,84
2018,1,21,2,32,56,88
2018,1,21,3,18,47,65
2018,1,21,4,12,25,37
2018,1,21,5,14,15,29
2018,1,21,6,18,23,41
2018,1,21,7,17,16,33
2018,1,21,8,33,31,64
2018,1,21,9,75,67,142
2018,1,21,10,97,61,158
2018,1,21,11,109,136,245
2018,1,21,12,138,151,289
2018,1,21,13,163,157,320
2018,1,21,14,163,157,320
2018,1,21,15,137,195,332
2018,1,21,16,144,152,296
2018,1,21,17,146,116,262
2018,1,21,18,146,146,292
2018,1,21,19,106,131,237
2018,1,21,20,78,111,189
2018,1,21,21,55,87,142
2018,1,21,22,32,58,90
2018,1,21,23,20,27,47
2018,1,22,0,6,21,27
2018,1,22,1,5,11,16
2018,1,22,2,5,9,14
2018,1,22,3,7,10,17
2018,1,22,4,24,14,38
2018,1,22,5,120,52,172
2018,1,22,6,212,163,375
2018,1,22,7,415,202,617
2018,1,22,8,283,184,467
2018,1,22,9,199,153,352
2018,1,22,10,201,173,374
2018,1,22,11,196,205,401
2018,1,22,12,215,194,409
2018,1,22,13,199,228,427
2018,1,22,14,244,328,572
2018,1,22,15,241,293,534
2018,1,22,16,216,207,423
2018,1,22,17,203,168,371
2018,1,22,18,132,135,267
2018,1,22,19,95,122,217
2018,1,22,20,78,119,197
2018,1,22,21,74,81,155
2018,1,22,22,39,57,96
2018,1,22,23,30,27,57
2018,1,23,0,9,12,21
2018,1,23,1,6,5,11
2018,1,23,2,2,7,9
2018,1,23,3,11,10,21
2018,1,23,4,21,15,36
2018,1,23,5,110,49,159
2018,1,23,6,249,136,385
2018,1,23,7,398,210,608
2018,1,23,8,258,164,422
2018,1,23,9,226,162,388
2018,1,23,10,455,200,655
2018,1,23,11,489,219,708
2018,1,23,12,221,221,442
2018,1,23,13,241,270,511
2018,1,23,14,247,359,606
2018,1,23,15,279,328,607
2018,1,23,16,191,215,406
2018,1,23,17,189,150,339
2018,1,23,18,145,147,292
2018,1,23,19,131,160,291
2018,1,23,20,85,113,198
2018,1,23,21,67,87,154
2018,1,23,22,41,47,88
2018,1,23,23,10,20,30
2018,1,24,0,9,26,35
2018,1,24,1,3,27,30
2018,1,24,2,7,33,40
2018,1,24,3,13,30,43
2018,1,24,4,19,37,56
2018,1,24,5,114,42,156
2018,1,24,6,258,164,422
2018,1,24,7,394,202,596
2018,1,24,8,237,137,374
2018,1,24,9,238,137,375
2018,1,24,10,233,204,437
2018,1,24,11,245,214,459
2018,1,24,12,226,215,441
2018,1,24,13,261,271,532
2018,1,24,14,231,324,555
2018,1,24,15,239,298,537
2018,1,24,16,207,207,414
2018,1,24,17,198,175,373
2018,1,24,18,138,158,296
2018,1,24,19,116,150,266
2018,1,24,20,90,129,219
2018,1,24,21,77,98,175
2018,1,24,22,44,46,90
2018,1,24,23,18,31,49
2018,1,25,0,13,16,29
2018,1,25,1,3,18,21
2018,1,25,2,7,23,30
2018,1,25,3,8,9,17
2018,1,25,4,17,12,29
2018,1,25,5,125,47,172
2018,1,25,6,251,175,426
2018,1,25,7,404,195,599
2018,1,25,8,262,167,429
2018,1,25,9,238,188,426
2018,1,25,10,214,175,389
2018,1,25,11,230,199,429
2018,1,25,12,234,204,438
2018,1,25,13,227,268,495
2018,1,25,14,260,354,614
2018,1,25,15,236,329,565
2018,1,25,16,194,225,419
2018,1,25,17,205,169,374
2018,1,25,18,157,171,328
2018,1,25,19,108,133,241
2018,1,25,20,81,111,192
2018,1,25,21,79,84,163
2018,1,25,22,29,55,84
2018,1,25,23,20,44,64
2018,1,26,0,12,27,39
2018,1,26,1,12,24,36
2018,1,26,2,10,31,41
2018,1,26,3,12,15,27
2018,1,26,4,20,10,30
2018,1,26,5,104,48,152
2018,1,26,6,237,165,402
2018,1,26,7,397,223,620
2018,1,26,8,278,156,434
2018,1,26,9,222,174,396
2018,1,26,10,251,194,445
2018,1,26,11,248,224,472
2018,1,26,12,202,204,406
2018,1,26,13,222,286,508
2018,1,26,14,261,362,623
2018,1,26,15,240,299,539
2018,1,26,16,167,192,359
2018,1,26,17,156,137,293
2018,1,26,18,113,156,269
2018,1,26,19,84,117,201
2018,1,26,20,80,84,164
2018,1,26,21,57,66,123
2018,1,26,22,49,69,118
2018,1,26,23,36,61,97
2018,1,27,0,24,41,65
2018,1,27,1,29,38,67
2018,1,27,2,17,46,63
2018,1,27,3,14,30,44
2018,1,27,4,20,12,32
2018,1,27,5,19,14,33
2018,1,27,6,19,20,39
2018,1,27,7,42,33,75
2018,1,27,8,66,48,114
2018,1,27,9,99,69,168
2018,1,27,10,129,85,214
2018,1,27,11,161,117,278
2018,1,27,12,176,154,330
2018,1,27,13,161,187,348
2018,1,27,14,143,213,356
2018,1,27,15,133,175,308
2018,1,27,16,160,196,356
2018,1,27,17,139,141,280
2018,1,27,18,150,133,283
2018,1,27,19,81,110,191
2018,1,27,20,54,68,122
2018,1,27,21,52,72,124
2018,1,27,22,40,72,112
2018,1,27,23,48,62,110
2018,1,28,0,45,59,104
2018,1,28,1,38,80,118
2018,1,28,2,30,60,90
2018,1,28,3,12,39,51
2018,1,28,4,20,22,42
2018,1,28,5,17,17,34
2018,1,28,6,17,16,33
2018,1,28,7,32,21,53
2018,1,28,8,50,34,84
2018,1,28,9,93,56,149
2018,1,28,10,111,69,180
2018,1,28,11,164,140,304
2018,1,28,12,159,181,340
2018,1,28,13,187,193,380
2018,1,28,14,188,212,400
2018,1,28,15,133,208,341
2018,1,28,16,178,179,357
2018,1,28,17,137,150,287
2018,1,28,18,138,154,292
2018,1,28,19,121,143,264
2018,1,28,20,76,93,169
2018,1,28,21,47,63,110
2018,1,28,22,31,43,74
2018,1,28,23,19,22,41
2018,1,29,0,9,16,25
2018,1,29,1,12,12,24
2018,1,29,2,3,13,16
2018,1,29,3,8,2,10
2018,1,29,4,21,16,37
2018,1,29,5,123,56,179
2018,1,29,6,235,164,399
2018,1,29,7,406,198,604
2018,1,29,8,281,162,443
2018,1,29,9,243,144,387
2018,1,29,10,220,183,403
2018,1,29,11,217,199,416
2018,1,29,12,237,175,412
2018,1,29,13,206,237,443
2018,1,29,14,247,382,629
2018,1,29,15,225,302,527
2018,1,29,16,188,197,385
2018,1,29,17,182,143,325
2018,1,29,18,127,141,268
2018,1,29,19,110,133,243
2018,1,29,20,87,126,213
2018,1,29,21,73,77,150
2018,1,29,22,29,45,74
2018,1,29,23,14,26,40
2018,1,30,0,14,18,32
2018,1,30,1,6,9,15
2018,1,30,2,9,13,22
2018,1,30,3,4,7,11
2018,1,30,4,20,16,36
2018,1,30,5,114,52,166
2018,1,30,6,249,170,419
2018,1,30,7,394,209,603
2018,1,30,8,285,166,451
2018,1,30,9,246,186,432
2018,1,30,10,232,201,433
2018,1,30,11,234,189,423
2018,1,30,12,228,210,438
2018,1,30,13,241,258,499
2018,1,30,14,237,354,591
2018,1,30,15,222,319,541
2018,1,30,16,227,213,440
2018,1,30,17,214,155,369
2018,1,30,18,142,139,281
2018,1,30,19,113,163,276
2018,1,30,20,92,126,218
2018,1,30,21,61,98,159
2018,1,30,22,29,66,95
2018,1,30,23,18,21,39
2018,1,31,0,9,16,25
2018,1,31,1,7,14,21
2018,1,31,2,4,16,20
2018,1,31,3,5,6,11
2018,1,31,4,30,13,43
2018,1,31,5,119,52,171
2018,1,31,6,262,152,414
2018,1,31,7,419,207,626
2018,1,31,8,261,163,424
2018,1,31,9,254,160,414
2018,1,31,10,240,183,423
2018,1,31,11,224,190,414
2018,1,31,12,215,208,423
2018,1,31,13,199,258,457
2018,1,31,14,244,313,557
2018,1,31,15,240,291,531
2018,1,31,16,190,181,371
2018,1,31,17,174,160,334
2018,1,31,18,149,168,317
2018,1,31,19,106,136,242
2018,1,31,20,94,111,205
2018,1,31,21,69,92,161
2018,1,31,22,37,70,107
2018,1,31,23,19,26,45
2018,2,1,0,13,25,38
2018,2,1,1,7,14,21
2018,2,1,2,6,11,17
2018,2,1,3,9,11,20
2018,2,1,4,21,18,39
2018,2,1,5,117,46,163
2018,2,1,6,246,129,375
2018,2,1,7,405,207,612
2018,2,1,8,263,166,429
2018,2,1,9,246,162,408
2018,2,1,10,225,166,391
2018,2,1,11,205,216,421
2018,2,1,12,216,190,406
2018,2,1,13,219,236,455
2018,2,1,14,247,333,580
2018,2,1,15,208,294,502
2018,2,1,16,160,181,341
2018,2,1,17,198,191,389
2018,2,1,18,144,140,284
2018,2,1,19,112,147,259
2018,2,1,20,90,130,220
2018,2,1,21,69,372,441
2018,2,1,22,37,263,300
2018,2,1,23,17,111,128
2018,2,2,0,18,60,78
2018,2,2,1,9,62,71
2018,2,2,2,11,55,66
2018,2,2,3,11,11,22
2018,2,2,4,18,13,31
2018,2,2,5,109,47,156
2018,2,2,6,219,115,334
2018,2,2,7,323,169,492
2018,2,2,8,265,158,423
2018,2,2,9,227,172,399
2018,2,2,10,234,162,396
2018,2,2,11,197,196,393
2018,2,2,12,223,212,435
2018,2,2,13,221,277,498
2018,2,2,14,247,329,576
2018,2,2,15,197,255,452
2018,2,2,16,129,167,296
2018,2,2,17,147,146,293
2018,2,2,18,112,119,231
2018,2,2,19,89,96,185
2018,2,2,20,69,76,145
2018,2,2,21,57,95,152
2018,2,2,22,37,82,119
2018,2,2,23,34,51,85
2018,2,3,0,30,45,75
2018,2,3,1,21,44,65
2018,2,3,2,16,67,83
2018,2,3,3,18,23,41
2018,2,3,4,10,16,26
2018,2,3,5,17,16,33
2018,2,3,6,30,30,60
2018,2,3,7,35,28,63
2018,2,3,8,70,47,117
2018,2,3,9,84,72,156
2018,2,3,10,126,94,220
2018,2,3,11,125,109,234
2018,2,3,12,123,134,257
2018,2,3,13,133,142,275
2018,2,3,14,147,169,316
2018,2,3,15,131,165,296
2018,2,3,16,115,154,269
2018,2,3,17,127,126,253
2018,2,3,18,94,103,197
2018,2,3,19,98,97,195
2018,2,3,20,53,75,128
2018,2,3,21,45,66,111
2018,2,3,22,50,63,113
2018,2,3,23,35,56,91
2018,2,4,0,46,42,88
2018,2,4,1,28,55,83
2018,2,4,2,33,64,97
2018,2,4,3,17,46,63
2018,2,4,4,16,15,31
2018,2,4,5,15,12,27
2018,2,4,6,16,21,37
2018,2,4,7,29,15,44
2018,2,4,8,55,43,98
2018,2,4,9,75,61,136
2018,2,4,10,111,66,177
2018,2,4,11,134,148,282
2018,2,4,12,140,168,308
2018,2,4,13,176,169,345
2018,2,4,14,142,174,316
2018,2,4,15,142,183,325
2018,2,4,16,167,173,340
2018,2,4,17,139,125,264
2018,2,4,18,158,174,332
2018,2,4,19,115,137,252
2018,2,4,20,85,110,195
2018,2,4,21,64,90,154
2018,2,4,22,30,49,79
2018,2,4,23,8,23,31
2018,2,5,0,7,20,27
2018,2,5,1,7,19,26
2018,2,5,2,5,11,16
2018,2,5,3,12,8,20
2018,2,5,4,19,12,31
2018,2,5,5,112,53,165
2018,2,5,6,247,131,378
2018,2,5,7,367,192,559
2018,2,5,8,261,157,418
2018,2,5,9,216,177,393
2018,2,5,10,199,147,346
2018,2,5,11,209,211,420
2018,2,5,12,237,205,442
2018,2,5,13,212,234,446
2018,2,5,14,219,325,544
2018,2,5,15,216,327,543
2018,2,5,16,182,186,368
2018,2,5,17,170,161,331
2018,2,5,18,130,139,269
2018,2,5,19,104,111,215
2018,2,5,20,84,111,195
2018,2,5,21,57,90,147
2018,2,5,22,32,48,80
2018,2,5,23,18,26,44
2018,2,6,0,10,17,27
2018,2,6,1,8,9,17
2018,2,6,2,4,5,9
2018,2,6,3,5,5,10
2018,2,6,4,21,11,32
2018,2,6,5,121,51,172
2018,2,6,6,245,144,389
2018,2,6,7,373,176,549
2018,2,6,8,241,153,394
2018,2,6,9,202,176,378
2018,2,6,10,223,172,395
2018,2,6,11,195,197,392
2018,2,6,12,207,196,403
2018,2,6,13,221,244,465
2018,2,6,14,224,344,568
2018,2,6,15,223,285,508
2018,2,6,16,193,204,397
2018,2,6,17,148,134,282
2018,2,6,18,126,135,261
2018,2,6,19,117,166,283
2018,2,6,20,76,103,179
2018,2,6,21,57,94,151
2018,2,6,22,34,39,73
2018,2,6,23,17,26,43
2018,2,7,0,12,26,38
2018,2,7,1,8,18,26
2018,2,7,2,3,16,19
2018,2,7,3,7,14,21
2018,2,7,4,22,20,42
2018,2,7,5,116,49,165
2018,2,7,6,257,148,405
2018,2,7,7,342,189,531
2018,2,7,8,273,162,435
2018,2,7,9,202,180,382
2018,2,7,10,205,173,378
2018,2,7,11,208,186,394
2018,2,7,12,222,207,429
2018,2,7,13,212,264,476
2018,2,7,14,217,326,543
2018,2,7,15,244,430,674
2018,2,7,16,195,195,390
2018,2,7,17,169,157,326
2018,2,7,18,132,149,281
2018,2,7,19,119,121,240
2018,2,7,20,81,103,184
2018,2,7,21,64,360,424
2018,2,7,22,26,234,260
2018,2,7,23,17,80,97
2018,2,8,0,15,47,62
2018,2,8,1,11,15,26
2018,2,8,2,11,25,36
2018,2,8,3,12,17,29
2018,2,8,4,20,18,38
2018,2,8,5,96,42,138
2018,2,8,6,249,142,391
2018,2,8,7,381,220,601
2018,2,8,8,283,152,435
2018,2,8,9,217,165,382
2018,2,8,10,236,185,421
2018,2,8,11,211,189,400
2018,2,8,12,208,195,403
2018,2,8,13,193,233,426
2018,2,8,14,256,359,615
2018,2,8,15,231,298,529
2018,2,8,16,190,206,396
2018,2,8,17,175,142,317
2018,2,8,18,136,160,296
2018,2,8,19,119,142,261
2018,2,8,20,80,111,191
2018,2,8,21,67,85,152
2018,2,8,22,33,52,85
2018,2,8,23,19,31,50
2018,2,9,0,21,22,43
2018,2,9,1,12,20,32
2018,2,9,2,10,23,33
2018,2,9,3,9,12,21
2018,2,9,4,22,12,34
2018,2,9,5,101,41,142
2018,2,9,6,258,149,407
2018,2,9,7,386,177,563
2018,2,9,8,265,166,431
2018,2,9,9,167,150,317
2018,2,9,10,198,162,360
2018,2,9,11,199,191,390
2018,2,9,12,222,213,435
2018,2,9,13,244,285,529
2018,2,9,14,268,380,648
2018,2,9,15,210,282,492
2018,2,9,16,166,160,326
2018,2,9,17,145,162,307
2018,2,9,18,127,132,259
2018,2,9,19,82,93,175
2018,2,9,20,71,91,162
2018,2,9,21,46,74,120
2018,2,9,22,58,64,122
2018,2,9,23,33,52,85
2018,2,10,0,32,48,80
2018,2,10,1,20,40,60
2018,2,10,2,14,41,55
2018,2,10,3,20,25,45
2018,2,10,4,8,19,27
2018,2,10,5,21,18,39
2018,2,10,6,27,17,44
2018,2,10,7,37,38,75
2018,2,10,8,66,53,119
2018,2,10,9,123,65,188
2018,2,10,10,194,127,321
2018,2,10,11,146,144,290
2018,2,10,12,149,125,274
2018,2,10,13,178,177,355
2018,2,10,14,126,173,299
2018,2,10,15,143,151,294
2018,2,10,16,126,140,266
2018,2,10,17,125,125,250
2018,2,10,18,110,120,230
2018,2,10,19,92,100,192
2018,2,10,20,51,79,130
2018,2,10,21,44,66,110
2018,2,10,22,43,89,132
2018,2,10,23,37,70,107
2018,2,11,0,37,47,84
2018,2,11,1,35,65,100
2018,2,11,2,36,74,110
2018,2,11,3,17,40,57
2018,2,11,4,16,23,39
2018,2,11,5,16,12,28
2018,2,11,6,13,16,29
2018,2,11,7,21,11,32
2018,2,11,8,32,27,59
2018,2,11,9,89,48,137
2018,2,11,10,84,70,154
2018,2,11,11,123,118,241
2018,2,11,12,154,161,315
2018,2,11,13,191,175,366
2018,2,11,14,170,188,358
2018,2,11,15,161,245,406
2018,2,11,16,144,141,285
2018,2,11,17,144,150,294
2018,2,11,18,154,138,292
2018,2,11,19,111,151,262
2018,2,11,20,75,87,162
2018,2,11,21,60,63,123
2018,2,11,22,26,41,67
2018,2,11,23,17,25,42
2018,2,12,0,14,22,36
2018,2,12,1,9,10,19
2018,2,12,2,7,13,20
2018,2,12,3,12,5,17
2018,2,12,4,21,15,36
2018,2,12,5,124,67,191
2018,2,12,6,234,129,363
2018,2,12,7,394,215,609
2018,2,12,8,247,159,406
2018,2,12,9,215,137,352
2018,2,12,10,173,135,308
2018,2,12,11,180,178,358
2018,2,12,12,216,183,399
2018,2,12,13,187,212,399
2018,2,12,14,232,341,573
2018,2,12,15,250,315,565
2018,2,12,16,174,184,358
2018,2,12,17,158,151,309
2018,2,12,18,138,141,279
2018,2,12,19,115,124,239
2018,2,12,20,79,117,196
2018,2,12,21,61,74,135
2018,2,12,22,40,40,80
2018,2,12,23,13,24,37
2018,2,13,0,11,17,28
2018,2,13,1,12,11,23
2018,2,13,2,7,9,16
2018,2,13,3,6,9,15
2018,2,13,4,14,11,25
2018,2,13,5,115,41,156
2018,2,13,6,257,131,388
2018,2,13,7,402,183,585
2018,2,13,8,249,169,418
2018,2,13,9,217,216,433
2018,2,13,10,219,170,389
2018,2,13,11,223,174,397
2018,2,13,12,215,185,400
2018,2,13,13,208,232,440
2018,2,13,14,225,306,531
2018,2,13,15,231,293,524
2018,2,13,16,183,182,365
2018,2,13,17,198,178,376
2018,2,13,18,136,153,289
2018,2,13,19,126,125,251
2018,2,13,20,86,122,208
2018,2,13,21,73,102,175
2018,2,13,22,35,48,83
2018,2,13,23,12,19,31
2018,2,14,0,7,14,21
2018,2,14,1,19,21,40
2018,2,14,2,12,19,31
2018,2,14,3,7,9,16
2018,2,14,4,17,16,33
2018,2,14,5,97,49,146
2018,2,14,6,225,134,359
2018,2,14,7,394,192,586
2018,2,14,8,308,162,470
2018,2,14,9,234,167,401
2018,2,14,10,233,189,422
2018,2,14,11,234,222,456
2018,2,14,12,196,181,377
2018,2,14,13,230,242,472
2018,2,14,14,258,336,594
2018,2,14,15,236,292,528
2018,2,14,16,214,198,412
2018,2,14,17,198,185,383
2018,2,14,18,131,170,301
2018,2,14,19,131,160,291
2018,2,14,20,93,141,234
2018,2,14,21,51,407,458
2018,2,14,22,33,281,314
2018,2,14,23,15,83,98
2018,2,15,0,14,23,37
2018,2,15,1,11,26,37
2018,2,15,2,8,28,36
2018,2,15,3,10,10,20
2018,2,15,4,14,21,35
2018,2,15,5,121,44,165
2018,2,15,6,262,156,418
2018,2,15,7,391,202,593
2018,2,15,8,262,182,444
2018,2,15,9,240,156,396
2018,2,15,10,312,205,517
2018,2,15,11,237,203,440
2018,2,15,12,221,226,447
2018,2,15,13,206,252,458
2018,2,15,14,268,335,603
2018,2,15,15,224,284,508
2018,2,15,16,191,227,418
2018,2,15,17,159,145,304
2018,2,15,18,145,161,306
2018,2,15,19,109,119,228
2018,2,15,20,84,135,219
2018,2,15,21,68,88,156
2018,2,15,22,23,59,82
2018,2,15,23,16,33,49
2018,2,16,0,15,36,51
2018,2,16,1,12,32,44
2018,2,16,2,11,38,49
2018,2,16,3,10,12,22
2018,2,16,4,22,16,38
2018,2,16,5,111,48,159
2018,2,16,6,249,129,378
2018,2,16,7,405,197,602
2018,2,16,8,243,161,404
2018,2,16,9,220,171,391
2018,2,16,10,219,196,415
2018,2,16,11,194,186,380
2018,2,16,12,220,227,447
2018,2,16,13,248,268,516
2018,2,16,14,289,368,657
2018,2,16,15,202,312,514
2018,2,16,16,162,161,323
2018,2,16,17,178,164,342
2018,2,16,18,123,136,259
2018,2,16,19,86,95,181
2018,2,16,20,83,83,166
2018,2,16,21,64,87,151
2018,2,16,22,58,84,142
2018,2,16,23,25,40,65
2018,2,17,0,26,40,66
2018,2,17,1,32,46,78
2018,2,17,2,16,37,53
2018,2,17,3,15,35,50
2018,2,17,4,17,10,27
2018,2,17,5,31,12,43
2018,2,17,6,24,25,49
2018,2,17,7,37,32,69
2018,2,17,8,68,52,120
2018,2,17,9,106,82,188
2018,2,17,10,121,119,240
2018,2,17,11,163,145,308
2018,2,17,12,160,151,311
2018,2,17,13,166,199,365
2018,2,17,14,160,190,350
2018,2,17,15,136,168,304
2018,2,17,16,128,142,270
2018,2,17,17,140,139,279
2018,2,17,18,101,137,238
2018,2,17,19,78,101,179
2018,2,17,20,52,80,132
2018,2,17,21,53,64,117
2018,2,17,22,45,59,104
2018,2,17,23,40,64,104
2018,2,18,0,37,58,95
2018,2,18,1,31,47,78
2018,2,18,2,33,63,96
2018,2,18,3,14,42,56
2018,2,18,4,17,18,35
2018,2,18,5,16,8,24
2018,2,18,6,15,10,25
2018,2,18,7,42,13,55
2018,2,18,8,54,34,88
2018,2,18,9,98,52,150
2018,2,18,10,140,87,227
2018,2,18,11,156,129,285
2018,2,18,12,153,148,301
2018,2,18,13,179,176,355
2018,2,18,14,167,191,358
2018,2,18,15,146,225,371
2018,2,18,16,162,186,348
2018,2,18,17,138,168,306
2018,2,18,18,140,160,300
2018,2,18,19,112,129,241
2018,2,18,20,71,95,166
2018,2,18,21,58,83,141
2018,2,18,22,26,53,79
2018,2,18,23,24,17,41
2018,2,19,0,11,13,24
2018,2,19,1,7,15,22
2018,2,19,2,11,13,24
2018,2,19,3,11,11,22
2018,2,19,4,13,10,23
2018,2,19,5,106,48,154
2018,2,19,6,244,151,395
2018,2,19,7,412,196,608
2018,2,19,8,274,173,447
2018,2,19,9,205,171,376
2018,2,19,10,216,158,374
2018,2,19,11,192,194,386
2018,2,19,12,223,215,438
2018,2,19,13,206,256,462
2018,2,19,14,246,332,578
2018,2,19,15,215,305,520
2018,2,19,16,193,180,373
2018,2,19,17,164,178,342
2018,2,19,18,151,127,278
2018,2,19,19,107,127,234
2018,2,19,20,85,130,215
2018,2,19,21,64,93,157
2018,2,19,22,39,84,123
2018,2,19,23,21,19,40
2018,2,20,0,6,4,10
2018,2,20,1,5,9,14
2018,2,20,2,10,8,18
2018,2,20,3,9,8,17
2018,2,20,4,30,12,42
2018,2,20,5,108,38,146
2018,2,20,6,231,144,375
2018,2,20,7,405,180,585
2018,2,20,8,237,150,387
2018,2,20,9,239,172,411
2018,2,20,10,201,177,378
2018,2,20,11,221,187,408
2018,2,20,12,199,251,450
2018,2,20,13,205,269,474
2018,2,20,14,285,365,650
2018,2,20,15,217,310,527
2018,2,20,16,176,187,363
2018,2,20,17,200,139,339
2018,2,20,18,159,161,320
2018,2,20,19,118,164,282
2018,2,20,20,85,115,200
2018,2,20,21,63,113,176
2018,2,20,22,28,44,72
2018,2,20,23,10,25,35
2018,2,21,0,7,30,37
2018,2,21,1,9,21,30
2018,2,21,2,5,21,26
2018,2,21,3,15,15,30
2018,2,21,4,22,26,48
2018,2,21,5,104,41,145
2018,2,21,6,220,131,351
2018,2,21,7,431,199,630
2018,2,21,8,253,174,427
2018,2,21,9,218,156,374
2018,2,21,10,242,173,415
2018,2,21,11,222,184,406
2018,2,21,12,190,200,390
2018,2,21,13,225,244,469
2018,2,21,14,248,329,577
2018,2,21,15,226,327,553
2018,2,21,16,189,187,376
2018,2,21,17,194,169,363
2018,2,21,18,156,139,295
2018,2,21,19,109,123,232
2018,2,21,20,104,154,258
2018,2,21,21,63,90,153
2018,2,21,22,43,55,98
2018,2,21,23,14,30,44
2018,2,22,0,19,24,43
2018,2,22,1,8,22,30
2018,2,22,2,11,20,31
2018,2,22,3,8,15,23
2018,2,22,4,15,13,28
2018,2,22,5,89,45,134
2018,2,22,6,256,145,401
2018,2,22,7,407,196,603
2018,2,22,8,233,156,389
2018,2,22,9,228,170,398
2018,2,22,10,243,187,430
2018,2,22,11,221,209,430
2018,2,22,12,209,220,429
2018,2,22,13,216,249,465
2018,2,22,14,233,328,561
2018,2,22,15,272,278,550
2018,2,22,16,209,205,414
2018,2,22,17,152,153,305
2018,2,22,18,142,176,318
2018,2,22,19,127,134,261
2018,2,22,20,100,114,214
2018,2,22,21,63,86,149
2018,2,22,22,46,54,100
2018,2,22,23,25,29,54
2018,2,23,0,11,24,35
2018,2,23,1,10,19,29
2018,2,23,2,5,22,27
2018,2,23,3,8,19,27
2018,2,23,4,20,14,34
2018,2,23,5,106,47,153
2018,2,23,6,251,155,406
2018,2,23,7,375,186,561
2018,2,23,8,222,150,372
2018,2,23,9,240,183,423
2018,2,23,10,232,197,429
2018,2,23,11,206,184,390
2018,2,23,12,213,232,445
2018,2,23,13,246,288,534
2018,2,23,14,258,326,584
2018,2,23,15,196,284,480
2018,2,23,16,167,166,333
2018,2,23,17,153,145,298
2018,2,23,18,107,126,233
2018,2,23,19,89,91,180
2018,2,23,20,64,85,149
2018,2,23,21,48,59,107
2018,2,23,22,35,50,85
2018,2,23,23,44,51,95
2018,2,24,0,31,44,75
2018,2,24,1,23,35,58
2018,2,24,2,24,49,73
2018,2,24,3,17,31,48
2018,2,24,4,5,11,16
2018,2,24,5,15,20,35
2018,2,24,6,28,26,54
2018,2,24,7,34,29,63
2018,2,24,8,60,51,111
2018,2,24,9,93,76,169
2018,2,24,10,137,99,236
2018,2,24,11,140,126,266
2018,2,24,12,157,145,302
2018,2,24,13,142,192,334
2018,2,24,14,117,189,306
2018,2,24,15,137,149,286
2018,2,24,16,130,136,266
2018,2,24,17,119,150,269
2018,2,24,18,82,96,178
2018,2,24,19,98,80,178
2018,2,24,20,50,65,115
2018,2,24,21,39,56,95
2018,2,24,22,45,73,118
2018,2,24,23,28,49,77
2018,2,25,0,26,50,76
2018,2,25,1,29,42,71
2018,2,25,2,27,51,78
2018,2,25,3,15,37,52
2018,2,25,4,9,18,27
2018,2,25,5,12,16,28
2018,2,25,6,13,15,28
2018,2,25,7,32,19,51
2018,2,25,8,40,25,65
2018,2,25,9,82,53,135
2018,2,25,10,103,70,173
2018,2,25,11,131,127,258
2018,2,25,12,124,162,286
2018,2,25,13,180,188,368
2018,2,25,14,151,159,310
2018,2,25,15,119,195,314
2018,2,25,16,141,176,317
2018,2,25,17,132,156,288
2018,2,25,18,111,93,204
2018,2,25,19,90,105,195
2018,2,25,20,61,84,145
2018,2,25,21,49,46,95
2018,2,25,22,27,31,58
2018,2,25,23,19,23,42
2018,2,26,0,8,13,21
2018,2,26,1,13,16,29
2018,2,26,2,3,10,13
2018,2,26,3,9,9,18
2018,2,26,4,20,8,28
2018,2,26,5,101,49,150
2018,2,26,6,210,127,337
2018,2,26,7,285,167,452
2018,2,26,8,218,138,356
2018,2,26,9,189,132,321
2018,2,26,10,193,141,334
2018,2,26,11,212,166,378
2018,2,26,12,187,196,383
2018,2,26,13,197,207,404
2018,2,26,14,234,301,535
2018,2,26,15,187,288,475
2018,2,26,16,176,172,348
2018,2,26,17,139,139,278
2018,2,26,18,106,122,228
2018,2,26,19,88,99,187
2018,2,26,20,86,102,188
2018,2,26,21,56,62,118
2018,2,26,22,32,114,146
2018,2,26,23,15,39,54
2018,2,27,0,12,8,20
2018,2,27,1,6,9,15
2018,2,27,2,8,9,17
2018,2,27,3,11,11,22
2018,2,27,4,18,17,35
2018,2,27,5,104,54,158
2018,2,27,6,227,133,360
2018,2,27,7,301,146,447
2018,2,27,8,218,144,362
2018,2,27,9,230,163,393
2018,2,27,10,223,170,393
2018,2,27,11,194,188,382
2018,2,27,12,206,208,414
2018,2,27,13,215,212,427
2018,2,27,14,235,292,527
2018,2,27,15,198,261,459
2018,2,27,16,180,181,361
2018,2,27,17,169,133,302
2018,2,27,18,123,146,269
2018,2,27,19,103,111,214
2018,2,27,20,82,106,188
2018,2,27,21,70,88,158
2018,2,27,22,29,47,76
2018,2,27,23,14,22,36
2018,2,28,0,13,16,29
2018,2,28,1,10,14,24
2018,2,28,2,1,10,11
2018,2,28,3,10,10,20
2018,2,28,4,12,22,34
2018,2,28,5,104,45,149
2018,2,28,6,197,130,327
2018,2,28,7,295,153,448
2018,2,28,8,228,135,363
2018,2,28,9,210,160,370
2018,2,28,10,233,165,398
2018,2,28,11,195,191,386
2018,2,28,12,221,178,399
2018,2,28,13,197,219,416
2018,2,28,14,239,277,516
2018,2,28,15,201,265,466
2018,2,28,16,187,192,379
2018,2,28,17,161,147,308
2018,2,28,18,118,139,257
2018,2,28,19,103,112,215
2018,2,28,20,89,107,196
2018,2,28,21,56,104,160
2018,2,28,22,35,50,85
2018,2,28,23,15,36,51
2018,3,1,0,7,18,25
2018,3,1,1,7,17,24
2018,3,1,2,10,19,29
2018,3,1,3,8,10,18
2018,3,1,4,17,21,38
2018,3,1,5,101,41,142
2018,3,1,6,203,125,328
2018,3,1,7,285,143,428
2018,3,1,8,230,143,373
2018,3,1,9,178,147,325
2018,3,1,10,200,166,366
2018,3,1,11,226,193,419
2018,3,1,12,204,199,403
2018,3,1,13,191,238,429
2018,3,1,14,228,294,522
2018,3,1,15,227,263,490
2018,3,1,16,191,180,371
2018,3,1,17,147,160,307
2018,3,1,18,132,130,262
2018,3,1,19,99,109,208
2018,3,1,20,68,112,180
2018,3,1,21,54,79,133
2018,3,1,22,34,52,86
2018,3,1,23,19,30,49
2018,3,2,0,14,29,43
2018,3,2,1,11,36,47
2018,3,2,2,8,15,23
2018,3,2,3,8,15,23
2018,3,2,4,16,19,35
2018,3,2,5,98,54,152
2018,3,2,6,184,117,301
2018,3,2,7,250,145,395
2018,3,2,8,211,146,357
2018,3,2,9,182,160,342
2018,3,2,10,202,153,355
2018,3,2,11,211,165,376
2018,3,2,12,202,223,425
2018,3,2,13,229,232,461
2018,3,2,14,233,304,537
2018,3,2,15,180,219,399
2018,3,2,16,155,170,325
2018,3,2,17,125,124,249
2018,3,2,18,96,127,223
2018,3,2,19,72,85,157
2018,3,2,20,69,73,142
2018,3,2,21,71,65,136
2018,3,2,22,36,49,85
2018,3,2,23,29,26,55
2018,3,3,0,16,32,48
2018,3,3,1,21,45,66
2018,3,3,2,24,35,59
2018,3,3,3,8,33,41
2018,3,3,4,7,11,18
2018,3,3,5,17,23,40
2018,3,3,6,32,17,49
2018,3,3,7,27,26,53
2018,3,3,8,60,45,105
2018,3,3,9,88,60,148
2018,3,3,10,90,77,167
2018,3,3,11,108,111,219
2018,3,3,12,138,113,251
2018,3,3,13,140,132,272
2018,3,3,14,137,137,274
2018,3,3,15,107,136,243
2018,3,3,16,122,144,266
2018,3,3,17,110,115,225
2018,3,3,18,92,99,191
2018,3,3,19,76,103,179
2018,3,3,20,56,70,126
2018,3,3,21,50,55,105
2018,3,3,22,26,48,74
2018,3,3,23,31,51,82
2018,3,4,0,26,45,71
2018,3,4,1,21,50,71
2018,3,4,2,27,59,86
2018,3,4,3,18,36,54
2018,3,4,4,5,25,30
2018,3,4,5,16,12,28
2018,3,4,6,21,19,40
2018,3,4,7,20,12,32
2018,3,4,8,44,28,72
2018,3,4,9,82,45,127
2018,3,4,10,102,62,164
2018,3,4,11,115,115,230
2018,3,4,12,123,161,284
2018,3,4,13,195,166,361
2018,3,4,14,147,182,329
2018,3,4,15,142,179,321
2018,3,4,16,121,139,260
2018,3,4,17,123,127,250
2018,3,4,18,138,158,296
2018,3,4,19,103,122,225
2018,3,4,20,72,97,169
2018,3,4,21,55,72,127
2018,3,4,22,18,46,64
2018,3,4,23,22,24,46
2018,3,5,0,9,13,22
2018,3,5,1,10,12,22
2018,3,5,2,3,18,21
2018,3,5,3,9,15,24
2018,3,5,4,16,7,23
2018,3,5,5,123,52,175
2018,3,5,6,255,137,392
2018,3,5,7,369,213,582
2018,3,5,8,288,153,441
2018,3,5,9,188,147,335
2018,3,5,10,196,167,363
2018,3,5,11,188,202,390
2018,3,5,12,188,179,367
2018,3,5,13,202,221,423
2018,3,5,14,228,326,554
2018,3,5,15,224,328,552
2018,3,5,16,179,174,353
2018,3,5,17,198,155,353
2018,3,5,18,136,136,272
2018,3,5,19,95,113,208
2018,3,5,20,82,106,188
2018,3,5,21,68,67,135
2018,3,5,22,37,42,79
2018,3,5,23,22,28,50
2018,3,6,0,13,22,35
2018,3,6,1,9,14,23
2018,3,6,2,10,16,26
2018,3,6,3,9,7,16
2018,3,6,4,17,9,26
2018,3,6,5,118,52,170
2018,3,6,6,264,144,408
2018,3,6,7,386,199,585
2018,3,6,8,305,181,486
2018,3,6,9,210,167,377
2018,3,6,10,214,167,381
2018,3,6,11,192,183,375
2018,3,6,12,196,198,394
2018,3,6,13,253,254,507
2018,3,6,14,245,332,577
2018,3,6,15,207,301,508
2018,3,6,16,212,202,414
2018,3,6,17,206,163,369
2018,3,6,18,154,132,286
2018,3,6,19,112,143,255
2018,3,6,20,92,115,207
2018,3,6,21,81,110,191
2018,3,6,22,35,44,79
2018,3,6,23,13,21,34
2018,3,7,0,8,24,32
2018,3,7,1,5,17,22
2018,3,7,2,11,19,30
2018,3,7,3,7,9,16
2018,3,7,4,26,15,41
2018,3,7,5,112,54,166
2018,3,7,6,250,145,395
2018,3,7,7,403,195,598
2018,3,7,8,258,168,426
2018,3,7,9,198,151,349
2018,3,7,10,196,168,364
2018,3,7,11,212,191,403
2018,3,7,12,204,183,387
2018,3,7,13,209,223,432
2018,3,7,14,256,328,584
2018,3,7,15,199,304,503
2018,3,7,16,214,216,430
2018,3,7,17,166,186,352
2018,3,7,18,148,151,299
2018,3,7,19,128,126,254
2018,3,7,20,84,129,213
2018,3,7,21,73,86,159
2018,3,7,22,36,39,75
2018,3,7,23,21,22,43
2018,3,8,0,10,18,28
2018,3,8,1,11,20,31
2018,3,8,2,10,23,33
2018,3,8,3,11,9,20
2018,3,8,4,17,15,32
2018,3,8,5,113,43,156
2018,3,8,6,259,144,403
2018,3,8,7,423,213,636
2018,3,8,8,251,171,422
2018,3,8,9,218,173,391
2018,3,8,10,201,181,382
2018,3,8,11,226,208,434
2018,3,8,12,211,208,419
2018,3,8,13,227,250,477
2018,3,8,14,238,312,550
2018,3,8,15,261,329,590
2018,3,8,16,207,190,397
2018,3,8,17,180,163,343
2018,3,8,18,176,154,330
2018,3,8,19,109,131,240
2018,3,8,20,91,137,228
2018,3,8,21,74,86,160
2018,3,8,22,52,59,111
2018,3,8,23,24,27,51
2018,3,9,0,12,39,51
2018,3,9,1,11,52,63
2018,3,9,2,17,41,58
2018,3,9,3,10,36,46
2018,3,9,4,17,26,43
2018,3,9,5,108,54,162
2018,3,9,6,244,132,376
2018,3,9,7,402,209,611
2018,3,9,8,258,171,429
2018,3,9,9,214,149,363
2018,3,9,10,227,169,396
2018,3,9,11,234,190,424
2018,3,9,12,212,209,421
2018,3,9,13,228,269,497
2018,3,9,14,275,326,601
2018,3,9,15,209,277,486
2018,3,9,16,169,164,333
2018,3,9,17,173,166,339
2018,3,9,18,163,138,301
2018,3,9,19,100,125,225
2018,3,9,20,101,88,189
2018,3,9,21,70,63,133
2018,3,9,22,40,42,82
2018,3,9,23,35,51,86
2018,3,10,0,19,29,48
2018,3,10,1,20,28,48
2018,3,10,2,15,40,55
2018,3,10,3,12,22,34
2018,3,10,4,14,20,34
2018,3,10,5,17,21,38
2018,3,10,6,42,29,71
2018,3,10,7,61,48,109
2018,3,10,8,111,72,183
2018,3,10,9,169,85,254
2018,3,10,10,162,123,285
2018,3,10,11,187,137,324
2018,3,10,12,197,184,381
2018,3,10,13,187,168,355
2018,3,10,14,167,176,343
2018,3,10,15,176,176,352
2018,3,10,16,191,147,338
2018,3,10,17,146,151,297
2018,3,10,18,136,122,258
2018,3,10,19,105,88,193
2018,3,10,20,65,76,141
2018,3,10,21,56,70,126
2018,3,10,22,40,57,97
2018,3,10,23,43,68,111
2018,3,11,0,33,52,85
2018,3,11,1,20,42,62
2018,3,11,2,19,46,65
2018,3,11,3,9,43,52
2018,3,11,4,8,16,24
2018,3,11,5,21,12,33
2018,3,11,6,20,17,37
2018,3,11,7,32,11,43
2018,3,11,8,56,41,97
2018,3,11,9,102,54,156
2018,3,11,10,131,63,194
2018,3,11,11,135,129,264
2018,3,11,12,144,184,328
2018,3,11,13,167,204,371
2018,3,11,14,178,196,374
2018,3,11,15,168,229,397
2018,3,11,16,164,168,332
2018,3,11,17,180,148,328
2018,3,11,18,129,167,296
2018,3,11,19,106,160,266
2018,3,11,20,79,117,196
2018,3,11,21,47,62,109
2018,3,11,22,19,32,51
2018,3,11,23,14,15,29
2018,3,12,0,10,12,22
2018,3,12,1,12,17,29
2018,3,12,2,3,10,13
2018,3,12,3,8,8,16
2018,3,12,4,24,11,35
2018,3,12,5,115,52,167
2018,3,12,6,257,160,417
2018,3,12,7,389,201,590
2018,3,12,8,276,156,432
2018,3,12,9,207,136,343
2018,3,12,10,194,163,357
2018,3,12,11,216,217,433
2018,3,12,12,208,213,421
2018,3,12,13,208,257,465
2018,3,12,14,240,331,571
2018,3,12,15,226,340,566
2018,3,12,16,204,187,391
2018,3,12,17,176,151,327
2018,3,12,18,137,154,291
2018,3,12,19,102,117,219
2018,3,12,20,74,129,203
2018,3,12,21,67,109,176
2018,3,12,22,33,38,71
2018,3,12,23,14,32,46
2018,3,13,0,8,15,23
2018,3,13,1,5,13,18
2018,3,13,2,7,12,19
2018,3,13,3,11,11,22
2018,3,13,4,17,15,32
2018,3,13,5,115,48,163
2018,3,13,6,258,152,410
2018,3,13,7,439,188,627
2018,3,13,8,253,154,407
2018,3,13,9,216,181,397
2018,3,13,10,224,203,427
2018,3,13,11,233,209,442
2018,3,13,12,231,198,429
2018,3,13,13,240,265,505
2018,3,13,14,238,348,586
2018,3,13,15,245,360,605
2018,3,13,16,175,208,383
2018,3,13,17,208,160,368
2018,3,13,18,171,167,338
2018,3,13,19,129,154,283
2018,3,13,20,83,115,198
2018,3,13,21,72,105,177
2018,3,13,22,34,50,84
2018,3,13,23,17,26,43
2018,3,14,0,13,24,37
2018,3,14,1,7,14,21
2018,3,14,2,7,23,30
2018,3,14,3,9,13,22
2018,3,14,4,20,17,37
2018,3,14,5,123,55,178
2018,3,14,6,268,137,405
2018,3,14,7,414,216,630
2018,3,14,8,247,171,418
2018,3,14,9,247,156,403
2018,3,14,10,206,190,396
2018,3,14,11,222,215,437
2018,3,14,12,234,196,430
2018,3,14,13,240,252,492
2018,3,14,14,234,305,539
2018,3,14,15,210,272,482
2018,3,14,16,210,202,412
2018,3,14,17,178,169,347
2018,3,14,18,134,168,302
2018,3,14,19,108,140,248
2018,3,14,20,75,108,183
2018,3,14,21,71,85,156
2018,3,14,22,40,51,91
2018,3,14,23,26,19,45
2018,3,15,0,12,11,23
2018,3,15,1,4,12,16
2018,3,15,2,5,15,20
2018,3,15,3,8,17,25
2018,3,15,4,20,11,31
2018,3,15,5,112,67,179
2018,3,15,6,262,143,405
2018,3,15,7,403,228,631
2018,3,15,8,261,172,433
2018,3,15,9,221,177,398
2018,3,15,10,227,177,404
2018,3,15,11,196,201,397
2018,3,15,12,232,215,447
2018,3,15,13,188,241,429
2018,3,15,14,244,300,544
2018,3,15,15,218,291,509
2018,3,15,16,233,207,440
2018,3,15,17,193,192,385
2018,3,15,18,157,156,313
2018,3,15,19,123,136,259
2018,3,15,20,88,138,226
2018,3,15,21,53,85,138
2018,3,15,22,43,45,88
2018,3,15,23,13,28,41
2018,3,16,0,17,20,37
2018,3,16,1,11,37,48
2018,3,16,2,14,22,36
2018,3,16,3,11,17,28
2018,3,16,4,14,13,27
2018,3,16,5,101,52,153
2018,3,16,6,243,144,387
2018,3,16,7,384,251,635
2018,3,16,8,250,163,413
2018,3,16,9,244,237,481
2018,3,16,10,218,188,406
2018,3,16,11,215,209,424
2018,3,16,12,223,215,438
2018,3,16,13,241,292,533
2018,3,16,14,266,341,607
2018,3,16,15,241,258,499
2018,3,16,16,157,161,318
2018,3,16,17,142,159,301
2018,3,16,18,111,121,232
2018,3,16,19,105,119,224
2018,3,16,20,65,83,148
2018,3,16,21,55,68,123
2018,3,16,22,55,57,112
2018,3,16,23,34,49,83
2018,3,17,0,24,43,67
2018,3,17,1,20,39,59
2018,3,17,2,16,47,63
2018,3,17,3,13,32,45
2018,3,17,4,13,12,25
2018,3,17,5,23,15,38
2018,3,17,6,33,28,61
2018,3,17,7,48,41,89
2018,3,17,8,57,59,116
2018,3,17,9,92,94,186
2018,3,17,10,141,106,247
2018,3,17,11,151,118,269
2018,3,17,12,156,129,285
2018,3,17,13,167,182,349
2018,3,17,14,179,197,376
2018,3,17,15,144,194,338
2018,3,17,16,136,175,311
2018,3,17,17,126,128,254
2018,3,17,18,113,122,235
2018,3,17,19,98,91,189
2018,3,17,20,53,90,143
2018,3,17,21,51,73,124
2018,3,17,22,44,54,98
2018,3,17,23,46,71,117
2018,3,18,0,37,50,87
2018,3,18,1,30,56,86
2018,3,18,2,32,61,93
2018,3,18,3,12,39,51
2018,3,18,4,12,15,27
2018,3,18,5,19,16,35
2018,3,18,6,24,25,49
2018,3,18,7,46,19,65
2018,3,18,8,51,51,102
2018,3,18,9,111,65,176
2018,3,18,10,107,80,187
2018,3,18,11,180,150,330
2018,3,18,12,145,173,318
2018,3,18,13,185,199,384
2018,3,18,14,167,205,372
2018,3,18,15,141,210,351
2018,3,18,16,125,205,330
2018,3,18,17,173,156,329
2018,3,18,18,125,128,253
2018,3,18,19,173,143,316
2018,3,18,20,83,114,197
2018,3,18,21,38,64,102
2018,3,18,22,36,34,70
2018,3,18,23,18,20,38
2018,3,19,0,10,10,20
2018,3,19,1,3,16,19
2018,3,19,2,13,14,27
2018,3,19,3,7,13,20
2018,3,19,4,20,12,32
2018,3,19,5,133,70,203
2018,3,19,6,236,143,379
2018,3,19,7,382,179,561
2018,3,19,8,290,166,456
2018,3,19,9,232,181,413
2018,3,19,10,224,158,382
2018,3,19,11,229,175,404
2018,3,19,12,231,204,435
2018,3,19,13,224,248,472
2018,3,19,14,251,339,590
2018,3,19,15,246,310,556
2018,3,19,16,216,197,413
2018,3,19,17,176,157,333
2018,3,19,18,147,144,291
2018,3,19,19,98,116,214
2018,3,19,20,94,132,226
2018,3,19,21,51,70,121
2018,3,19,22,25,44,69
2018,3,19,23,10,21,31
2018,3,20,0,11,18,29
2018,3,20,1,9,7,16
2018,3,20,2,3,6,9
2018,3,20,3,5,12,17
2018,3,20,4,23,14,37
2018,3,20,5,121,51,172
2018,3,20,6,265,155,420
2018,3,20,7,400,186,586
2018,3,20,8,248,166,414
2018,3,20,9,208,176,384
2018,3,20,10,217,164,381
2018,3,20,11,204,214,418
2018,3,20,12,216,195,411
2018,3,20,13,227,251,478
2018,3,20,14,263,334,597
2018,3,20,15,232,299,531
2018,3,20,16,199,186,385
2018,3,20,17,174,161,335
2018,3,20,18,165,175,340
2018,3,20,19,126,127,253
2018,3,20,20,79,128,207
2018,3,20,21,66,95,161
2018,3,20,22,24,33,57
2018,3,20,23,22,22,44
2018,3,21,0,9,25,34
2018,3,21,1,13,18,31
2018,3,21,2,7,13,20
2018,3,21,3,8,14,22
2018,3,21,4,17,16,33
2018,3,21,5,122,53,175
2018,3,21,6,234,147,381
2018,3,21,7,395,216,611
2018,3,21,8,247,169,416
2018,3,21,9,231,177,408
2018,3,21,10,204,194,398
2018,3,21,11,242,219,461
2018,3,21,12,218,210,428
2018,3,21,13,220,247,467
2018,3,21,14,273,345,618
2018,3,21,15,261,299,560
2018,3,21,16,216,213,429
2018,3,21,17,197,174,371
2018,3,21,18,132,147,279
2018,3,21,19,128,154,282
2018,3,21,20,92,123,215
2018,3,21,21,62,92,154
2018,3,21,22,34,122,156
2018,3,21,23,13,83,96
2018,3,22,0,14,29,43
2018,3,22,1,13,17,30
2018,3,22,2,11,24,35
2018,3,22,3,7,11,18
2018,3,22,4,22,14,36
2018,3,22,5,130,58,188
2018,3,22,6,250,164,414
2018,3,22,7,438,205,643
2018,3,22,8,241,180,421
2018,3,22,9,234,189,423
2018,3,22,10,257,194,451
2018,3,22,11,218,222,440
2018,3,22,12,258,227,485
2018,3,22,13,194,259,453
2018,3,22,14,271,396,667
2018,3,22,15,287,379,666
2018,3,22,16,213,197,410
2018,3,22,17,177,173,350
2018,3,22,18,157,147,304
2018,3,22,19,107,146,253
2018,3,22,20,111,133,244
2018,3,22,21,74,111,185
2018,3,22,22,29,53,82
2018,3,22,23,23,23,46
2018,3,23,0,20,20,40
2018,3,23,1,10,30,40
2018,3,23,2,13,25,38
2018,3,23,3,11,14,25
2018,3,23,4,20,17,37
2018,3,23,5,120,52,172
2018,3,23,6,254,176,430
2018,3,23,7,395,194,589
2018,3,23,8,272,175,447
2018,3,23,9,261,203,464
2018,3,23,10,259,206,465
2018,3,23,11,239,230,469
2018,3,23,12,235,244,479
2018,3,23,13,242,296,538
2018,3,23,14,250,327,577
2018,3,23,15,227,305,532
2018,3,23,16,163,179,342
2018,3,23,17,152,160,312
2018,3,23,18,116,122,238
2018,3,23,19,108,107,215
2018,3,23,20,71,83,154
2018,3,23,21,64,85,149
2018,3,23,22,42,79,121
2018,3,23,23,28,53,81
2018,3,24,0,29,36,65
2018,3,24,1,11,43,54
2018,3,24,2,15,44,59
2018,3,24,3,11,23,34
2018,3,24,4,11,13,24
2018,3,24,5,24,18,42
2018,3,24,6,26,29,55
2018,3,24,7,35,22,57
2018,3,24,8,57,45,102
2018,3,24,9,98,75,173
2018,3,24,10,125,100,225
2018,3,24,11,151,136,287
2018,3,24,12,149,135,284
2018,3,24,13,150,160,310
2018,3,24,14,138,153,291
2018,3,24,15,121,140,261
2018,3,24,16,98,129,227
2018,3,24,17,129,106,235
2018,3,24,18,88,121,209
2018,3,24,19,86,80,166
2018,3,24,20,57,80,137
2018,3,24,21,43,54,97
2018,3,24,22,41,46,87
2018,3,24,23,39,51,90
2018,3,25,0,35,44,79
2018,3,25,1,35,54,89
2018,3,25,2,21,52,73
2018,3,25,3,13,26,39
2018,3,25,4,15,17,32
2018,3,25,5,19,21,40
2018,3,25,6,24,12,36
2018,3,25,7,44,34,78
2018,3,25,8,59,40,99
2018,3,25,9,77,63,140
2018,3,25,10,117,127,244
2018,3,25,11,118,114,232
2018,3,25,12,159,138,297
2018,3,25,13,139,159,298
2018,3,25,14,137,178,315
2018,3,25,15,141,142,283
2018,3,25,16,143,115,258
2018,3,25,17,126,131,257
2018,3,25,18,124,152,276
2018,3,25,19,59,96,155
2018,3,25,20,46,73,119
2018,3,25,21,42,53,95
2018,3,25,22,17,22,39
2018,3,25,23,17,23,40
2018,3,26,0,5,13,18
2018,3,26,1,10,16,26
2018,3,26,2,7,12,19
2018,3,26,3,22,14,36
2018,3,26,4,66,39,105
2018,3,26,5,125,94,219
2018,3,26,6,190,104,294
2018,3,26,7,197,115,312
2018,3,26,8,174,115,289
2018,3,26,9,179,131,310
2018,3,26,10,172,144,316
2018,3,26,11,166,198,364
2018,3,26,12,185,218,403
2018,3,26,13,192,204,396
2018,3,26,14,149,196,345
2018,3,26,15,149,151,300
2018,3,26,16,130,128,258
2018,3,26,17,123,125,248
2018,3,26,18,96,107,203
2018,3,26,19,65,78,143
2018,3,26,20,38,149,187
2018,3,26,21,33,124,157
2018,3,26,22,22,77,99
2018,3,26,23,18,41,59
2018,3,27,0,12,20,32
2018,3,27,1,17,15,32
2018,3,27,2,11,10,21
2018,3,27,3,20,13,33
2018,3,27,4,68,33,101
2018,3,27,5,125,90,215
2018,3,27,6,164,107,271
2018,3,27,7,170,90,260
2018,3,27,8,165,100,265
2018,3,27,9,162,120,282
2018,3,27,10,174,128,302
2018,3,27,11,178,170,348
2018,3,27,12,191,207,398
2018,3,27,13,173,213,386
2018,3,27,14,142,213,355
2018,3,27,15,139,143,282
2018,3,27,16,141,132,273
2018,3,27,17,122,127,249
2018,3,27,18,76,105,181
2018,3,27,19,57,68,125
2018,3,27,20,55,78,133
2018,3,27,21,25,58,83
2018,3,27,22,21,20,41
2018,3,27,23,15,27,42
2018,3,28,0,14,22,36
2018,3,28,1,8,19,27
2018,3,28,2,12,16,28
2018,3,28,3,8,12,20
2018,3,28,4,53,34,87
2018,3,28,5,106,63,169
2018,3,28,6,135,66,201
2018,3,28,7,119,82,201
2018,3,28,8,134,113,247
2018,3,28,9,160,165,325
2018,3,28,10,232,189,421
2018,3,28,11,159,169,328
2018,3,28,12,152,157,309
2018,3,28,13,127,145,272
2018,3,28,14,119,131,250
2018,3,28,15,102,109,211
2018,3,28,16,112,124,236
2018,3,28,17,91,87,178
2018,3,28,18,65,96,161
2018,3,28,19,60,78,138
2018,3,28,20,55,59,114
2018,3,28,21,25,50,75
2018,3,28,22,22,25,47
2018,3,28,23,14,32,46
2018,3,29,0,15,30,45
2018,3,29,1,8,26,34
2018,3,29,2,4,17,21
2018,3,29,3,4,7,11
2018,3,29,4,19,5,24
2018,3,29,5,13,16,29
2018,3,29,6,21,23,44
2018,3,29,7,38,32,70
2018,3,29,8,47,41,88
2018,3,29,9,74,46,120
2018,3,29,10,90,88,178
2018,3,29,11,88,95,183
2018,3,29,12,98,130,228
2018,3,29,13,106,98,204
2018,3,29,14,109,113,222
2018,3,29,15,111,122,233
2018,3,29,16,92,108,200
2018,3,29,17,79,116,195
2018,3,29,18,80,73,153
2018,3,29,19,50,64,114
2018,3,29,20,33,56,89
2018,3,29,21,21,39,60
2018,3,29,22,20,38,58
2018,3,29,23,18,31,49
2018,3,30,0,15,37,52
2018,3,30,1,11,26,37
2018,3,30,2,6,11,17
2018,3,30,3,3,4,7
2018,3,30,4,13,8,21
2018,3,30,5,12,20,32
2018,3,30,6,17,7,24
2018,3,30,7,29,20,49
2018,3,30,8,44,42,86
2018,3,30,9,75,46,121
2018,3,30,10,96,80,176
2018,3,30,11,101,102,203
2018,3,30,12,122,127,249
2018,3,30,13,125,144,269
2018,3,30,14,94,127,221
2018,3,30,15,89,116,205
2018,3,30,16,104,98,202
2018,3,30,17,70,76,146
2018,3,30,18,78,76,154
2018,3,30,19,62,66,128
2018,3,30,20,48,54,102
2018,3,30,21,28,50,78
2018,3,30,22,15,49,64
2018,3,30,23,13,28,41
2018,3,31,0,20,21,41
2018,3,31,1,12,31,43
2018,3,31,2,10,14,24
2018,3,31,3,6,11,17
2018,3,31,4,14,13,27
2018,3,31,5,13,19,32
2018,3,31,6,26,22,48
2018,3,31,7,52,45,97
2018,3,31,8,91,68,159
2018,3,31,9,121,133,254
2018,3,31,10,98,146,244
2018,3,31,11,111,131,242
2018,3,31,12,107,106,213
2018,3,31,13,91,130,221
2018,3,31,14,134,129,263
2018,3,31,15,96,108,204
2018,3,31,16,103,88,191
2018,3,31,17,80,80,160
2018,3,31,18,74,93,167
2018,3,31,19,68,76,144
2018,3,31,20,46,65,111
2018,3,31,21,36,58,94
2018,3,31,22,34,55,89
2018,3,31,23,23,28,51
2018,4,1,0,23,40,63
2018,4,1,1,18,50,68
2018,4,1,2,12,19,31
2018,4,1,3,6,21,27
2018,4,1,4,15,9,24
2018,4,1,5,11,10,21
2018,4,1,6,17,24,41
2018,4,1,7,55,23,78
2018,4,1,8,60,82,142
2018,4,1,9,56,53,109
2018,4,1,10,95,98,193
2018,4,1,11,98,111,209
2018,4,1,12,128,144,272
2018,4,1,13,106,124,230
2018,4,1,14,89,147,236
2018,4,1,15,101,104,205
2018,4,1,16,118,107,225
2018,4,1,17,98,120,218
2018,4,1,18,114,114,228
2018,4,1,19,93,97,190
2018,4,1,20,60,58,118
2018,4,1,21,45,52,97
2018,4,1,22,24,35,59
2018,4,1,23,14,18,32
2018,4,2,0,11,11,22
2018,4,2,1,14,28,42
2018,4,2,2,6,10,16
2018,4,2,3,4,6,10
2018,4,2,4,20,14,34
2018,4,2,5,12,8,20
2018,4,2,6,24,20,44
2018,4,2,7,36,31,67
2018,4,2,8,47,36,83
2018,4,2,9,99,66,165
2018,4,2,10,109,98,207
2018,4,2,11,109,123,232
2018,4,2,12,188,161,349
2018,4,2,13,148,194,342
2018,4,2,14,168,169,337
2018,4,2,15,131,145,276
2018,4,2,16,155,170,325
2018,4,2,17,148,141,289
2018,4,2,18,142,156,298
2018,4,2,19,79,103,182
2018,4,2,20,59,76,135
2018,4,2,21,31,41,72
2018,4,2,22,16,22,38
2018,4,2,23,11,11,22
2018,4,3,0,0,14,14
2018,4,3,1,2,13,15
2018,4,3,2,1,2,3
2018,4,3,3,24,8,32
2018,4,3,4,108,47,155
2018,4,3,5,226,127,353
2018,4,3,6,403,189,592
2018,4,3,7,269,150,419
2018,4,3,8,216,159,375
2018,4,3,9,188,163,351
2018,4,3,10,189,192,381
2018,4,3,11,199,188,387
2018,4,3,12,220,241,461
2018,4,3,13,226,325,551
2018,4,3,14,199,291,490
2018,4,3,15,177,191,368
2018,4,3,16,176,152,328
2018,4,3,17,142,150,292
2018,4,3,18,135,125,260
2018,4,3,19,95,117,212
2018,4,3,20,60,83,143
2018,4,3,21,30,27,57
2018,4,3,22,15,19,34
2018,4,3,23,19,11,30
2018,4,4,0,10,18,28
2018,4,4,1,5,15,20
2018,4,4,2,7,11,18
2018,4,4,3,23,14,37
2018,4,4,4,103,43,146
2018,4,4,5,238,127,365
2018,4,4,6,383,207,590
2018,4,4,7,262,174,436
2018,4,4,8,231,173,404
2018,4,4,9,212,144,356
2018,4,4,10,207,185,392
2018,4,4,11,216,200,416
2018,4,4,12,197,245,442
2018,4,4,13,251,329,580
2018,4,4,14,205,279,484
2018,4,4,15,196,180,376
2018,4,4,16,150,163,313
2018,4,4,17,129,152,281
2018,4,4,18,120,146,266
2018,4,4,19,95,99,194
2018,4,4,20,58,96,154
2018,4,4,21,53,56,109
2018,4,4,22,29,33,62
2018,4,4,23,16,14,30
2018,4,5,0,12,18,30
2018,4,5,1,10,25,35
2018,4,5,2,7,9,16
2018,4,5,3,13,12,25
2018,4,5,4,91,50,141
2018,4,5,5,230,139,369
2018,4,5,6,412,200,612
2018,4,5,7,274,175,449
2018,4,5,8,215,168,383
2018,4,5,9,228,159,387
2018,4,5,10,215,205,420
2018,4,5,11,211,208,419
2018,4,5,12,202,243,445
2018,4,5,13,249,313,562
2018,4,5,14,240,309,549
2018,4,5,15,220,226,446
2018,4,5,16,186,153,339
2018,4,5,17,139,177,316
2018,4,5,18,101,142,243
2018,4,5,19,110,124,234
2018,4,5,20,66,386,452
2018,4,5,21,35,262,297
2018,4,5,22,21,105,126
2018,4,5,23,14,57,71
2018,4,6,0,10,61,71
2018,4,6,1,9,50,59
2018,4,6,2,7,41,48
2018,4,6,3,19,20,39
2018,4,6,4,112,49,161
2018,4,6,5,252,149,401
2018,4,6,6,377,196,573
2018,4,6,7,259,162,421
2018,4,6,8,210,165,375
2018,4,6,9,240,177,417
2018,4,6,10,218,220,438
2018,4,6,11,199,236,435
2018,4,6,12,234,263,497
2018,4,6,13,265,327,592
2018,4,6,14,240,295,535
2018,4,6,15,179,195,374
2018,4,6,16,161,142,303
2018,4,6,17,110,115,225
2018,4,6,18,98,120,218
2018,4,6,19,77,86,163
2018,4,6,20,52,89,141
2018,4,6,21,45,60,105
2018,4,6,22,38,57,95
2018,4,6,23,29,31,60
2018,4,7,0,16,40,56
2018,4,7,1,12,48,60
2018,4,7,2,9,18,27
2018,4,7,3,8,22,30
2018,4,7,4,17,15,32
2018,4,7,5,24,26,50
2018,4,7,6,44,48,92
2018,4,7,7,81,45,126
2018,4,7,8,121,74,195
2018,4,7,9,168,111,279
2018,4,7,10,176,172,348
2018,4,7,11,164,161,325
2018,4,7,12,166,179,345
2018,4,7,13,147,182,329
2018,4,7,14,127,191,318
2018,4,7,15,145,154,299
2018,4,7,16,134,154,288
2018,4,7,17,104,109,213
2018,4,7,18,82,103,185
2018,4,7,19,78,108,186
2018,4,7,20,73,78,151
2018,4,7,21,53,69,122
2018,4,7,22,35,53,88
2018,4,7,23,35,43,78
2018,4,8,0,26,54,80
2018,4,8,1,24,64,88
2018,4,8,2,29,50,79
2018,4,8,3,13,23,36
2018,4,8,4,12,8,20
2018,4,8,5,14,20,34
2018,4,8,6,34,8,42
2018,4,8,7,45,46,91
2018,4,8,8,100,51,151
2018,4,8,9,94,90,184
2018,4,8,10,135,119,254
2018,4,8,11,164,179,343
2018,4,8,12,174,192,366
2018,4,8,13,167,193,360
2018,4,8,14,129,199,328
2018,4,8,15,166,182,348
2018,4,8,16,143,150,293
2018,4,8,17,123,146,269
2018,4,8,18,180,167,347
2018,4,8,19,81,94,175
2018,4,8,20,55,79,134
2018,4,8,21,20,41,61
2018,4,8,22,10,14,24
2018,4,8,23,10,19,29
2018,4,9,0,7,14,21
2018,4,9,1,5,13,18
2018,4,9,2,15,8,23
2018,4,9,3,20,15,35
2018,4,9,4,119,53,172
2018,4,9,5,257,143,400
2018,4,9,6,444,227,671
2018,4,9,7,281,173,454
2018,4,9,8,231,172,403
2018,4,9,9,229,193,422
2018,4,9,10,192,179,371
2018,4,9,11,222,188,410
2018,4,9,12,212,259,471
2018,4,9,13,237,346,583
2018,4,9,14,232,314,546
2018,4,9,15,197,192,389
2018,4,9,16,190,170,360
2018,4,9,17,138,175,313
2018,4,9,18,109,138,247
2018,4,9,19,95,116,211
2018,4,9,20,80,110,190
2018,4,9,21,26,42,68
2018,4,9,22,19,34,53
2018,4,9,23,9,12,21
2018,4,10,0,4,11,15
2018,4,10,1,5,12,17
2018,4,10,2,9,10,19
2018,4,10,3,20,18,38
2018,4,10,4,108,54,162
2018,4,10,5,267,148,415
2018,4,10,6,416,189,605
2018,4,10,7,265,180,445
2018,4,10,8,264,194,458
2018,4,10,9,229,191,420
2018,4,10,10,199,206,405
2018,4,10,11,227,241,468
2018,4,10,12,210,275,485
2018,4,10,13,278,345,623
2018,4,10,14,235,335,570
2018,4,10,15,203,206,409
2018,4,10,16,202,163,365
2018,4,10,17,160,176,336
2018,4,10,18,134,140,274
2018,4,10,19,86,128,214
2018,4,10,20,54,142,196
2018,4,10,21,26,55,81
2018,4,10,22,25,23,48
2018,4,10,23,18,12,30
2018,4,11,0,4,24,28
2018,4,11,1,8,16,24
2018,4,11,2,10,11,21
2018,4,11,3,21,14,35
2018,4,11,4,111,54,165
2018,4,11,5,242,149,391
2018,4,11,6,410,204,614
2018,4,11,7,250,138,388
2018,4,11,8,233,190,423
2018,4,11,9,208,217,425
2018,4,11,10,204,200,404
2018,4,11,11,220,215,435
2018,4,11,12,216,223,439
2018,4,11,13,264,351,615
2018,4,11,14,254,319,573
2018,4,11,15,206,206,412
2018,4,11,16,178,162,340
2018,4,11,17,140,196,336
2018,4,11,18,107,155,262
2018,4,11,19,100,128,228
2018,4,11,20,73,111,184
2018,4,11,21,31,55,86
2018,4,11,22,20,27,47
2018,4,11,23,12,25,37
2018,4,12,0,9,17,26
2018,4,12,1,7,19,26
2018,4,12,2,7,18,25
2018,4,12,3,12,18,30
2018,4,12,4,113,49,162
2018,4,12,5,234,176,410
2018,4,12,6,412,190,602
2018,4,12,7,282,165,447
2018,4,12,8,204,164,368
2018,4,12,9,235,204,439
2018,4,12,10,205,230,435
2018,4,12,11,235,215,450
2018,4,12,12,220,272,492
2018,4,12,13,248,351,599
2018,4,12,14,256,288,544
2018,4,12,15,209,207,416
2018,4,12,16,208,202,410
2018,4,12,17,161,199,360
2018,4,12,18,132,171,303
2018,4,12,19,86,130,216
2018,4,12,20,76,102,178
2018,4,12,21,35,44,79
2018,4,12,22,14,29,43
2018,4,12,23,15,29,44
2018,4,13,0,14,32,46
2018,4,13,1,10,24,34
2018,4,13,2,14,13,27
2018,4,13,3,20,13,33
2018,4,13,4,106,49,155
2018,4,13,5,244,157,401
2018,4,13,6,404,195,599
2018,4,13,7,227,173,400
2018,4,13,8,259,171,430
2018,4,13,9,218,174,392
2018,4,13,10,251,208,459
2018,4,13,11,232,255,487
2018,4,13,12,245,320,565
2018,4,13,13,300,367,667
2018,4,13,14,246,303,549
2018,4,13,15,168,186,354
2018,4,13,16,162,163,325
2018,4,13,17,113,129,242
2018,4,13,18,99,85,184
2018,4,13,19,83,99,182
2018,4,13,20,64,88,152
2018,4,13,21,51,62,113
2018,4,13,22,32,52,84
2018,4,13,23,20,38,58
2018,4,14,0,25,43,68
2018,4,14,1,17,37,54
2018,4,14,2,15,28,43
2018,4,14,3,10,15,25
2018,4,14,4,22,24,46
2018,4,14,5,39,25,64
2018,4,14,6,49,44,93
2018,4,14,7,87,54,141
2018,4,14,8,105,92,197
2018,4,14,9,158,126,284
2018,4,14,10,172,138,310
2018,4,14,11,154,165,319
2018,4,14,12,164,181,345
2018,4,14,13,132,208,340
2018,4,14,14,143,168,311
2018,4,14,15,139,165,304
2018,4,14,16,141,160,301
2018,4,14,17,101,130,231
2018,4,14,18,93,80,173
2018,4,14,19,59,81,140
2018,4,14,20,60,79,139
2018,4,14,21,46,58,104
2018,4,14,22,40,44,84
2018,4,14,23,26,47,73
2018,4,15,0,29,43,72
2018,4,15,1,17,47,64
2018,4,15,2,9,34,43
2018,4,15,3,15,19,34
2018,4,15,4,18,16,34
2018,4,15,5,8,19,27
2018,4,15,6,33,20,53
2018,4,15,7,55,33,88
2018,4,15,8,118,74,192
2018,4,15,9,157,101,258
2018,4,15,10,175,161,336
2018,4,15,11,159,202,361
2018,4,15,12,185,171,356
2018,4,15,13,163,214,377
2018,4,15,14,167,232,399
2018,4,15,15,166,200,366
2018,4,15,16,204,168,372
2018,4,15,17,142,185,327
2018,4,15,18,120,173,293
2018,4,15,19,90,136,226
2018,4,15,20,59,90,149
2018,4,15,21,28,50,78
2018,4,15,22,14,20,34
2018,4,15,23,7,9,16
2018,4,16,0,6,10,16
2018,4,16,1,5,14,19
2018,4,16,2,6,11,17
2018,4,16,3,20,15,35
2018,4,16,4,112,61,173
2018,4,16,5,237,157,394
2018,4,16,6,380,230,610
2018,4,16,7,276,180,456
2018,4,16,8,239,186,425
2018,4,16,9,203,163,366
2018,4,16,10,238,200,438
2018,4,16,11,235,204,439
2018,4,16,12,205,239,444
2018,4,16,13,274,359,633
2018,4,16,14,219,330,549
2018,4,16,15,199,215,414
2018,4,16,16,176,179,355
2018,4,16,17,142,143,285
2018,4,16,18,117,126,243
2018,4,16,19,103,142,245
2018,4,16,20,57,87,144
2018,4,16,21,41,49,90
2018,4,16,22,13,31,44
2018,4,16,23,9,11,20
2018,4,17,0,4,15,19
2018,4,17,1,4,11,15
2018,4,17,2,7,9,16
2018,4,17,3,27,28,55
2018,4,17,4,105,55,160
2018,4,17,5,253,162,415
2018,4,17,6,417,211,628
2018,4,17,7,281,183,464
2018,4,17,8,262,194,456
2018,4,17,9,220,186,406
2018,4,17,10,223,193,416
2018,4,17,11,190,205,395
2018,4,17,12,237,254,491
2018,4,17,13,245,354,599
2018,4,17,14,249,319,568
2018,4,17,15,200,187,387
2018,4,17,16,191,165,356
2018,4,17,17,148,158,306
2018,4,17,18,123,166,289
2018,4,17,19,80,115,195
2018,4,17,20,61,100,161
2018,4,17,21,38,49,87
2018,4,17,22,14,24,38
2018,4,17,23,8,18,26
2018,4,18,0,5,10,15
2018,4,18,1,6,10,16
2018,4,18,2,9,9,18
2018,4,18,3,17,16,33
2018,4,18,4,109,57,166
2018,4,18,5,259,141,400
2018,4,18,6,407,213,620
2018,4,18,7,284,161,445
2018,4,18,8,231,202,433
2018,4,18,9,227,190,417
2018,4,18,10,197,205,402
2018,4,18,11,217,222,439
2018,4,18,12,194,236,430
2018,4,18,13,253,359,612
2018,4,18,14,238,324,562
2018,4,18,15,216,189,405
2018,4,18,16,193,162,355
2018,4,18,17,137,166,303
2018,4,18,18,142,139,281
2018,4,18,19,92,126,218
2018,4,18,20,64,105,169
2018,4,18,21,34,178,212
2018,4,18,22,12,103,115
2018,4,18,23,16,23,39
2018,4,19,0,10,22,32
2018,4,19,1,6,15,21
2018,4,19,2,9,12,21
2018,4,19,3,20,15,35
2018,4,19,4,117,63,180
2018,4,19,5,267,162,429
2018,4,19,6,392,185,577
2018,4,19,7,234,152,386
2018,4,19,8,267,200,467
2018,4,19,9,216,201,417
2018,4,19,10,204,213,417
2018,4,19,11,229,218,447
2018,4,19,12,235,284,519
2018,4,19,13,271,405,676
2018,4,19,14,239,339,578
2018,4,19,15,227,200,427
2018,4,19,16,176,203,379
2018,4,19,17,176,194,370
2018,4,19,18,124,139,263
2018,4,19,19,85,131,216
2018,4,19,20,52,89,141
2018,4,19,21,28,74,102
2018,4,19,22,19,28,47
2018,4,19,23,11,24,35
2018,4,20,0,6,22,28
2018,4,20,1,2,20,22
2018,4,20,2,13,18,31
2018,4,20,3,19,10,29
2018,4,20,4,118,57,175
2018,4,20,5,258,153,411
2018,4,20,6,385,221,606
2018,4,20,7,233,177,410
2018,4,20,8,223,158,381
2018,4,20,9,254,169,423
2018,4,20,10,215,212,427
2018,4,20,11,233,254,487
2018,4,20,12,245,262,507
2018,4,20,13,241,304,545
2018,4,20,14,204,285,489
2018,4,20,15,148,169,317
2018,4,20,16,158,162,320
2018,4,20,17,134,126,260
2018,4,20,18,95,121,216
2018,4,20,19,83,85,168
2018,4,20,20,60,108,168
2018,4,20,21,58,65,123
2018,4,20,22,34,44,78
2018,4,20,23,28,39,67
2018,4,21,0,19,40,59
2018,4,21,1,9,41,50
2018,4,21,2,11,22,33
2018,4,21,3,17,11,28
2018,4,21,4,28,28,56
2018,4,21,5,27,26,53
2018,4,21,6,45,39,84
2018,4,21,7,75,48,123
2018,4,21,8,131,96,227
2018,4,21,9,134,119,253
2018,4,21,10,144,130,274
2018,4,21,11,184,156,340
2018,4,21,12,159,165,324
2018,4,21,13,171,202,373
2018,4,21,14,151,209,360
2018,4,21,15,167,204,371
2018,4,21,16,141,160,301
2018,4,21,17,115,136,251
2018,4,21,18,132,106,238
2018,4,21,19,65,78,143
2018,4,21,20,42,79,121
2018,4,21,21,61,70,131
2018,4,21,22,32,61,93
2018,4,21,23,30,57,87
2018,4,22,0,23,61,84
2018,4,22,1,21,58,79
2018,4,22,2,15,41,56
2018,4,22,3,15,13,28
2018,4,22,4,18,16,34
2018,4,22,5,12,14,26
2018,4,22,6,37,15,52
2018,4,22,7,56,58,114
2018,4,22,8,97,75,172
2018,4,22,9,129,117,246
2018,4,22,10,160,148,308
2018,4,22,11,152,192,344
2018,4,22,12,182,185,367
2018,4,22,13,164,176,340
2018,4,22,14,168,216,384
2018,4,22,15,149,157,306
2018,4,22,16,146,157,303
2018,4,22,17,148,148,296
2018,4,22,18,139,166,305
2018,4,22,19,86,108,194
2018,4,22,20,66,80,146
2018,4,22,21,38,39,77
2018,4,22,22,19,21,40
2018,4,22,23,13,23,36
2018,4,23,0,2,20,22
2018,4,23,1,7,16,23
2018,4,23,2,8,10,18
2018,4,23,3,19,10,29
2018,4,23,4,133,62,195
2018,4,23,5,253,177,430
2018,4,23,6,414,196,610
2018,4,23,7,267,151,418
2018,4,23,8,248,167,415
2018,4,23,9,225,179,404
2018,4,23,10,206,338,544
2018,4,23,11,197,357,554
2018,4,23,12,214,453,667
2018,4,23,13,258,262,520
2018,4,23,14,241,344,585
2018,4,23,15,198,354,552
2018,4,23,16,181,189,370
2018,4,23,17,131,166,297
2018,4,23,18,138,142,280
2018,4,23,19,92,116,208
2018,4,23,20,59,88,147
2018,4,23,21,40,41,81
2018,4,23,22,16,18,34
2018,4,23,23,14,16,30
2018,4,24,0,5,12,17
2018,4,24,1,4,9,13
2018,4,24,2,7,9,16
2018,4,24,3,31,14,45
2018,4,24,4,130,69,199
2018,4,24,5,263,155,418
2018,4,24,6,409,229,638
2018,4,24,7,296,169,465
2018,4,24,8,228,185,413
2018,4,24,9,232,215,447
2018,4,24,10,203,168,371
2018,4,24,11,230,241,471
2018,4,24,12,218,244,462
2018,4,24,13,250,339,589
2018,4,24,14,244,302,546
2018,4,24,15,207,222,429
2018,4,24,16,219,217,436
2018,4,24,17,156,177,333
2018,4,24,18,126,141,267
2018,4,24,19,67,95,162
2018,4,24,20,75,101,176
2018,4,24,21,50,63,113
2018,4,24,22,24,24,48
2018,4,24,23,17,18,35
2018,4,25,0,7,15,22
2018,4,25,1,4,13,17
2018,4,25,2,11,6,17
2018,4,25,3,25,16,41
2018,4,25,4,111,63,174
2018,4,25,5,242,141,383
2018,4,25,6,434,199,633
2018,4,25,7,276,173,449
2018,4,25,8,222,178,400
2018,4,25,9,247,164,411
2018,4,25,10,217,219,436
2018,4,25,11,216,233,449
2018,4,25,12,217,231,448
2018,4,25,13,251,333,584
2018,4,25,14,251,323,574
2018,4,25,15,184,211,395
2018,4,25,16,189,176,365
2018,4,25,17,139,154,293
2018,4,25,18,120,127,247
2018,4,25,19,97,126,223
2018,4,25,20,66,100,166
2018,4,25,21,41,60,101
2018,4,25,22,20,43,63
2018,4,25,23,10,19,29
2018,4,26,0,8,18,26
2018,4,26,1,7,16,23
2018,4,26,2,11,13,24
2018,4,26,3,23,17,40
2018,4,26,4,120,51,171
2018,4,26,5,240,169,409
2018,4,26,6,405,215,620
2018,4,26,7,251,157,408
2018,4,26,8,253,164,417
2018,4,26,9,223,165,388
2018,4,26,10,247,224,471
2018,4,26,11,216,220,436
2018,4,26,12,248,276,524
2018,4,26,13,286,375,661
2018,4,26,14,273,343,616
2018,4,26,15,227,215,442
2018,4,26,16,183,152,335
2018,4,26,17,147,179,326
2018,4,26,18,114,152,266
2018,4,26,19,103,128,231
2018,4,26,20,77,107,184
2018,4,26,21,47,88,135
2018,4,26,22,35,36,71
2018,4,26,23,12,29,41
2018,4,27,0,10,26,36
2018,4,27,1,7,31,38
2018,4,27,2,10,19,29
2018,4,27,3,26,16,42
2018,4,27,4,124,54,178
2018,4,27,5,261,156,417
2018,4,27,6,411,220,631
2018,4,27,7,259,163,422
2018,4,27,8,235,184,419
2018,4,27,9,253,195,448
2018,4,27,10,200,213,413
2018,4,27,11,260,241,501
2018,4,27,12,274,319,593
2018,4,27,13,267,346,613
2018,4,27,14,235,360,595
2018,4,27,15,185,213,398
2018,4,27,16,173,176,349
2018,4,27,17,135,169,304
2018,4,27,18,118,113,231
2018,4,27,19,96,96,192
2018,4,27,20,69,98,167
2018,4,27,21,44,70,114
2018,4,27,22,41,70,111
2018,4,27,23,30,34,64
2018,4,28,0,22,26,48
2018,4,28,1,17,37,54
2018,4,28,2,8,33,41
2018,4,28,3,12,14,26
2018,4,28,4,25,18,43
2018,4,28,5,35,33,68
2018,4,28,6,63,32,95
2018,4,28,7,115,54,169
2018,4,28,8,138,65,203
2018,4,28,9,169,94,263
2018,4,28,10,158,117,275
2018,4,28,11,151,131,282
2018,4,28,12,177,172,349
2018,4,28,13,136,133,269
2018,4,28,14,174,169,343
2018,4,28,15,142,161,303
2018,4,28,16,135,156,291
2018,4,28,17,115,130,245
2018,4,28,18,113,139,252
2018,4,28,19,85,117,202
2018,4,28,20,63,82,145
2018,4,28,21,60,81,141
2018,4,28,22,31,46,77
2018,4,28,23,43,48,91
2018,4,29,0,27,49,76
2018,4,29,1,34,50,84
2018,4,29,2,26,37,63
2018,4,29,3,17,9,26
2018,4,29,4,16,13,29
2018,4,29,5,18,16,34
2018,4,29,6,34,19,53
2018,4,29,7,69,50,119
2018,4,29,8,120,78,198
2018,4,29,9,136,109,245
2018,4,29,10,158,171,329
2018,4,29,11,171,167,338
2018,4,29,12,173,209,382
2018,4,29,13,137,237,374
2018,4,29,14,171,237,408
2018,4,29,15,152,197,349
2018,4,29,16,137,130,267
2018,4,29,17,144,178,322
2018,4,29,18,138,170,308
2018,4,29,19,87,132,219
2018,4,29,20,87,82,169
2018,4,29,21,49,49,98
2018,4,29,22,22,26,48
2018,4,29,23,11,17,28
2018,4,30,0,12,13,25
2018,4,30,1,10,12,22
2018,4,30,2,12,8,20
2018,4,30,3,23,9,32
2018,4,30,4,102,49,151
2018,4,30,5,223,126,349
2018,4,30,6,317,177,494
2018,4,30,7,248,168,416
2018,4,30,8,196,165,361
2018,4,30,9,228,179,407
2018,4,30,10,201,223,424
2018,4,30,11,226,239,465
2018,4,30,12,236,251,487
2018,4,30,13,249,452,701
2018,4,30,14,199,335,534
2018,4,30,15,197,191,388
2018,4,30,16,175,189,364
2018,4,30,17,148,145,293
2018,4,30,18,131,135,266
2018,4,30,19,92,119,211
2018,4,30,20,73,95,168
2018,4,30,21,38,68,106
2018,4,30,22,26,48,74
2018,4,30,23,28,37,65
2018,5,1,0,29,46,75
2018,5,1,1,17,38,55
2018,5,1,2,15,29,44
2018,5,1,3,11,14,25
2018,5,1,4,16,11,27
2018,5,1,5,28,24,52
2018,5,1,6,40,33,73
2018,5,1,7,68,35,103
2018,5,1,8,84,55,139
2018,5,1,9,103,92,195
2018,5,1,10,134,116,250
2018,5,1,11,130,151,281
2018,5,1,12,151,165,316
2018,5,1,13,137,151,288
2018,5,1,14,137,165,302
2018,5,1,15,131,156,287
2018,5,1,16,130,166,296
2018,5,1,17,122,152,274
2018,5,1,18,114,146,260
2018,5,1,19,73,85,158
2018,5,1,20,44,71,115
2018,5,1,21,25,41,66
2018,5,1,22,20,20,40
2018,5,1,23,9,20,29
2018,5,2,0,8,9,17
2018,5,2,1,6,17,23
2018,5,2,2,8,6,14
2018,5,2,3,19,17,36
2018,5,2,4,107,48,155
2018,5,2,5,246,145,391
2018,5,2,6,451,243,694
2018,5,2,7,280,177,457
2018,5,2,8,229,177,406
2018,5,2,9,214,198,412
2018,5,2,10,201,204,405
2018,5,2,11,241,241,482
2018,5,2,12,231,244,475
2018,5,2,13,246,359,605
2018,5,2,14,234,309,543
2018,5,2,15,202,217,419
2018,5,2,16,145,156,301
2018,5,2,17,148,174,322
2018,5,2,18,129,159,288
2018,5,2,19,85,124,209
2018,5,2,20,71,101,172
2018,5,2,21,38,51,89
2018,5,2,22,18,23,41
2018,5,2,23,18,16,34
2018,5,3,0,7,13,20
2018,5,3,1,11,20,31
2018,5,3,2,10,8,18
2018,5,3,3,17,14,31
2018,5,3,4,107,63,170
2018,5,3,5,255,163,418
2018,5,3,6,412,240,652
2018,5,3,7,259,162,421
2018,5,3,8,235,172,407
2018,5,3,9,230,184,414
2018,5,3,10,235,223,458
2018,5,3,11,240,213,453
2018,5,3,12,224,244,468
2018,5,3,13,230,356,586
2018,5,3,14,212,281,493
2018,5,3,15,227,226,453
2018,5,3,16,182,213,395
2018,5,3,17,155,182,337
2018,5,3,18,107,132,239
2018,5,3,19,101,111,212
2018,5,3,20,75,82,157
2018,5,3,21,45,63,108
2018,5,3,22,23,73,96
2018,5,3,23,12,31,43
2018,5,4,0,5,17,22
2018,5,4,1,11,21,32
2018,5,4,2,7,7,14
2018,5,4,3,24,14,38
2018,5,4,4,118,54,172
2018,5,4,5,268,188,456
2018,5,4,6,400,219,619
2018,5,4,7,252,164,416
2018,5,4,8,233,164,397
2018,5,4,9,246,189,435
2018,5,4,10,249,223,472
2018,5,4,11,230,240,470
2018,5,4,12,253,293,546
2018,5,4,13,240,363,603
2018,5,4,14,201,358,559
2018,5,4,15,175,184,359
2018,5,4,16,144,166,310
2018,5,4,17,121,140,261
2018,5,4,18,96,118,214
2018,5,4,19,81,117,198
2018,5,4,20,52,63,115
2018,5,4,21,49,52,101
2018,5,4,22,32,43,75
2018,5,4,23,24,26,50
2018,5,5,0,17,23,40
2018,5,5,1,19,31,50
2018,5,5,2,8,17,25
2018,5,5,3,8,13,21
2018,5,5,4,19,8,27
2018,5,5,5,30,28,58
2018,5,5,6,49,51,100
2018,5,5,7,71,50,121
2018,5,5,8,105,88,193
2018,5,5,9,159,109,268
2018,5,5,10,158,162,320
2018,5,5,11,141,144,285
2018,5,5,12,121,193,314
2018,5,5,13,144,145,289
2018,5,5,14,140,198,338
2018,5,5,15,149,143,292
2018,5,5,16,137,149,286
2018,5,5,17,106,140,246
2018,5,5,18,111,134,245
2018,5,5,19,70,102,172
2018,5,5,20,65,72,137
2018,5,5,21,42,71,113
2018,5,5,22,43,53,96
2018,5,5,23,33,44,77
2018,5,6,0,31,43,74
2018,5,6,1,31,68,99
2018,5,6,2,14,38,52
2018,5,6,3,12,13,25
2018,5,6,4,18,15,33
2018,5,6,5,16,23,39
2018,5,6,6,32,23,55
2018,5,6,7,54,47,101
2018,5,6,8,107,74,181
2018,5,6,9,125,65,190
2018,5,6,10,160,141,301
2018,5,6,11,171,186,357
2018,5,6,12,215,187,402
2018,5,6,13,164,194,358
2018,5,6,14,154,243,397
2018,5,6,15,162,209,371
2018,5,6,16,145,182,327
2018,5,6,17,157,187,344
2018,5,6,18,132,170,302
2018,5,6,19,88,130,218
2018,5,6,20,118,89,207
2018,5,6,21,41,62,103
2018,5,6,22,13,35,48
2018,5,6,23,7,15,22
2018,5,7,0,7,9,16
2018,5,7,1,4,5,9
2018,5,7,2,9,7,16
2018,5,7,3,23,14,37
2018,5,7,4,134,68,202
2018,5,7,5,261,157,418
2018,5,7,6,404,209,613
2018,5,7,7,264,162,426
2018,5,7,8,217,164,381
2018,5,7,9,209,189,398
2018,5,7,10,225,229,454
2018,5,7,11,225,226,451
2018,5,7,12,226,267,493
2018,5,7,13,245,343,588
2018,5,7,14,215,330,545
2018,5,7,15,200,222,422
2018,5,7,16,188,153,341
2018,5,7,17,147,141,288
2018,5,7,18,121,121,242
2018,5,7,19,96,149,245
2018,5,7,20,65,88,153
2018,5,7,21,30,66,96
2018,5,7,22,21,30,51
2018,5,7,23,11,21,32
2018,5,8,0,10,11,21
2018,5,8,1,4,17,21
2018,5,8,2,7,12,19
2018,5,8,3,17,11,28
2018,5,8,4,104,57,161
2018,5,8,5,258,176,434
2018,5,8,6,430,188,618
2018,5,8,7,271,197,468
2018,5,8,8,245,167,412
2018,5,8,9,237,177,414
2018,5,8,10,240,248,488
2018,5,8,11,199,203,402
2018,5,8,12,222,299,521
2018,5,8,13,228,363,591
2018,5,8,14,250,301,551
2018,5,8,15,184,186,370
2018,5,8,16,170,162,332
2018,5,8,17,144,168,312
2018,5,8,18,128,137,265
2018,5,8,19,101,124,225
2018,5,8,20,59,111,170
2018,5,8,21,43,80,123
2018,5,8,22,19,30,49
2018,5,8,23,13,22,35
2018,5,9,0,10,17,27
2018,5,9,1,6,14,20
2018,5,9,2,9,9,18
2018,5,9,3,23,14,37
2018,5,9,4,113,53,166
2018,5,9,5,220,173,393
2018,5,9,6,413,215,628
2018,5,9,7,250,179,429
2018,5,9,8,243,168,411
2018,5,9,9,254,206,460
2018,5,9,10,211,210,421
2018,5,9,11,232,243,475
2018,5,9,12,237,259,496
2018,5,9,13,289,355,644
2018,5,9,14,216,305,521
2018,5,9,15,179,202,381
2018,5,9,16,159,164,323
2018,5,9,17,134,151,285
2018,5,9,18,112,145,257
2018,5,9,19,95,121,216
2018,5,9,20,78,106,184
2018,5,9,21,51,65,116
2018,5,9,22,43,47,90
2018,5,9,23,18,35,53
2018,5,10,0,17,34,51
2018,5,10,1,16,32,48
2018,5,10,2,11,21,32
2018,5,10,3,8,10,18
2018,5,10,4,15,13,28
2018,5,10,5,28,21,49
2018,5,10,6,51,37,88
2018,5,10,7,56,36,92
2018,5,10,8,132,88,220
2018,5,10,9,121,97,218
2018,5,10,10,175,119,294
2018,5,10,11,142,166,308
2018,5,10,12,176,186,362
2018,5,10,13,170,243,413
2018,5,10,14,172,225,397
2018,5,10,15,142,216,358
2018,5,10,16,134,140,274
2018,5,10,17,136,149,285
2018,5,10,18,100,155,255
2018,5,10,19,99,110,209
2018,5,10,20,44,77,121
2018,5,10,21,37,58,95
2018,5,10,22,29,38,67
2018,5,10,23,11,17,28
2018,5,11,0,5,17,22
2018,5,11,1,6,17,23
2018,5,11,2,9,12,21
2018,5,11,3,19,13,32
2018,5,11,4,81,45,126
2018,5,11,5,205,103,308
2018,5,11,6,289,149,438
2018,5,11,7,224,155,379
2018,5,11,8,231,171,402
2018,5,11,9,214,200,414
2018,5,11,10,222,233,455
2018,5,11,11,221,222,443
2018,5,11,12,211,260,471
2018,5,11,13,230,262,492
2018,5,11,14,181,244,425
2018,5,11,15,157,191,348
2018,5,11,16,123,151,274
2018,5,11,17,99,144,243
2018,5,11,18,93,133,226
2018,5,11,19,86,99,185
2018,5,11,20,63,90,153
2018,5,11,21,44,56,100
2018,5,11,22,32,42,74
2018,5,11,23,22,44,66
2018,5,12,0,17,24,41
2018,5,12,1,16,36,52
2018,5,12,2,12,18,30
2018,5,12,3,13,13,26
2018,5,12,4,23,16,39
2018,5,12,5,31,26,57
2018,5,12,6,42,39,81
2018,5,12,7,75,70,145
2018,5,12,8,115,83,198
2018,5,12,9,145,112,257
2018,5,12,10,146,164,310
2018,5,12,11,155,138,293
2018,5,12,12,131,145,276
2018,5,12,13,136,173,309
2018,5,12,14,138,159,297
2018,5,12,15,124,166,290
2018,5,12,16,98,139,237
2018,5,12,17,106,113,219
2018,5,12,18,99,96,195
2018,5,12,19,50,88,138
2018,5,12,20,52,65,117
2018,5,12,21,50,62,112
2018,5,12,22,43,57,100
2018,5,12,23,37,49,86
2018,5,13,0,25,38,63
2018,5,13,1,24,49,73
2018,5,13,2,22,37,59
2018,5,13,3,12,14,26
2018,5,13,4,15,11,26
2018,5,13,5,11,16,27
2018,5,13,6,30,25,55
2018,5,13,7,52,50,102
2018,5,13,8,85,71,156
2018,5,13,9,118,97,215
2018,5,13,10,154,131,285
2018,5,13,11,148,171,319
2018,5,13,12,160,202,362
2018,5,13,13,147,171,318
2018,5,13,14,153,193,346
2018,5,13,15,174,178,352
2018,5,13,16,176,187,363
2018,5,13,17,134,172,306
2018,5,13,18,119,167,286
2018,5,13,19,130,156,286
2018,5,13,20,64,97,161
2018,5,13,21,42,59,101
2018,5,13,22,21,42,63
2018,5,13,23,14,20,34
2018,5,14,0,6,12,18
2018,5,14,1,5,18,23
2018,5,14,2,14,4,18
2018,5,14,3,25,20,45
2018,5,14,4,112,59,171
2018,5,14,5,238,169,407
2018,5,14,6,394,231,625
2018,5,14,7,281,172,453
2018,5,14,8,234,191,425
2018,5,14,9,243,177,420
2018,5,14,10,211,237,448
2018,5,14,11,245,222,467
2018,5,14,12,245,288,533
2018,5,14,13,249,366,615
2018,5,14,14,244,300,544
2018,5,14,15,205,214,419
2018,5,14,16,183,179,362
2018,5,14,17,143,182,325
2018,5,14,18,120,143,263
2018,5,14,19,90,151,241
2018,5,14,20,74,115,189
2018,5,14,21,34,60,94
2018,5,14,22,16,28,44
2018,5,14,23,7,16,23
2018,5,15,0,13,12,25
2018,5,15,1,6,10,16
2018,5,15,2,6,12,18
2018,5,15,3,22,15,37
2018,5,15,4,113,53,166
2018,5,15,5,229,169,398
2018,5,15,6,428,222,650
2018,5,15,7,299,189,488
2018,5,15,8,250,196,446
2018,5,15,9,232,199,431
2018,5,15,10,252,224,476
2018,5,15,11,243,260,503
2018,5,15,12,247,293,540
2018,5,15,13,286,363,649
2018,5,15,14,248,308,556
2018,5,15,15,181,192,373
2018,5,15,16,194,170,364
2018,5,15,17,167,178,345
2018,5,15,18,165,180,345
2018,5,15,19,108,141,249
2018,5,15,20,75,121,196
2018,5,15,21,56,64,120
2018,5,15,22,25,31,56
2018,5,15,23,8,23,31
2018,5,16,0,11,23,34
2018,5,16,1,4,16,20
2018,5,16,2,6,12,18
2018,5,16,3,15,15,30
2018,5,16,4,114,57,171
2018,5,16,5,269,166,435
2018,5,16,6,395,210,605
2018,5,16,7,297,195,492
2018,5,16,8,269,208,477
2018,5,16,9,223,223,446
2018,5,16,10,273,246,519
2018,5,16,11,244,256,500
2018,5,16,12,263,292,555
2018,5,16,13,299,433,732
2018,5,16,14,256,503,759
2018,5,16,15,194,320,514
2018,5,16,16,177,165,342
2018,5,16,17,174,178,352
2018,5,16,18,253,206,459
2018,5,16,19,126,170,296
2018,5,16,20,93,119,212
2018,5,16,21,67,80,147
2018,5,16,22,37,53,90
2018,5,16,23,17,34,51
2018,5,17,0,14,35,49
2018,5,17,1,18,38,56
2018,5,17,2,10,19,29
2018,5,17,3,20,15,35
2018,5,17,4,49,42,91
2018,5,17,5,82,54,136
2018,5,17,6,144,105,249
2018,5,17,7,274,194,468
2018,5,17,8,439,174,613
2018,5,17,9,242,238,480
2018,5,17,10,130,360,490
2018,5,17,11,143,366,509
2018,5,17,12,110,250,360
2018,5,17,13,118,188,306
2018,5,17,14,101,139,240
2018,5,17,15,96,146,242
2018,5,17,16,111,117,228
2018,5,17,17,110,109,219
2018,5,17,18,81,130,211
2018,5,17,19,88,109,197
2018,5,17,20,109,80,189
2018,5,17,21,58,133,191
2018,5,17,22,41,65,106
2018,5,17,23,25,60,85
2018,5,18,0,21,47,68
2018,5,18,1,24,56,80
2018,5,18,2,17,42,59
2018,5,18,3,22,21,43
2018,5,18,4,67,45,112
2018,5,18,5,111,95,206
2018,5,18,6,148,98,246
2018,5,18,7,170,125,295
2018,5,18,8,170,139,309
2018,5,18,9,187,171,358
2018,5,18,10,223,222,445
2018,5,18,11,200,185,385
2018,5,18,12,177,222,399
2018,5,18,13,180,271,451
2018,5,18,14,151,222,373
2018,5,18,15,155,146,301
2018,5,18,16,104,126,230
2018,5,18,17,116,129,245
2018,5,18,18,92,96,188
2018,5,18,19,80,106,186
2018,5,18,20,64,80,144
2018,5,18,21,46,44,90
2018,5,18,22,37,34,71
2018,5,18,23,17,28,45
2018,5,19,0,12,26,38
2018,5,19,1,10,23,33
2018,5,19,2,9,13,22
2018,5,19,3,15,7,22
2018,5,19,4,14,18,32
2018,5,19,5,28,29,57
2018,5,19,6,35,45,80
2018,5,19,7,55,53,108
2018,5,19,8,87,74,161
2018,5,19,9,113,111,224
2018,5,19,10,122,114,236
2018,5,19,11,118,135,253
2018,5,19,12,125,138,263
2018,5,19,13,110,140,250
2018,5,19,14,136,147,283
2018,5,19,15,120,149,269
2018,5,19,16,130,156,286
2018,5,19,17,87,134,221
2018,5,19,18,109,120,229
2018,5,19,19,89,93,182
2018,5,19,20,48,73,121
2018,5,19,21,54,56,110
2018,5,19,22,49,57,106
2018,5,19,23,19,38,57
2018,5,20,0,21,37,58
2018,5,20,1,18,47,65
2018,5,20,2,13,23,36
2018,5,20,3,11,15,26
2018,5,20,4,11,11,22
2018,5,20,5,20,24,44
2018,5,20,6,27,24,51
2018,5,20,7,39,35,74
2018,5,20,8,87,62,149
2018,5,20,9,84,59,143
2018,5,20,10,122,137,259
2018,5,20,11,125,113,238
2018,5,20,12,130,153,283
2018,5,20,13,115,181,296
2018,5,20,14,147,168,315
2018,5,20,15,124,124,248
2018,5,20,16,118,143,261
2018,5,20,17,133,161,294
2018,5,20,18,114,158,272
2018,5,20,19,81,122,203
2018,5,20,20,59,82,141
2018,5,20,21,48,66,114
2018,5,20,22,24,26,50
2018,5,20,23,18,28,46
2018,5,21,0,12,29,41
2018,5,21,1,13,23,36
2018,5,21,2,8,11,19
2018,5,21,3,12,6,18
2018,5,21,4,10,12,22
2018,5,21,5,28,27,55
2018,5,21,6,32,28,60
2018,5,21,7,46,46,92
2018,5,21,8,86,58,144
2018,5,21,9,106,107,213
2018,5,21,10,142,128,270
2018,5,21,11,115,143,258
2018,5,21,12,142,145,287
2018,5,21,13,147,174,321
2018,5,21,14,155,188,343
2018,5,21,15,129,178,307
2018,5,21,16,139,153,292
2018,5,21,17,167,173,340
2018,5,21,18,114,154,268
2018,5,21,19,111,133,244
2018,5,21,20,70,92,162
2018,5,21,21,35,66,101
2018,5,21,22,21,32,53
2018,5,21,23,16,19,35
2018,5,22,0,4,15,19
2018,5,22,1,8,10,18
2018,5,22,2,9,15,24
2018,5,22,3,22,17,39
2018,5,22,4,113,54,167
2018,5,22,5,216,156,372
2018,5,22,6,381,219,600
2018,5,22,7,291,184,475
2018,5,22,8,232,170,402
2018,5,22,9,198,186,384
2018,5,22,10,213,212,425
2018,5,22,11,231,229,460
2018,5,22,12,244,289,533
2018,5,22,13,257,373,630
2018,5,22,14,209,325,534
2018,5,22,15,181,200,381
2018,5,22,16,190,186,376
2018,5,22,17,135,147,282
2018,5,22,18,124,169,293
2018,5,22,19,98,121,219
2018,5,22,20,70,91,161
2018,5,22,21,31,50,81
2018,5,22,22,26,20,46
2018,5,22,23,15,16,31
2018,5,23,0,8,13,21
2018,5,23,1,7,9,16
2018,5,23,2,10,5,15
2018,5,23,3,18,12,30
2018,5,23,4,107,58,165
2018,5,23,5,230,166,396
2018,5,23,6,382,207,589
2018,5,23,7,261,159,420
2018,5,23,8,223,203,426
2018,5,23,9,224,185,409
2018,5,23,10,234,188,422
2018,5,23,11,230,219,449
2018,5,23,12,215,261,476
2018,5,23,13,243,344,587
2018,5,23,14,226,324,550
2018,5,23,15,187,193,380
2018,5,23,16,178,178,356
2018,5,23,17,146,168,314
2018,5,23,18,142,181,323
2018,5,23,19,106,137,243
2018,5,23,20,94,101,195
2018,5,23,21,50,61,111
2018,5,23,22,26,60,86
2018,5,23,23,13,24,37
2018,5,24,0,8,15,23
2018,5,24,1,9,13,22
2018,5,24,2,10,9,19
2018,5,24,3,11,10,21
2018,5,24,4,105,53,158
2018,5,24,5,228,165,393
2018,5,24,6,369,235,604
2018,5,24,7,278,165,443
2018,5,24,8,240,182,422
2018,5,24,9,227,200,427
2018,5,24,10,219,205,424
2018,5,24,11,249,246,495
2018,5,24,12,194,242,436
2018,5,24,13,262,346,608
2018,5,24,14,223,297,520
2018,5,24,15,200,206,406
2018,5,24,16,174,180,354
2018,5,24,17,144,188,332
2018,5,24,18,124,129,253
2018,5,24,19,96,136,232
2018,5,24,20,79,89,168
2018,5,24,21,51,58,109
2018,5,24,22,27,31,58
2018,5,24,23,14,20,34
2018,5,25,0,7,18,25
2018,5,25,1,8,25,33
2018,5,25,2,5,8,13
2018,5,25,3,24,14,38
2018,5,25,4,113,64,177
2018,5,25,5,228,153,381
2018,5,25,6,401,223,624
2018,5,25,7,266,181,447
2018,5,25,8,228,175,403
2018,5,25,9,253,204,457
2018,5,25,10,218,253,471
2018,5,25,11,238,264,502
2018,5,25,12,239,292,531
2018,5,25,13,278,430,708
2018,5,25,14,158,309,467
2018,5,25,15,168,173,341
2018,5,25,16,142,149,291
2018,5,25,17,130,143,273
2018,5,25,18,92,118,210
2018,5,25,19,82,104,186
2018,5,25,20,72,108,180
2018,5,25,21,56,72,128
2018,5,25,22,34,59,93
2018,5,25,23,26,40,66
2018,5,26,0,17,27,44
2018,5,26,1,18,39,57
2018,5,26,2,5,21,26
2018,5,26,3,8,11,19
2018,5,26,4,24,16,40
2018,5,26,5,27,20,47
2018,5,26,6,40,52,92
2018,5,26,7,69,64,133
2018,5,26,8,125,94,219
2018,5,26,9,147,117,264
2018,5,26,10,188,128,316
2018,5,26,11,167,164,331
2018,5,26,12,140,156,296
2018,5,26,13,118,164,282
2018,5,26,14,126,170,296
2018,5,26,15,144,144,288
2018,5,26,16,135,165,300
2018,5,26,17,130,152,282
2018,5,26,18,93,116,209
2018,5,26,19,56,78,134
2018,5,26,20,59,82,141
2018,5,26,21,72,105,177
2018,5,26,22,51,74,125
2018,5,26,23,32,51,83
2018,5,27,0,23,35,58
2018,5,27,1,22,51,73
2018,5,27,2,23,31,54
2018,5,27,3,21,17,38
2018,5,27,4,30,15,45
2018,5,27,5,20,13,33
2018,5,27,6,47,27,74
2018,5,27,7,60,60,120
2018,5,27,8,87,69,156
2018,5,27,9,104,102,206
2018,5,27,10,126,144,270
2018,5,27,11,134,155,289
2018,5,27,12,148,159,307
2018,5,27,13,148,161,309
2018,5,27,14,135,173,308
2018,5,27,15,144,161,305
2018,5,27,16,176,154,330
2018,5,27,17,170,166,336
2018,5,27,18,121,153,274
2018,5,27,19,99,143,242
2018,5,27,20,87,105,192
2018,5,27,21,58,76,134
2018,5,27,22,22,31,53
2018,5,27,23,9,23,32
2018,5,28,0,6,16,22
2018,5,28,1,6,9,15
2018,5,28,2,13,10,23
2018,5,28,3,24,12,36
2018,5,28,4,108,49,157
2018,5,28,5,231,154,385
2018,5,28,6,363,218,581
2018,5,28,7,286,176,462
2018,5,28,8,221,197,418
2018,5,28,9,250,181,431
2018,5,28,10,219,230,449
2018,5,28,11,229,245,474
2018,5,28,12,244,259,503
2018,5,28,13,266,348,614
2018,5,28,14,222,303,525
2018,5,28,15,180,197,377
2018,5,28,16,174,174,348
2018,5,28,17,139,160,299
2018,5,28,18,121,173,294
2018,5,28,19,103,152,255
2018,5,28,20,76,114,190
2018,5,28,21,47,61,108
2018,5,28,22,22,41,63
2018,5,28,23,9,17,26
2018,5,29,0,11,13,24
2018,5,29,1,9,9,18
2018,5,29,2,9,6,15
2018,5,29,3,20,14,34
2018,5,29,4,113,53,166
2018,5,29,5,237,175,412
2018,5,29,6,371,208,579
2018,5,29,7,252,172,424
2018,5,29,8,239,194,433
2018,5,29,9,221,169,390
2018,5,29,10,363,221,584
2018,5,29,11,245,214,459
2018,5,29,12,237,266,503
2018,5,29,13,272,333,605
2018,5,29,14,203,277,480
2018,5,29,15,193,201,394
2018,5,29,16,145,173,318
2018,5,29,17,148,164,312
2018,5,29,18,127,135,262
2018,5,29,19,110,155,265
2018,5,29,20,82,145,227
2018,5,29,21,36,80,116
2018,5,29,22,35,47,82
2018,5,29,23,14,21,35
2018,5,30,0,12,40,52
2018,5,30,1,10,18,28
2018,5,30,2,7,10,17
2018,5,30,3,18,17,35
2018,5,30,4,106,60,166
2018,5,30,5,211,157,368
2018,5,30,6,388,212,600
2018,5,30,7,256,185,441
2018,5,30,8,238,206,444
2018,5,30,9,194,204,398
2018,5,30,10,210,208,418
2018,5,30,11,216,234,450
2018,5,30,12,251,283,534
2018,5,30,13,285,369,654
2018,5,30,14,219,309,528
2018,5,30,15,206,171,377
2018,5,30,16,192,184,376
2018,5,30,17,134,187,321
2018,5,30,18,151,147,298
2018,5,30,19,95,163,258
2018,5,30,20,89,476,565
2018,5,30,21,69,368,437
2018,5,30,22,32,180,212
2018,5,30,23,26,93,119
2018,5,31,0,9,71,80
2018,5,31,1,9,18,27
2018,5,31,2,11,14,25
2018,5,31,3,14,20,34
2018,5,31,4,123,55,178
2018,5,31,5,225,158,383
2018,5,31,6,382,215,597
2018,5,31,7,264,165,429
2018,5,31,8,209,182,391
2018,5,31,9,261,206,467
2018,5,31,10,223,230,453
2018,5,31,11,218,228,446
2018,5,31,12,232,284,516
2018,5,31,13,291,364,655
2018,5,31,14,213,287,500
2018,5,31,15,180,180,360
2018,5,31,16,181,186,367
2018,5,31,17,117,172,289
2018,5,31,18,140,190,330
2018,5,31,19,121,142,263
2018,5,31,20,103,119,222
2018,5,31,21,34,69,103
2018,5,31,22,40,52,92
2018,5,31,23,24,33,57
2018,6,1,0,7,25,32
2018,6,1,1,9,22,31
2018,6,1,2,8,18,26
2018,6,1,3,22,22,44
2018,6,1,4,116,51,167
2018,6,1,5,213,135,348
2018,6,1,6,384,186,570
2018,6,1,7,261,185,446
2018,6,1,8,219,189,408
2018,6,1,9,244,233,477
2018,6,1,10,237,232,469
2018,6,1,11,250,276,526
2018,6,1,12,278,345,623
2018,6,1,13,279,376,655
2018,6,1,14,191,254,445
2018,6,1,15,147,188,335
2018,6,1,16,205,167,372
2018,6,1,17,132,163,295
2018,6,1,18,110,133,243
2018,6,1,19,100,128,228
2018,6,1,20,81,102,183
2018,6,1,21,65,74,139
2018,6,1,22,48,53,101
2018,6,1,23,35,48,83
2018,6,2,0,21,32,53
2018,6,2,1,21,34,55
2018,6,2,2,17,17,34
2018,6,2,3,14,23,37
2018,6,2,4,40,14,54
2018,6,2,5,29,101,130
2018,6,2,6,45,41,86
2018,6,2,7,79,64,143
2018,6,2,8,92,91,183
2018,6,2,9,144,116,260
2018,6,2,10,133,121,254
2018,6,2,11,128,153,281
2018,6,2,12,141,157,298
2018,6,2,13,133,153,286
2018,6,2,14,126,154,280
2018,6,2,15,150,172,322
2018,6,2,16,152,142,294
2018,6,2,17,106,118,224
2018,6,2,18,101,109,210
2018,6,2,19,79,106,185
2018,6,2,20,66,100,166
2018,6,2,21,57,82,139
2018,6,2,22,48,63,111
2018,6,2,23,41,42,83
2018,6,3,0,29,45,74
2018,6,3,1,18,40,58
2018,6,3,2,19,44,63
2018,6,3,3,15,20,35
2018,6,3,4,13,12,25
2018,6,3,5,17,13,30
2018,6,3,6,32,24,56
2018,6,3,7,63,49,112
2018,6,3,8,81,69,150
2018,6,3,9,125,96,221
2018,6,3,10,131,162,293
2018,6,3,11,172,160,332
2018,6,3,12,150,177,327
2018,6,3,13,154,170,324
2018,6,3,14,146,169,315
2018,6,3,15,173,224,397
2018,6,3,16,148,153,301
2018,6,3,17,152,192,344
2018,6,3,18,156,168,324
2018,6,3,19,116,146,262
2018,6,3,20,49,94,143
2018,6,3,21,37,50,87
2018,6,3,22,43,43,86
2018,6,3,23,9,21,30
2018,6,4,0,17,15,32
2018,6,4,1,5,16,21
2018,6,4,2,10,10,20
2018,6,4,3,25,18,43
2018,6,4,4,122,56,178
2018,6,4,5,224,134,358
2018,6,4,6,388,198,586
2018,6,4,7,230,141,371
2018,6,4,8,234,177,411
2018,6,4,9,380,221,601
2018,6,4,10,270,199,469
2018,6,4,11,212,211,423
2018,6,4,12,215,267,482
2018,6,4,13,266,363,629
2018,6,4,14,200,300,500
2018,6,4,15,179,201,380
2018,6,4,16,161,160,321
2018,6,4,17,140,152,292
2018,6,4,18,119,126,245
2018,6,4,19,104,139,243
2018,6,4,20,69,113,182
2018,6,4,21,42,62,104
2018,6,4,22,27,29,56
2018,6,4,23,15,23,38
2018,6,5,0,8,19,27
2018,6,5,1,6,7,13
2018,6,5,2,6,10,16
2018,6,5,3,14,18,32
2018,6,5,4,104,51,155
2018,6,5,5,237,130,367
2018,6,5,6,411,180,591
2018,6,5,7,288,192,480
2018,6,5,8,234,193,427
2018,6,5,9,227,206,433
2018,6,5,10,193,196,389
2018,6,5,11,216,215,431
2018,6,5,12,194,260,454
2018,6,5,13,267,366,633
2018,6,5,14,186,302,488
2018,6,5,15,171,190,361
2018,6,5,16,159,146,305
2018,6,5,17,136,153,289
2018,6,5,18,122,136,258
2018,6,5,19,103,138,241
2018,6,5,20,85,106,191
2018,6,5,21,47,54,101
2018,6,5,22,22,24,46
2018,6,5,23,26,22,48
2018,6,6,0,12,15,27
2018,6,6,1,9,20,29
2018,6,6,2,18,10,28
2018,6,6,3,14,15,29
2018,6,6,4,103,55,158
2018,6,6,5,233,152,385
2018,6,6,6,387,194,581
2018,6,6,7,270,155,425
2018,6,6,8,231,189,420
2018,6,6,9,237,207,444
2018,6,6,10,199,207,406
2018,6,6,11,211,232,443
2018,6,6,12,205,277,482
2018,6,6,13,269,319,588
2018,6,6,14,185,269,454
2018,6,6,15,187,165,352
2018,6,6,16,148,167,315
2018,6,6,17,126,134,260
2018,6,6,18,119,122,241
2018,6,6,19,82,129,211
2018,6,6,20,89,85,174
2018,6,6,21,60,42,102
2018,6,6,22,34,30,64
2018,6,6,23,20,20,40
2018,6,7,0,17,23,40
2018,6,7,1,15,21,36
2018,6,7,2,13,9,22
2018,6,7,3,13,10,23
2018,6,7,4,127,56,183
2018,6,7,5,229,141,370
2018,6,7,6,389,190,579
2018,6,7,7,264,188,452
2018,6,7,8,217,185,402
2018,6,7,9,218,186,404
2018,6,7,10,203,209,412
2018,6,7,11,206,230,436
2018,6,7,12,220,271,491
2018,6,7,13,221,330,551
2018,6,7,14,200,236,436
2018,6,7,15,158,203,361
2018,6,7,16,180,193,373
2018,6,7,17,151,181,332
2018,6,7,18,113,155,268
2018,6,7,19,93,144,237
2018,6,7,20,87,106,193
2018,6,7,21,57,51,108
2018,6,7,22,28,96,124
2018,6,7,23,16,31,47
2018,6,8,0,16,19,35
2018,6,8,1,9,29,38
2018,6,8,2,10,17,27
2018,6,8,3,16,14,30
2018,6,8,4,110,58,168
2018,6,8,5,217,145,362
2018,6,8,6,368,216,584
2018,6,8,7,262,165,427
2018,6,8,8,238,183,421
2018,6,8,9,234,207,441
2018,6,8,10,216,226,442
2018,6,8,11,230,246,476
2018,6,8,12,223,279,502
2018,6,8,13,247,379,626
2018,6,8,14,191,259,450
2018,6,8,15,158,192,350
2018,6,8,16,198,141,339
2018,6,8,17,179,150,329
2018,6,8,18,122,114,236
2018,6,8,19,92,106,198
2018,6,8,20,73,102,175
2018,6,8,21,79,64,143
2018,6,8,22,48,66,114
2018,6,8,23,41,45,86
2018,6,9,0,24,36,60
2018,6,9,1,14,25,39
2018,6,9,2,16,22,38
2018,6,9,3,20,17,37
2018,6,9,4,32,22,54
2018,6,9,5,33,24,57
2018,6,9,6,52,36,88
2018,6,9,7,96,71,167
2018,6,9,8,111,92,203
2018,6,9,9,159,100,259
2018,6,9,10,193,128,321
2018,6,9,11,169,151,320
2018,6,9,12,192,156,348
2018,6,9,13,173,157,330
2018,6,9,14,164,150,314
2018,6,9,15,156,162,318
2018,6,9,16,136,138,274
2018,6,9,17,106,123,229
2018,6,9,18,94,111,205
2018,6,9,19,67,87,154
2018,6,9,20,66,89,155
2018,6,9,21,48,84,132
2018,6,9,22,39,76,115
2018,6,9,23,40,46,86
2018,6,10,0,24,40,64
2018,6,10,1,26,52,78
2018,6,10,2,15,38,53
2018,6,10,3,18,9,27
2018,6,10,4,15,21,36
2018,6,10,5,19,16,35
2018,6,10,6,33,18,51
2018,6,10,7,49,47,96
2018,6,10,8,84,66,150
2018,6,10,9,126,84,210
2018,6,10,10,167,150,317
2018,6,10,11,170,171,341
2018,6,10,12,176,209,385
2018,6,10,13,168,211,379
2018,6,10,14,171,280,451
2018,6,10,15,163,193,356
2018,6,10,16,148,157,305
2018,6,10,17,139,192,331
2018,6,10,18,124,138,262
2018,6,10,19,97,124,221
2018,6,10,20,133,94,227
2018,6,10,21,55,54,109
2018,6,10,22,30,29,59
2018,6,10,23,14,22,36
2018,6,11,0,13,16,29
2018,6,11,1,7,17,24
2018,6,11,2,15,12,27
2018,6,11,3,16,14,30
2018,6,11,4,120,57,177
2018,6,11,5,226,135,361
2018,6,11,6,373,211,584
2018,6,11,7,287,193,480
2018,6,11,8,215,190,405
2018,6,11,9,210,172,382
2018,6,11,10,234,240,474
2018,6,11,11,232,245,477
2018,6,11,12,200,284,484
2018,6,11,13,258,321,579
2018,6,11,14,212,300,512
2018,6,11,15,172,178,350
2018,6,11,16,163,171,334
2018,6,11,17,136,163,299
2018,6,11,18,116,129,245
2018,6,11,19,103,125,228
2018,6,11,20,72,86,158
2018,6,11,21,39,37,76
2018,6,11,22,30,30,60
2018,6,11,23,23,17,40
2018,6,12,0,12,13,25
2018,6,12,1,11,10,21
2018,6,12,2,16,15,31
2018,6,12,3,19,11,30
2018,6,12,4,115,66,181
2018,6,12,5,216,138,354
2018,6,12,6,359,206,565
2018,6,12,7,242,170,412
2018,6,12,8,227,184,411
2018,6,12,9,228,189,417
2018,6,12,10,248,232,480
2018,6,12,11,226,235,461
2018,6,12,12,211,253,464
2018,6,12,13,269,318,587
2018,6,12,14,239,284,523
2018,6,12,15,165,188,353
2018,6,12,16,176,173,349
2018,6,12,17,135,158,293
2018,6,12,18,140,151,291
2018,6,12,19,102,121,223
2018,6,12,20,70,73,143
2018,6,12,21,50,75,125
2018,6,12,22,33,44,77
2018,6,12,23,17,31,48
2018,6,13,0,12,21,33
2018,6,13,1,15,23,38
2018,6,13,2,17,16,33
2018,6,13,3,12,13,25
2018,6,13,4,117,55,172
2018,6,13,5,226,147,373
2018,6,13,6,386,206,592
2018,6,13,7,288,178,466
2018,6,13,8,223,175,398
2018,6,13,9,259,200,459
2018,6,13,10,253,234,487
2018,6,13,11,226,215,441
2018,6,13,12,228,265,493
2018,6,13,13,259,353,612
2018,6,13,14,242,278,520
2018,6,13,15,180,221,401
2018,6,13,16,151,176,327
2018,6,13,17,140,150,290
2018,6,13,18,136,161,297
2018,6,13,19,88,113,201
2018,6,13,20,81,111,192
2018,6,13,21,55,61,116
2018,6,13,22,28,51,79
2018,6,13,23,24,47,71
2018,6,14,0,15,66,81
2018,6,14,1,3,43,46
2018,6,14,2,6,28,34
2018,6,14,3,17,14,31
2018,6,14,4,116,67,183
2018,6,14,5,219,121,340
2018,6,14,6,419,229,648
2018,6,14,7,271,179,450
2018,6,14,8,231,178,409
2018,6,14,9,222,182,404
2018,6,14,10,245,232,477
2018,6,14,11,222,238,460
2018,6,14,12,216,273,489
2018,6,14,13,283,362,645
2018,6,14,14,250,342,592
2018,6,14,15,195,193,388
2018,6,14,16,172,181,353
2018,6,14,17,140,145,285
2018,6,14,18,122,135,257
2018,6,14,19,92,115,207
2018,6,14,20,82,102,184
2018,6,14,21,55,77,132
2018,6,14,22,39,36,75
2018,6,14,23,24,27,51
2018,6,15,0,13,29,42
2018,6,15,1,20,16,36
2018,6,15,2,15,17,32
2018,6,15,3,16,12,28
2018,6,15,4,112,48,160
2018,6,15,5,243,145,388
2018,6,15,6,368,213,581
2018,6,15,7,259,216,475
2018,6,15,8,235,157,392
2018,6,15,9,281,223,504
2018,6,15,10,245,231,476
2018,6,15,11,235,257,492
2018,6,15,12,273,282,555
2018,6,15,13,250,329,579
2018,6,15,14,197,279,476
2018,6,15,15,155,195,350
2018,6,15,16,132,153,285
2018,6,15,17,129,140,269
2018,6,15,18,98,96,194
2018,6,15,19,76,100,176
2018,6,15,20,87,98,185
2018,6,15,21,66,83,149
2018,6,15,22,46,60,106
2018,6,15,23,23,50,73
2018,6,16,0,26,45,71
2018,6,16,1,22,38,60
2018,6,16,2,16,23,39
2018,6,16,3,15,17,32
2018,6,16,4,19,14,33
2018,6,16,5,32,22,54
2018,6,16,6,38,45,83
2018,6,16,7,73,66,139
2018,6,16,8,116,81,197
2018,6,16,9,199,123,322
2018,6,16,10,159,149,308
2018,6,16,11,159,151,310
2018,6,16,12,24,26,50
2018,6,25,10,217,186,403
2018,6,25,11,227,200,427
2018,6,25,12,189,248,437
2018,6,25,13,238,306,544
2018,6,25,14,190,263,453
2018,6,25,15,151,188,339
2018,6,25,16,145,167,312
2018,6,25,17,126,123,249
2018,6,25,18,101,90,191
2018,6,25,19,69,93,162
2018,6,25,20,75,95,170
2018,6,25,21,44,48,92
2018,6,25,22,18,28,46
2018,6,25,23,8,29,37
2018,6,26,0,8,14,22
2018,6,26,1,11,15,26
2018,6,26,2,10,11,21
2018,6,26,3,17,16,33
2018,6,26,4,101,56,157
2018,6,26,5,214,140,354
2018,6,26,6,278,142,420
2018,6,26,7,257,187,444
2018,6,26,8,187,185,372
2018,6,26,9,209,206,415
2018,6,26,10,211,213,424
2018,6,26,11,208,205,413
2018,6,26,12,211,245,456
2018,6,26,13,263,305,568
2018,6,26,14,215,257,472
2018,6,26,15,158,170,328
2018,6,26,16,143,150,293
2018,6,26,17,119,132,251
2018,6,26,18,110,114,224
2018,6,26,19,69,79,148
2018,6,26,20,73,76,149
2018,6,26,21,39,133,172
2018,6,26,22,18,41,59
2018,6,26,23,15,22,37
2018,6,27,0,15,14,29
2018,6,27,1,9,16,25
2018,6,27,2,7,12,19
2018,6,27,3,11,10,21
2018,6,27,4,111,53,164
2018,6,27,5,197,140,337
2018,6,27,6,314,177,491
2018,6,27,7,243,176,419
2018,6,27,8,196,181,377
2018,6,27,9,224,170,394
2018,6,27,10,191,195,386
2018,6,27,11,216,213,429
2018,6,27,12,209,240,449
2018,6,27,13,239,323,562
2018,6,27,14,194,279,473
2018,6,27,15,132,165,297
2018,6,27,16,158,175,333
2018,6,27,17,114,137,251
2018,6,27,18,102,113,215
2018,6,27,19,82,94,176
2018,6,27,20,80,294,374
2018,6,27,21,40,192,232
2018,6,27,22,24,97,121
2018,6,27,23,17,58,75
2018,6,28,0,15,53,68
2018,6,28,1,8,45,53
2018,6,28,2,11,39,50
2018,6,28,3,14,38,52
2018,6,28,4,109,45,154
2018,6,28,5,205,140,345
2018,6,28,6,300,165,465
2018,6,28,7,236,184,420
2018,6,28,8,198,158,356
2018,6,28,9,214,174,388
2018,6,28,10,203,199,402
2018,6,28,11,228,206,434
2018,6,28,12,230,249,479
2018,6,28,13,249,302,551
2018,6,28,14,182,247,429
2018,6,28,15,149,220,369
2018,6,28,16,147,161,308
2018,6,28,17,137,140,277
2018,6,28,18,108,131,239
2018,6,28,19,84,97,181
2018,6,28,20,55,432,487
2018,6,28,21,41,273,314
2018,6,28,22,16,187,203
2018,6,28,23,20,96,116
2018,6,29,0,9,30,39
2018,6,29,1,8,25,33
2018,6,29,2,5,11,16
2018,6,29,3,14,15,29
2018,6,29,4,108,45,153
2018,6,29,5,195,128,323
2018,6,29,6,286,146,432
2018,6,29,7,240,162,402
2018,6,29,8,214,188,402
2018,6,29,9,227,222,449
2018,6,29,10,248,207,455
2018,6,29,11,221,224,445
2018,6,29,12,224,307,531
2018,6,29,13,243,304,547
2018,6,29,14,151,218,369
2018,6,29,15,138,158,296
2018,6,29,16,140,141,281
2018,6,29,17,109,131,240
2018,6,29,18,116,101,217
2018,6,29,19,84,107,191
2018,6,29,20,64,74,138
2018,6,29,21,39,65,104
2018,6,29,22,33,56,89
2018,6,29,23,22,36,58
2018,6,30,0,11,29,40
2018,6,30,1,20,26,46
2018,6,30,2,13,22,35
2018,6,30,3,16,12,28
2018,6,30,4,25,9,34
2018,6,30,5,21,30,51
2018,6,30,6,38,28,66
2018,6,30,7,59,57,116
2018,6,30,8,101,88,189
2018,6,30,9,123,111,234
2018,6,30,10,124,118,242
2018,6,30,11,140,158,298
2018,6,30,12,131,152,283
2018,6,30,13,113,141,254
2018,6,30,14,107,141,248
2018,6,30,15,91,109,200
2018,6,30,16,118,132,250
2018,6,30,17,92,122,214
2018,6,30,18,76,91,167
2018,6,30,19,70,79,149
2018,6,30,20,61,96,157
2018,6,30,21,55,86,141
2018,6,30,22,37,45,82
2018,6,30,23,23,39,62
2018,7,1,0,23,45,68
2018,7,1,1,13,30,43
2018,7,1,2,16,32,48
2018,7,1,3,13,13,26
2018,7,1,4,17,9,26
2018,7,1,5,21,19,40
2018,7,1,6,27,23,50
2018,7,1,7,41,43,84
2018,7,1,8,73,64,137
2018,7,1,9,96,77,173
2018,7,1,10,107,125,232
2018,7,1,11,129,122,251
2018,7,1,12,151,162,313
2018,7,1,13,137,187,324
2018,7,1,14,119,181,300
2018,7,1,15,115,159,274
2018,7,1,16,115,139,254
2018,7,1,17,136,159,295
2018,7,1,18,163,134,297
2018,7,1,19,92,96,188
2018,7,1,20,54,56,110
2018,7,1,21,56,69,125
2018,7,1,22,28,29,57
2018,7,1,23,14,23,37
2018,7,2,0,13,17,30
2018,7,2,1,8,19,27
2018,7,2,2,7,13,20
2018,7,2,3,18,12,30
2018,7,2,4,102,36,138
2018,7,2,5,181,127,308
2018,7,2,6,248,158,406
2018,7,2,7,237,154,391
2018,7,2,8,228,155,383
2018,7,2,9,207,174,381
2018,7,2,10,185,203,388
2018,7,2,11,185,218,403
2018,7,2,12,185,239,424
2018,7,2,13,211,272,483
2018,7,2,14,187,231,418
2018,7,2,15,122,161,283
2018,7,2,16,127,123,250
2018,7,2,17,128,147,275
2018,7,2,18,106,119,225
2018,7,2,19,85,90,175
2018,7,2,20,83,266,349
2018,7,2,21,40,187,227
2018,7,2,22,25,72,97
2018,7,2,23,19,52,71
2018,7,3,0,8,16,24
2018,7,3,1,10,9,19
2018,7,3,2,2,6,8
2018,7,3,3,13,11,24
2018,7,3,4,99,43,142
2018,7,3,5,194,122,316
2018,7,3,6,259,147,406
2018,7,3,7,121,101,222
2018,7,3,9,202,165,367
2018,7,3,10,192,191,383
2018,7,3,11,198,188,386
2018,7,3,12,226,257,483
2018,7,3,13,230,272,502
2018,7,3,14,177,216,393
2018,7,3,15,137,168,305
2018,7,3,16,122,116,238
2018,7,3,17,114,118,232
2018,7,3,18,96,102,198
2018,7,3,19,78,78,156
2018,7,3,20,54,68,122
2018,7,3,21,37,77,114
2018,7,3,22,23,24,47
2018,7,3,23,23,62,85
2018,7,4,0,13,50,63
2018,7,4,1,15,29,44
2018,7,4,2,12,28,40
2018,7,4,3,19,13,32
2018,7,4,4,97,39,136
2018,7,4,5,168,114,282
2018,7,4,6,256,144,400
2018,7,4,7,217,136,353
2018,7,4,8,137,120,257
2018,7,4,10,191,190,381
2018,7,4,11,179,176,355
2018,7,4,12,202,228,430
2018,7,4,13,193,247,440
2018,7,4,14,152,225,377
2018,7,4,15,148,145,293
2018,7,4,16,122,140,262
2018,7,4,17,106,108,214
2018,7,4,18,113,107,220
2018,7,4,19,69,82,151
2018,7,4,20,64,248,312
2018,7,4,21,33,164,197
2018,7,4,22,34,82,116
2018,7,4,23,14,61,75
2018,7,5,0,13,15,28
2018,7,5,1,8,10,18
2018,7,5,2,12,11,23
2018,7,5,3,14,13,27
2018,7,5,4,95,38,133
2018,7,5,5,172,110,282
2018,7,5,6,233,141,374
2018,7,5,7,220,146,366
2018,7,5,8,187,147,334
2018,7,5,9,180,162,342
2018,7,5,10,200,163,363
2018,7,5,11,186,222,408
2018,7,5,12,213,226,439
2018,7,5,13,184,277,461
2018,7,5,14,164,202,366
2018,7,5,15,148,154,302
2018,7,5,16,133,134,267
2018,7,5,17,115,108,223
2018,7,5,18,104,94,198
2018,7,5,19,68,91,159
2018,7,5,20,49,77,126
2018,7,5,21,45,42,87
2018,7,5,22,23,34,57
2018,7,5,23,12,15,27
2018,7,6,0,10,26,36
2018,7,6,1,7,19,26
2018,7,6,2,7,8,15
2018,7,6,3,15,5,20
2018,7,6,4,91,38,129
2018,7,6,5,149,94,243
2018,7,6,6,200,139,339
2018,7,6,7,222,137,359
2018,7,6,8,171,135,306
2018,7,6,9,189,166,355
2018,7,6,10,188,172,360
2018,7,6,11,175,209,384
2018,7,6,12,194,214,408
2018,7,6,13,183,265,448
2018,7,6,14,131,177,308
2018,7,6,15,92,133,225
2018,7,6,16,121,109,230
2018,7,6,17,89,107,196
2018,7,6,18,64,74,138
2018,7,6,19,55,51,106
2018,7,6,20,57,73,130
2018,7,6,21,41,39,80
2018,7,6,22,22,42,64
2018,7,6,23,22,30,52
2018,7,7,0,22,27,49
2018,7,7,1,14,31,45
2018,7,7,2,8,8,16
2018,7,7,3,10,7,17
2018,7,7,4,17,15,32
2018,7,7,5,26,21,47
2018,7,7,6,27,34,61
2018,7,7,7,52,38,90
2018,7,7,8,74,52,126
2018,7,7,9,84,75,159
2018,7,7,10,100,100,200
2018,7,7,11,108,122,230
2018,7,7,12,104,103,207
2018,7,7,13,101,128,229
2018,7,7,14,86,98,184
2018,7,7,15,69,75,144
2018,7,7,16,74,94,168
2018,7,7,17,72,75,147
2018,7,7,18,62,81,143
2018,7,7,19,57,64,121
2018,7,7,20,41,50,91
2018,7,7,21,49,69,118
2018,7,7,22,32,48,80
2018,7,7,23,19,42,61
2018,7,8,0,27,32,59
2018,7,8,1,16,45,61
2018,7,8,2,15,22,37
2018,7,8,3,11,11,22
2018,7,8,4,13,12,25
2018,7,8,5,8,19,27
2018,7,8,6,29,21,50
2018,7,8,7,27,37,64
2018,7,8,8,66,37,103
2018,7,8,9,80,67,147
2018,7,8,10,79,95,174
2018,7,8,11,95,91,186
2018,7,8,12,117,148,265
2018,7,8,13,109,134,243
2018,7,8,14,88,146,234
2018,7,8,15,123,133,256
2018,7,8,16,113,121,234
2018,7,8,17,97,115,212
2018,7,8,18,77,116,193
2018,7,8,19,63,71,134
2018,7,8,20,51,52,103
2018,7,8,21,23,26,49
2018,7,8,22,20,29,49
2018,7,8,23,9,12,21
2018,7,9,0,4,10,14
2018,7,9,1,4,8,12
2018,7,9,2,7,9,16
2018,7,9,3,11,16,27
2018,7,9,4,65,33,98
2018,7,9,5,110,95,205
2018,7,9,6,154,83,237
2018,7,9,7,161,103,264
2018,7,9,8,162,123,285
2018,7,9,9,154,132,286
2018,7,9,10,146,170,316
2018,7,9,11,150,157,307
2018,7,9,12,157,192,349
2018,7,9,13,129,192,321
2018,7,9,14,119,161,280
2018,7,9,15,115,144,259
2018,7,9,16,113,109,222
2018,7,9,17,88,104,192
2018,7,9,18,95,90,185
2018,7,9,19,84,84,168
2018,7,9,20,44,85,129
2018,7,9,21,32,54,86
2018,7,9,22,27,21,48
2018,7,9,23,11,21,32
2018,7,10,0,10,15,25
2018,7,10,1,5,6,11
2018,7,10,2,8,9,17
2018,7,10,3,13,18,31
2018,7,10,4,66,30,96
2018,7,10,5,122,98,220
2018,7,10,6,142,95,237
2018,7,10,7,159,110,269
2018,7,10,8,150,138,288
2018,7,10,9,143,132,275
2018,7,10,10,155,128,283
2018,7,10,11,164,182,346
2018,7,10,12,161,197,358
2018,7,10,13,144,209,353
2018,7,10,14,124,161,285
2018,7,10,15,105,150,255
2018,7,10,16,91,92,183
2018,7,10,17,101,110,211
2018,7,10,18,63,74,137
2018,7,10,19,42,64,106
2018,7,10,20,68,331,399
2018,7,10,21,28,147,175
2018,7,10,22,18,27,45
2018,7,10,23,17,21,38
2018,7,11,0,10,20,30
2018,7,11,1,17,15,32
2018,7,11,2,13,15,28
2018,7,11,3,11,19,30
2018,7,11,4,75,25,100
2018,7,11,5,95,78,173
2018,7,11,6,150,94,244
2018,7,11,7,135,102,237
2018,7,11,8,130,126,256
2018,7,11,9,141,127,268
2018,7,11,10,131,142,273
2018,7,11,11,150,150,300
2018,7,11,12,151,158,309
2018,7,11,13,133,183,316
2018,7,11,14,118,173,291
2018,7,11,15,97,129,226
2018,7,11,16,143,126,269
2018,7,11,17,94,115,209
2018,7,11,18,64,66,130
2018,7,11,19,46,56,102
2018,7,11,20,46,81,127
2018,7,11,21,45,75,120
2018,7,11,22,20,32,52
2018,7,11,23,16,13,29
2018,7,12,0,7,21,28
2018,7,12,1,11,18,29
2018,7,12,2,8,16,24
2018,7,12,3,10,13,23
2018,7,12,4,60,30,90
2018,7,12,5,102,81,183
2018,7,12,6,148,89,237
2018,7,12,7,120,97,217
2018,7,12,8,132,110,242
2018,7,12,9,134,110,244
2018,7,12,10,158,173,331
2018,7,12,11,148,159,307
2018,7,12,12,158,169,327
2018,7,12,13,133,194,327
2018,7,12,14,125,173,298
2018,7,12,15,108,117,225
2018,7,12,16,109,121,230
2018,7,12,17,103,94,197
2018,7,12,18,84,82,166
2018,7,12,19,68,114,182
2018,7,12,20,48,69,117
2018,7,12,21,30,39,69
2018,7,12,22,33,26,59
2018,7,12,23,12,16,28
2018,7,13,0,7,20,27
2018,7,13,1,10,24,34
2018,7,13,2,9,15,24
2018,7,13,3,9,6,15
2018,7,13,4,57,33,90
2018,7,13,5,101,80,181
2018,7,13,6,132,93,225
2018,7,13,7,144,96,240
2018,7,13,8,158,123,281
2018,7,13,9,178,129,307
2018,7,13,10,164,158,322
2018,7,13,11,146,160,306
2018,7,13,12,168,206,374
2018,7,13,13,173,185,358
2018,7,13,14,103,144,247
2018,7,13,15,104,130,234
2018,7,13,16,108,106,214
2018,7,13,17,82,89,171
2018,7,13,18,64,75,139
2018,7,13,19,68,67,135
2018,7,13,20,47,55,102
2018,7,13,21,43,39,82
2018,7,13,22,23,31,54
2018,7,13,23,17,33,50
2018,7,14,0,14,15,29
2018,7,14,1,14,32,46
2018,7,14,2,10,11,21
2018,7,14,3,7,10,17
2018,7,14,4,16,13,29
2018,7,14,5,24,22,46
2018,7,14,6,22,28,50
2018,7,14,7,42,44,86
2018,7,14,8,65,54,119
2018,7,14,9,71,68,139
2018,7,14,10,115,83,198
2018,7,14,11,114,104,218
2018,7,14,12,86,107,193
2018,7,14,13,100,110,210
2018,7,14,14,74,102,176
2018,7,14,15,76,97,173
2018,7,14,16,75,86,161
2018,7,14,17,84,84,168
2018,7,14,18,63,63,126
2018,7,14,19,57,67,124
2018,7,14,20,34,54,88
2018,7,14,21,37,43,80
2018,7,14,22,35,33,68
2018,7,14,23,19,33,52
2018,7,15,0,16,26,42
2018,7,15,1,16,24,40
2018,7,15,2,16,30,46
2018,7,15,3,11,15,26
2018,7,15,4,13,7,20
2018,7,15,5,10,13,23
2018,7,15,6,23,23,46
2018,7,15,7,33,35,68
2018,7,15,8,54,41,95
2018,7,15,9,76,58,134
2018,7,15,10,88,103,191
2018,7,15,11,89,93,182
2018,7,15,12,109,127,236
2018,7,15,13,113,124,237
2018,7,15,14,112,128,240
2018,7,15,15,61,84,145
2018,7,15,16,51,59,110
2018,7,15,17,107,101,208
2018,7,15,18,82,119,201
2018,7,15,19,64,94,158
2018,7,15,20,79,62,141
2018,7,15,21,61,43,104
2018,7,15,22,31,32,63
2018,7,15,23,13,14,27
2018,7,16,0,10,8,18
2018,7,16,1,17,22,39
2018,7,16,2,10,12,22
2018,7,16,3,13,9,22
2018,7,16,4,62,34,96
2018,7,16,5,98,78,176
2018,7,16,6,122,78,200
2018,7,16,7,127,106,233
2018,7,16,8,147,110,257
2018,7,16,9,130,130,260
2018,7,16,10,148,172,320
2018,7,16,11,154,139,293
2018,7,16,12,149,126,275
2018,7,16,13,153,198,351
2018,7,16,14,111,147,258
2018,7,16,15,104,110,214
2018,7,16,16,96,108,204
2018,7,16,17,90,111,201
2018,7,16,18,86,90,176
2018,7,16,19,92,106,198
2018,7,16,20,72,71,143
2018,7,16,21,42,44,86
2018,7,16,22,27,20,47
2018,7,16,23,10,17,27
2018,7,17,0,8,15,23
2018,7,17,1,14,14,28
2018,7,17,2,11,15,26
2018,7,17,3,9,8,17
2018,7,17,4,70,33,103
2018,7,17,5,109,81,190
2018,7,17,6,124,85,209
2018,7,17,7,103,98,201
2018,7,17,8,162,104,266
2018,7,17,9,143,111,254
2018,7,17,10,158,132,290
2018,7,17,11,151,140,291
2018,7,17,12,178,174,352
2018,7,17,13,131,183,314
2018,7,17,14,134,159,293
2018,7,17,15,121,123,244
2018,7,17,16,99,102,201
2018,7,17,17,87,85,172
2018,7,17,18,75,100,175
2018,7,17,19,51,79,130
2018,7,17,20,37,81,118
2018,7,17,21,41,51,92
2018,7,17,22,26,35,61
2018,7,17,23,22,20,42
2018,7,18,0,17,19,36
2018,7,18,1,15,28,43
2018,7,18,2,7,14,21
2018,7,18,3,10,13,23
2018,7,18,4,60,27,87
2018,7,18,5,93,65,158
2018,7,18,6,113,63,176
2018,7,18,7,121,88,209
2018,7,18,8,151,124,275
2018,7,18,9,161,128,289
2018,7,18,10,170,167,337
2018,7,18,11,151,167,318
2018,7,18,12,152,187,339
2018,7,18,13,150,186,336
2018,7,18,14,124,153,277
2018,7,18,15,108,146,254
2018,7,18,16,105,121,226
2018,7,18,17,63,94,157
2018,7,18,18,80,98,178
2018,7,18,19,80,92,172
2018,7,18,20,58,59,117
2018,7,18,21,36,44,80
2018,7,18,22,16,24,40
2018,7,18,23,10,16,26
2018,7,19,0,6,24,30
2018,7,19,1,12,19,31
2018,7,19,2,12,15,27
2018,7,19,3,12,6,18
2018,7,19,4,61,32,93
2018,7,19,5,97,75,172
2018,7,19,6,108,94,202
2018,7,19,7,115,88,203
2018,7,19,8,119,119,238
2018,7,19,9,147,128,275
2018,7,19,10,137,116,253
2018,7,19,11,146,146,292
2018,7,19,12,151,162,313
2018,7,19,13,143,158,301
2018,7,19,14,112,145,257
2018,7,19,15,111,134,245
2018,7,19,16,97,115,212
2018,7,19,17,95,110,205
2018,7,19,18,76,89,165
2018,7,19,19,62,80,142
2018,7,19,20,53,82,135
2018,7,19,21,35,63,98
2018,7,19,22,26,34,60
2018,7,19,23,11,23,34
2018,7,20,0,10,21,31
2018,7,20,1,7,28,35
2018,7,20,2,11,17,28
2018,7,20,3,11,7,18
2018,7,20,4,57,27,84
2018,7,20,5,86,73,159
2018,7,20,6,111,88,199
2018,7,20,7,125,88,213
2018,7,20,8,125,102,227
2018,7,20,9,162,105,267
2018,7,20,10,146,141,287
2018,7,20,11,154,167,321
2018,7,20,12,145,165,310
2018,7,20,13,152,160,312
2018,7,20,14,116,156,272
2018,7,20,15,99,124,223
2018,7,20,16,112,106,218
2018,7,20,17,83,100,183
2018,7,20,18,75,100,175
2018,7,20,19,62,78,140
2018,7,20,20,58,69,127
2018,7,20,21,41,50,91
2018,7,20,22,25,37,62
2018,7,20,23,19,27,46
2018,7,21,0,11,21,32
2018,7,21,1,10,27,37
2018,7,21,2,6,9,15
2018,7,21,3,9,8,17
2018,7,21,4,16,10,26
2018,7,21,5,14,14,28
2018,7,21,6,27,27,54
2018,7,21,7,36,35,71
2018,7,21,8,69,48,117
2018,7,21,9,80,75,155
2018,7,21,10,94,94,188
2018,7,21,11,95,98,193
2018,7,21,12,107,108,215
2018,7,21,13,107,116,223
2018,7,21,14,88,141,229
2018,7,21,15,109,140,249
2018,7,21,16,97,102,199
2018,7,21,17,80,88,168
2018,7,21,18,68,69,137
2018,7,21,19,54,70,124
2018,7,21,20,46,47,93
2018,7,21,21,30,47,77
2018,7,21,22,28,42,70
2018,7,21,23,13,28,41
2018,7,22,0,20,30,50
2018,7,22,1,14,40,54
2018,7,22,2,7,26,33
2018,7,22,3,7,20,27
2018,7,22,4,13,9,22
2018,7,22,5,9,19,28
2018,7,22,6,14,20,34
2018,7,22,7,27,33,60
2018,7,22,8,52,47,99
2018,7,22,9,93,72,165
2018,7,22,10,90,90,180
2018,7,22,11,94,103,197
2018,7,22,12,104,122,226
2018,7,22,13,91,116,207
2018,7,22,14,101,138,239
2018,7,22,15,100,118,218
2018,7,22,16,126,132,258
2018,7,22,17,82,116,198
2018,7,22,18,89,96,185
2018,7,22,19,76,88,164
2018,7,22,20,44,51,95
2018,7,22,21,36,46,82
2018,7,22,22,26,21,47
2018,7,22,23,8,19,27
2018,7,23,0,7,10,17
2018,7,23,1,11,18,29
2018,7,23,2,4,11,15
2018,7,23,3,19,13,32
2018,7,23,4,63,27,90
2018,7,23,5,113,80,193
2018,7,23,6,125,104,229
2018,7,23,7,131,101,232
2018,7,23,8,145,111,256
2018,7,23,9,150,97,247
2018,7,23,10,130,139,269
2018,7,23,11,146,152,298
2018,7,23,12,148,174,322
2018,7,23,13,126,205,331
2018,7,23,14,119,164,283
2018,7,23,15,126,131,257
2018,7,23,16,118,102,220
2018,7,23,17,94,108,202
2018,7,23,18,92,106,198
2018,7,23,19,60,80,140
2018,7,23,20,64,62,126
2018,7,23,21,32,37,69
2018,7,23,22,22,22,44
2018,7,23,23,12,15,27
2018,7,24,0,9,10,19
2018,7,24,1,21,8,29
2018,7,24,2,9,6,15
2018,7,24,3,15,11,26
2018,7,24,4,64,29,93
2018,7,24,5,100,74,174
2018,7,24,6,108,101,209
2018,7,24,7,118,106,224
2018,7,24,8,148,111,259
2018,7,24,9,138,113,251
2018,7,24,10,164,142,306
2018,7,24,11,213,166,379
2018,7,24,12,176,166,342
2018,7,24,13,229,216,445
2018,7,24,14,317,289,606
2018,7,24,15,122,158,280
2018,7,24,16,118,99,217
2018,7,24,17,107,105,212
2018,7,24,18,77,88,165
2018,7,24,19,77,82,159
2018,7,24,20,51,66,117
2018,7,24,21,28,43,71
2018,7,24,22,21,23,44
2018,7,24,23,18,18,36
2018,7,25,0,11,14,25
2018,7,25,1,17,14,31
2018,7,25,2,14,19,33
2018,7,25,3,18,14,32
2018,7,25,4,59,23,82
2018,7,25,5,104,69,173
2018,7,25,6,102,96,198
2018,7,25,7,129,100,229
2018,7,25,8,141,102,243
2018,7,25,9,145,127,272
2018,7,25,10,142,154,296
2018,7,25,11,150,151,301
2018,7,25,12,133,170,303
2018,7,25,13,163,180,343
2018,7,25,14,118,152,270
2018,7,25,15,117,129,246
2018,7,25,16,113,121,234
2018,7,25,17,94,126,220
2018,7,25,18,76,105,181
2018,7,25,19,78,86,164
2018,7,25,20,73,83,156
2018,7,25,21,34,40,74
2018,7,25,22,29,39,68
2018,7,25,23,16,14,30
2018,7,26,0,20,17,37
2018,7,26,1,12,16,28
2018,7,26,2,9,12,21
2018,7,26,3,18,8,26
2018,7,26,4,67,33,100
2018,7,26,5,92,83,175
2018,7,26,6,103,91,194
2018,7,26,7,141,105,246
2018,7,26,8,108,105,213
2018,7,26,9,173,132,305
2018,7,26,10,146,157,303
2018,7,26,11,158,127,285
2018,7,26,12,130,176,306
2018,7,26,13,163,166,329
2018,7,26,14,110,163,273
2018,7,26,15,118,135,253
2018,7,26,16,107,133,240
2018,7,26,17,90,96,186
2018,7,26,18,92,110,202
2018,7,26,19,64,88,152
2018,7,26,20,71,61,132
2018,7,26,21,55,55,110
2018,7,26,22,22,25,47
2018,7,26,23,15,14,29
2018,7,27,0,6,19,25
2018,7,27,1,10,20,30
2018,7,27,2,8,11,19
2018,7,27,3,8,11,19
2018,7,27,4,67,27,94
2018,7,27,5,102,74,176
2018,7,27,6,111,106,217
2018,7,27,7,126,99,225
2018,7,27,8,125,121,246
2018,7,27,9,149,122,271
2018,7,27,10,150,150,300
2018,7,27,11,141,147,288
2018,7,27,12,140,181,321
2018,7,27,13,149,175,324
2018,7,27,14,112,102,214
2018,7,27,15,97,113,210
2018,7,27,16,105,109,214
2018,7,27,17,75,99,174
2018,7,27,18,64,91,155
2018,7,27,19,55,80,135
2018,7,27,20,56,64,120
2018,7,27,21,49,59,108
2018,7,27,22,30,45,75
2018,7,27,23,18,33,51
2018,7,28,0,17,25,42
2018,7,28,1,11,25,36
2018,7,28,2,12,15,27
2018,7,28,3,11,11,22
2018,7,28,4,15,9,24
2018,7,28,5,17,16,33
2018,7,28,6,23,18,41
2018,7,28,7,45,47,92
2018,7,28,8,71,54,125
2018,7,28,9,75,86,161
2018,7,28,10,94,96,190
2018,7,28,11,89,99,188
2018,7,28,12,107,117,224
2018,7,28,13,97,135,232
2018,7,28,14,111,117,228
2018,7,28,15,84,103,187
2018,7,28,16,105,111,216
2018,7,28,17,76,95,171
2018,7,28,18,74,110,184
2018,7,28,19,65,87,152
2018,7,28,20,49,58,107
2018,7,28,21,38,55,93
2018,7,28,22,41,64,105
2018,7,28,23,21,33,54
2018,7,29,0,14,31,45
2018,7,29,1,14,35,49
2018,7,29,2,13,24,37
2018,7,29,3,14,14,28
2018,7,29,4,16,15,31
2018,7,29,5,7,18,25
2018,7,29,6,25,19,44
2018,7,29,7,36,44,80
2018,7,29,8,65,43,108
2018,7,29,9,83,68,151
2018,7,29,10,108,107,215
2018,7,29,11,101,130,231
2018,7,29,12,131,145,276
2018,7,29,13,112,140,252
2018,7,29,14,106,161,267
2018,7,29,15,140,123,263
2018,7,29,16,122,157,279
2018,7,29,17,110,137,247
2018,7,29,18,106,132,238
2018,7,29,19,79,82,161
2018,7,29,20,55,63,118
2018,7,29,21,37,53,90
2018,7,29,22,16,31,47
2018,7,29,23,13,15,28
2018,7,30,0,4,15,19
2018,7,30,1,3,10,13
2018,7,30,2,7,7,14
2018,7,30,3,20,7,27
2018,7,30,4,81,39,120
2018,7,30,5,141,97,238
2018,7,30,6,176,119,295
2018,7,30,7,165,109,274
2018,7,30,8,167,140,307
2018,7,30,9,175,119,294
2018,7,30,10,168,161,329
2018,7,30,11,202,201,403
2018,7,30,12,167,217,384
2018,7,30,13,190,252,442
2018,7,30,14,174,215,389
2018,7,30,15,134,162,296
2018,7,30,16,153,147,300
2018,7,30,17,121,126,247
2018,7,30,18,92,117,209
2018,7,30,19,91,99,190
2018,7,30,20,70,87,157
2018,7,30,21,32,59,91
2018,7,30,22,17,24,41
2018,7,30,23,10,15,25
2018,7,31,0,6,13,19
2018,7,31,1,5,11,16
2018,7,31,2,16,10,26
2018,7,31,3,14,7,21
2018,7,31,4,69,39,108
2018,7,31,5,152,89,241
2018,7,31,6,196,121,317
2018,7,31,7,186,137,323
2018,7,31,8,177,141,318
2018,7,31,9,200,135,335
2018,7,31,10,180,164,344
2018,7,31,11,190,186,376
2018,7,31,12,186,187,373
2018,7,31,13,211,276,487
2018,7,31,14,159,226,385
2018,7,31,15,149,179,328
2018,7,31,16,154,144,298
2018,7,31,17,127,133,260
2018,7,31,18,99,119,218
2018,7,31,19,72,99,171
2018,7,31,20,47,87,134
2018,7,31,21,33,42,75
2018,7,31,22,19,21,40
2018,7,31,23,9,17,26
2018,8,1,0,7,12,19
2018,8,1,1,4,15,19
2018,8,1,2,8,8,16
2018,8,1,3,17,11,28
2018,8,1,4,79,38,117
2018,8,1,5,131,99,230
2018,8,1,6,204,116,320
2018,8,1,7,175,118,293
2018,8,1,8,154,143,297
2018,8,1,9,202,140,342
2018,8,1,10,194,194,388
2018,8,1,11,170,159,329
2018,8,1,12,160,213,373
2018,8,1,13,211,278,489
2018,8,1,14,168,237,405
2018,8,1,15,156,170,326
2018,8,1,16,131,147,278
2018,8,1,17,107,111,218
2018,8,1,18,83,104,187
2018,8,1,19,76,98,174
2018,8,1,20,45,94,139
2018,8,1,21,28,59,87
2018,8,1,22,15,27,42
2018,8,1,23,12,18,30
2018,8,2,0,10,12,22
2018,8,2,1,6,14,20
2018,8,2,2,8,17,25
2018,8,2,3,16,12,28
2018,8,2,4,97,28,125
2018,8,2,5,136,104,240
2018,8,2,6,181,123,304
2018,8,2,7,162,115,277
2018,8,2,8,137,118,255
2018,8,2,9,169,153,322
2018,8,2,10,175,156,331
2018,8,2,11,171,179,350
2018,8,2,12,180,205,385
2018,8,2,13,208,267,475
2018,8,2,14,169,219,388
2018,8,2,15,133,160,293
2018,8,2,16,120,134,254
2018,8,2,17,131,129,260
2018,8,2,18,87,110,197
2018,8,2,19,73,90,163
2018,8,2,20,49,66,115
2018,8,2,21,33,48,81
2018,8,2,22,24,25,49
2018,8,2,23,11,25,36
2018,8,3,0,12,24,36
2018,8,3,1,11,14,25
2018,8,3,2,9,9,18
2018,8,3,3,10,21,31
2018,8,3,4,88,30,118
2018,8,3,5,132,108,240
2018,8,3,6,193,107,300
2018,8,3,7,176,89,265
2018,8,3,8,158,126,284
2018,8,3,9,186,139,325
2018,8,3,10,188,183,371
2018,8,3,11,175,177,352
2018,8,3,12,189,220,409
2018,8,3,13,204,243,447
2018,8,3,14,150,222,372
2018,8,3,15,120,154,274
2018,8,3,16,125,128,253
2018,8,3,17,111,97,208
2018,8,3,18,79,80,159
2018,8,3,19,63,85,148
2018,8,3,20,45,72,117
2018,8,3,21,24,42,66
2018,8,3,22,39,41,80
2018,8,3,23,18,26,44
2018,8,4,0,11,27,38
2018,8,4,1,13,30,43
2018,8,4,2,7,22,29
2018,8,4,3,12,7,19
2018,8,4,4,27,13,40
2018,8,4,5,12,18,30
2018,8,4,6,36,31,67
2018,8,4,7,45,52,97
2018,8,4,8,75,69,144
2018,8,4,9,113,79,192
2018,8,4,10,137,93,230
2018,8,4,11,121,117,238
2018,8,4,12,133,138,271
2018,8,4,13,136,132,268
2018,8,4,14,101,159,260
2018,8,4,15,116,140,256
2018,8,4,16,94,135,229
2018,8,4,17,97,100,197
2018,8,4,18,67,90,157
2018,8,4,19,63,70,133
2018,8,4,20,57,60,117
2018,8,4,21,35,62,97
2018,8,4,22,30,66,96
2018,8,4,23,18,40,58
2018,8,5,0,29,39,68
2018,8,5,1,30,48,78
2018,8,5,2,11,31,42
2018,8,5,3,9,13,22
2018,8,5,4,12,7,19
2018,8,5,5,15,8,23
2018,8,5,6,26,12,38
2018,8,5,7,28,35,63
2018,8,5,8,69,55,124
2018,8,5,9,87,76,163
2018,8,5,10,128,124,252
2018,8,5,11,118,124,242
2018,8,5,12,128,162,290
2018,8,5,13,119,178,297
2018,8,5,14,138,185,323
2018,8,5,15,142,138,280
2018,8,5,16,124,131,255
2018,8,5,17,145,166,311
2018,8,5,18,109,137,246
2018,8,5,19,71,101,172
2018,8,5,20,56,64,120
2018,8,5,21,31,39,70
2018,8,5,22,30,28,58
2018,8,5,23,12,12,24
2018,8,6,0,6,15,21
2018,8,6,1,12,20,32
2018,8,6,2,11,6,17
2018,8,6,3,19,14,33
2018,8,6,4,92,48,140
2018,8,6,5,171,95,266
2018,8,6,6,298,157,455
2018,8,6,7,231,146,377
2018,8,6,8,200,170,370
2018,8,6,9,204,183,387
2018,8,6,10,196,194,390
2018,8,6,11,185,193,378
2018,8,6,12,191,258,449
2018,8,6,13,216,311,527
2018,8,6,14,173,298,471
2018,8,6,15,129,157,286
2018,8,6,16,132,184,316
2018,8,6,17,103,101,204
2018,8,6,18,98,100,198
2018,8,6,19,139,85,224
2018,8,6,20,60,68,128
2018,8,6,21,46,36,82
2018,8,6,22,19,32,51
2018,8,6,23,16,16,32
2018,8,7,0,15,9,24
2018,8,7,1,6,14,20
2018,8,7,2,4,11,15
2018,8,7,3,17,11,28
2018,8,7,4,113,51,164
2018,8,7,5,190,118,308
2018,8,7,6,263,157,420
2018,8,7,7,241,158,399
2018,8,7,8,189,131,320
2018,8,7,9,200,179,379
2018,8,7,10,200,194,394
2018,8,7,11,226,196,422
2018,8,7,12,191,275,466
2018,8,7,13,224,310,534
2018,8,7,14,181,268,449
2018,8,7,15,151,188,339
2018,8,7,16,152,146,298
2018,8,7,17,109,127,236
2018,8,7,18,106,142,248
2018,8,7,19,67,105,172
2018,8,7,20,51,78,129
2018,8,7,21,37,39,76
2018,8,7,22,26,45,71
2018,8,7,23,9,17,26
2018,8,8,0,7,13,20
2018,8,8,1,6,33,39
2018,8,8,2,7,47,54
2018,8,8,3,12,36,48
2018,8,8,4,103,46,149
2018,8,8,5,183,107,290
2018,8,8,6,285,126,411
2018,8,8,7,227,186,413
2018,8,8,8,206,167,373
2018,8,8,9,188,154,342
2018,8,8,10,224,199,423
2018,8,8,11,199,211,410
2018,8,8,12,222,262,484
2018,8,8,13,229,322,551
2018,8,8,14,210,290,500
2018,8,8,15,182,214,396
2018,8,8,16,147,138,285
2018,8,8,17,102,155,257
2018,8,8,18,110,125,235
2018,8,8,19,76,107,183
2018,8,8,20,62,261,323
2018,8,8,21,30,156,186
2018,8,8,22,20,99,119
2018,8,8,23,14,37,51
2018,8,9,0,7,30,37
2018,8,9,1,14,30,44
2018,8,9,2,11,29,40
2018,8,9,3,12,24,36
2018,8,9,4,111,42,153
2018,8,9,5,200,104,304
2018,8,9,6,272,141,413
2018,8,9,7,227,165,392
2018,8,9,8,210,181,391
2018,8,9,9,249,163,412
2018,8,9,10,244,197,441
2018,8,9,11,218,224,442
2018,8,9,12,224,278,502
2018,8,9,13,248,329,577
2018,8,9,14,193,269,462
2018,8,9,15,161,209,370
2018,8,9,16,153,155,308
2018,8,9,17,118,133,251
2018,8,9,18,100,114,214
2018,8,9,19,80,105,185
2018,8,9,20,76,86,162
2018,8,9,21,41,62,103
2018,8,9,22,30,33,63
2018,8,9,23,14,21,35
2018,8,10,0,16,22,38
2018,8,10,1,5,20,25
2018,8,10,2,10,19,29
2018,8,10,3,18,14,32
2018,8,10,4,107,45,152
2018,8,10,5,179,111,290
2018,8,10,6,311,168,479
2018,8,10,7,245,176,421
2018,8,10,8,237,185,422
2018,8,10,9,227,187,414
2018,8,10,10,233,191,424
2018,8,10,11,253,244,497
2018,8,10,12,260,308,568
2018,8,10,13,301,394,695
2018,8,10,14,202,322,524
2018,8,10,15,188,209,397
2018,8,10,16,140,182,322
2018,8,10,17,158,137,295
2018,8,10,18,112,134,246
2018,8,10,19,79,101,180
2018,8,10,20,65,85,150
2018,8,10,21,46,72,118
2018,8,10,22,32,52,84
2018,8,10,23,20,26,46
2018,8,11,0,17,24,41
2018,8,11,1,16,31,47
2018,8,11,2,11,23,34
2018,8,11,3,9,8,17
2018,8,11,4,25,16,41
2018,8,11,5,26,29,55
2018,8,11,6,35,43,78
2018,8,11,7,70,42,112
2018,8,11,8,103,84,187
2018,8,11,9,139,109,248
2018,8,11,10,173,129,302
2018,8,11,11,153,173,326
2018,8,11,12,147,190,337
2018,8,11,13,156,182,338
2018,8,11,14,158,165,323
2018,8,11,15,118,151,269
2018,8,11,16,137,117,254
2018,8,11,17,99,124,223
2018,8,11,18,84,91,175
2018,8,11,19,68,106,174
2018,8,11,20,51,72,123
2018,8,11,21,41,78,119
2018,8,11,22,51,60,111
2018,8,11,23,28,31,59
2018,8,12,0,19,35,54
2018,8,12,1,19,47,66
2018,8,12,2,10,27,37
2018,8,12,3,11,12,23
2018,8,12,4,17,15,32
2018,8,12,5,11,10,21
2018,8,12,6,32,21,53
2018,8,12,7,59,56,115
2018,8,12,8,105,74,179
2018,8,12,9,109,95,204
2018,8,12,10,140,148,288
2018,8,12,11,172,159,331
2018,8,12,12,171,172,343
2018,8,12,13,159,169,328
2018,8,12,14,161,216,377
2018,8,12,15,149,167,316
2018,8,12,16,128,158,286
2018,8,12,17,152,167,319
2018,8,12,18,140,151,291
2018,8,12,19,99,128,227
2018,8,12,20,67,80,147
2018,8,12,21,36,49,85
2018,8,12,22,24,27,51
2018,8,12,23,11,22,33
2018,8,13,0,7,18,25
2018,8,13,1,2,16,18
2018,8,13,2,9,2,11
2018,8,13,3,16,17,33
2018,8,13,4,125,52,177
2018,8,13,5,197,141,338
2018,8,13,6,369,144,513
2018,8,13,7,260,164,424
2018,8,13,8,197,191,388
2018,8,13,9,190,166,356
2018,8,13,10,235,189,424
2018,8,13,11,225,206,431
2018,8,13,12,230,313,543
2018,8,13,13,262,347,609
2018,8,13,14,217,327,544
2018,8,13,15,181,178,359
2018,8,13,16,139,167,306
2018,8,13,17,147,133,280
2018,8,13,18,128,137,265
2018,8,13,19,84,119,203
2018,8,13,20,99,81,180
2018,8,13,21,53,50,103
2018,8,13,22,26,25,51
2018,8,13,23,16,13,29
2018,8,14,0,13,13,26
2018,8,14,1,15,20,35
2018,8,14,2,15,17,32
2018,8,14,3,22,9,31
2018,8,14,4,126,57,183
2018,8,14,5,205,153,358
2018,8,14,6,361,170,531
2018,8,14,7,240,177,417
2018,8,14,8,212,179,391
2018,8,14,9,208,189,397
2018,8,14,10,209,210,419
2018,8,14,11,245,232,477
2018,8,14,12,224,263,487
2018,8,14,13,261,335,596
2018,8,14,14,217,302,519
2018,8,14,15,151,195,346
2018,8,14,16,176,144,320
2018,8,14,17,145,142,287
2018,8,14,18,127,131,258
2018,8,14,19,104,108,212
2018,8,14,20,62,82,144
2018,8,14,21,39,60,99
2018,8,14,22,30,66,96
2018,8,14,23,19,38,57
2018,8,15,0,11,36,47
2018,8,15,1,13,25,38
2018,8,15,2,13,15,28
2018,8,15,3,22,12,34
2018,8,15,4,117,49,166
2018,8,15,5,227,148,375
2018,8,15,6,368,185,553
2018,8,15,7,252,157,409
2018,8,15,8,231,183,414
2018,8,15,9,226,177,403
2018,8,15,10,216,193,409
2018,8,15,11,217,214,431
2018,8,15,12,195,268,463
2018,8,15,13,234,367,601
2018,8,15,14,217,295,512
2018,8,15,15,177,212,389
2018,8,15,16,157,150,307
2018,8,15,17,166,157,323
2018,8,15,18,128,144,272
2018,8,15,19,74,95,169
2018,8,15,20,63,92,155
2018,8,15,21,45,58,103
2018,8,15,22,23,38,61
2018,8,15,23,19,34,53
2018,8,16,0,13,36,49
2018,8,16,1,12,24,36
2018,8,16,2,14,10,24
2018,8,16,3,17,12,29
2018,8,16,4,104,48,152
2018,8,16,5,218,150,368
2018,8,16,6,363,160,523
2018,8,16,7,237,167,404
2018,8,16,8,233,165,398
2018,8,16,9,231,166,397
2018,8,16,10,238,318,556
2018,8,16,11,210,507,717
2018,8,16,12,244,335,579
2018,8,16,13,253,360,613
2018,8,16,14,214,366,580
2018,8,16,15,176,218,394
2018,8,16,16,183,158,341
2018,8,16,17,131,162,293
2018,8,16,18,113,153,266
2018,8,16,19,89,112,201
2018,8,16,20,75,73,148
2018,8,16,21,37,47,84
2018,8,16,22,30,41,71
2018,8,16,23,30,31,61
2018,8,17,0,13,38,51
2018,8,17,1,14,34,48
2018,8,17,2,10,18,28
2018,8,17,3,24,17,41
2018,8,17,4,108,56,164
2018,8,17,5,216,132,348
2018,8,17,6,390,179,569
2018,8,17,7,240,193,433
2018,8,17,8,211,176,387
2018,8,17,9,221,191,412
2018,8,17,10,234,231,465
2018,8,17,11,231,228,459
2018,8,17,12,254,292,546
2018,8,17,13,269,354,623
2018,8,17,14,201,291,492
2018,8,17,15,162,191,353
2018,8,17,16,165,168,333
2018,8,17,17,144,139,283
2018,8,17,18,91,128,219
2018,8,17,19,85,107,192
2018,8,17,20,68,80,148
2018,8,17,21,48,75,123
2018,8,17,22,44,58,102
2018,8,17,23,31,45,76
2018,8,18,0,21,47,68
2018,8,18,1,32,49,81
2018,8,18,2,7,24,31
2018,8,18,3,12,12,24
2018,8,18,4,21,13,34
2018,8,18,5,41,28,69
2018,8,18,6,35,39,74
2018,8,18,7,72,56,128
2018,8,18,8,105,65,170
2018,8,18,9,135,88,223
2018,8,18,10,178,124,302
2018,8,18,11,166,166,332
2018,8,18,12,174,178,352
2018,8,18,13,146,188,334
2018,8,18,14,157,186,343
2018,8,18,15,172,180,352
2018,8,18,16,166,200,366
2018,8,18,17,104,129,233
2018,8,18,18,78,111,189
2018,8,18,19,81,99,180
2018,8,18,20,65,92,157
2018,8,18,21,53,66,119
2018,8,18,22,46,82,128
2018,8,18,23,29,39,68
2018,8,19,0,35,53,88
2018,8,19,1,28,74,102
2018,8,19,2,17,46,63
2018,8,19,3,10,20,30
2018,8,19,4,21,17,38
2018,8,19,5,22,16,38
2018,8,19,6,26,16,42
2018,8,19,7,58,49,107
2018,8,19,8,83,63,146
2018,8,19,9,93,69,162
2018,8,19,10,137,159,296
2018,8,19,11,130,152,282
2018,8,19,12,181,189,370
2018,8,19,13,150,176,326
2018,8,19,14,155,235,390
2018,8,19,15,160,232,392
2018,8,19,16,148,161,309
2018,8,19,17,143,153,296
2018,8,19,18,225,160,385
2018,8,19,19,106,130,236
2018,8,19,20,71,90,161
2018,8,19,21,42,56,98
2018,8,19,22,16,22,38
2018,8,19,23,13,21,34
2018,8,20,0,7,10,17
2018,8,20,1,6,12,18
2018,8,20,2,6,14,20
2018,8,20,3,21,11,32
2018,8,20,4,141,52,193
2018,8,20,5,223,145,368
2018,8,20,6,399,180,579
2018,8,20,7,244,178,422
2018,8,20,8,238,180,418
2018,8,20,9,201,215,416
2018,8,20,10,226,204,430
2018,8,20,11,256,223,479
2018,8,20,12,209,268,477
2018,8,20,13,255,368,623
2018,8,20,14,234,293,527
2018,8,20,15,174,208,382
2018,8,20,16,151,194,345
2018,8,20,17,141,156,297
2018,8,20,18,112,165,277
2018,8,20,19,81,111,192
2018,8,20,20,49,64,113
2018,8,20,21,45,46,91
2018,8,20,22,23,24,47
2018,8,20,23,14,20,34
2018,8,21,0,10,20,30
2018,8,21,1,15,9,24
2018,8,21,2,11,10,21
2018,8,21,3,19,8,27
2018,8,21,4,124,62,186
2018,8,21,5,235,143,378
2018,8,21,6,403,256,659
2018,8,21,7,252,181,433
2018,8,21,8,236,161,397
2018,8,21,9,283,195,478
2018,8,21,10,185,201,386
2018,8,21,11,241,209,450
2018,8,21,12,220,275,495
2018,8,21,13,245,354,599
2018,8,21,14,193,332,525
2018,8,21,15,192,217,409
2018,8,21,16,167,150,317
2018,8,21,17,129,148,277
2018,8,21,18,143,143,286
2018,8,21,19,105,133,238
2018,8,21,20,50,80,130
2018,8,21,21,34,42,76
2018,8,21,22,19,30,49
2018,8,21,23,10,11,21
2018,8,22,0,5,14,19
2018,8,22,1,10,9,19
2018,8,22,2,6,4,10
2018,8,22,3,20,13,33
2018,8,22,4,130,50,180
2018,8,22,5,240,167,407
2018,8,22,6,417,211,628
2018,8,22,7,278,158,436
2018,8,22,8,230,179,409
2018,8,22,9,214,181,395
2018,8,22,10,241,195,436
2018,8,22,11,235,233,468
2018,8,22,12,219,280,499
2018,8,22,13,256,349,605
2018,8,22,14,271,301,572
2018,8,22,15,244,215,459
2018,8,22,16,155,179,334
2018,8,22,17,127,146,273
2018,8,22,18,110,172,282
2018,8,22,19,93,124,217
2018,8,22,20,78,73,151
2018,8,22,21,48,44,92
2018,8,22,22,21,26,47
2018,8,22,23,15,28,43
2018,8,23,0,7,13,20
2018,8,23,1,8,12,20
2018,8,23,2,8,10,18
2018,8,23,3,17,10,27
2018,8,23,4,124,50,174
2018,8,23,5,248,142,390
2018,8,23,6,383,221,604
2018,8,23,7,270,183,453
2018,8,23,8,233,183,416
2018,8,23,9,232,188,420
2018,8,23,10,253,209,462
2018,8,23,11,225,241,466
2018,8,23,12,250,285,535
2018,8,23,13,238,338,576
2018,8,23,14,252,412,664
2018,8,23,15,179,238,417
2018,8,23,16,176,164,340
2018,8,23,17,128,164,292
2018,8,23,18,124,142,266
2018,8,23,19,85,111,196
2018,8,23,20,65,79,144
2018,8,23,21,33,52,85
2018,8,23,22,26,31,57
2018,8,23,23,17,29,46
2018,8,24,0,12,27,39
2018,8,24,1,10,24,34
2018,8,24,2,10,20,30
2018,8,24,3,20,12,32
2018,8,24,4,115,46,161
2018,8,24,5,247,141,388
2018,8,24,6,365,187,552
2018,8,24,7,255,158,413
2018,8,24,8,237,190,427
2018,8,24,9,234,175,409
2018,8,24,10,211,245,456
2018,8,24,11,197,242,439
2018,8,24,12,244,314,558
2018,8,24,13,256,395,651
2018,8,24,14,196,310,506
2018,8,24,15,178,183,361
2018,8,24,16,149,165,314
2018,8,24,17,143,130,273
2018,8,24,18,116,108,224
2018,8,24,19,93,98,191
2018,8,24,20,56,84,140
2018,8,24,21,52,64,116
2018,8,24,22,43,59,102
2018,8,24,23,34,50,84
2018,8,25,0,27,51,78
2018,8,25,1,22,51,73
2018,8,25,2,11,28,39
2018,8,25,3,7,10,17
2018,8,25,4,22,18,40
2018,8,25,5,28,26,54
2018,8,25,6,22,31,53
2018,8,25,7,56,64,120
2018,8,25,8,109,79,188
2018,8,25,9,148,114,262
2018,8,25,10,174,148,322
2018,8,25,11,154,170,324
2018,8,25,12,145,173,318
2018,8,25,13,154,188,342
2018,8,25,14,127,168,295
2018,8,25,15,158,147,305
2018,8,25,16,133,124,257
2018,8,25,17,115,119,234
2018,8,25,18,88,106,194
2018,8,25,19,70,91,161
2018,8,25,20,48,72,120
2018,8,25,21,39,62,101
2018,8,25,22,49,73,122
2018,8,25,23,30,52,82
2018,8,26,0,30,54,84
2018,8,26,1,34,52,86
2018,8,26,2,25,48,73
2018,8,26,3,11,26,37
2018,8,26,4,14,22,36
2018,8,26,5,18,27,45
2018,8,26,6,37,24,61
2018,8,26,7,55,43,98
2018,8,26,8,135,72,207
2018,8,26,9,111,77,188
2018,8,26,10,133,156,289
2018,8,26,11,137,184,321
2018,8,26,12,154,217,371
2018,8,26,13,177,217,394
2018,8,26,14,144,217,361
2018,8,26,15,181,157,338
2018,8,26,16,167,190,357
2018,8,26,17,166,150,316
2018,8,26,18,105,160,265
2018,8,26,19,87,121,208
2018,8,26,20,58,74,132
2018,8,26,21,27,47,74
2018,8,26,22,23,23,46
2018,8,26,23,8,19,27
2018,8,27,0,6,7,13
2018,8,27,1,4,7,11
2018,8,27,2,8,8,16
2018,8,27,3,18,8,26
2018,8,27,4,117,63,180
2018,8,27,5,245,168,413
2018,8,27,6,390,201,591
2018,8,27,7,277,181,458
2018,8,27,8,240,177,417
2018,8,27,9,225,177,402
2018,8,27,10,218,195,413
2018,8,27,11,220,236,456
2018,8,27,12,201,273,474
2018,8,27,13,261,353,614
2018,8,27,14,200,304,504
2018,8,27,15,197,200,397
2018,8,27,16,170,158,328
2018,8,27,17,131,121,252
2018,8,27,18,115,151,266
2018,8,27,19,86,113,199
2018,8,27,20,50,63,113
2018,8,27,21,31,43,74
2018,8,27,22,21,21,42
2018,8,27,23,11,6,17
2018,8,28,0,1,9,10
2018,8,28,1,8,14,22
2018,8,28,2,10,9,19
2018,8,28,3,15,10,25
2018,8,28,4,129,52,181
2018,8,28,5,271,153,424
2018,8,28,6,358,187,545
2018,8,28,7,231,155,386
2018,8,28,8,227,213,440
2018,8,28,9,238,179,417
2018,8,28,10,208,232,440
2018,8,28,11,204,247,451
2018,8,28,12,214,275,489
2018,8,28,13,258,371,629
2018,8,28,14,211,296,507
2018,8,28,15,172,176,348
2018,8,28,16,219,146,365
2018,8,28,17,142,157,299
2018,8,28,18,118,168,286
2018,8,28,19,90,120,210
2018,8,28,20,59,108,167
2018,8,28,21,36,39,75
2018,8,28,22,14,28,42
2018,8,28,23,9,26,35
2018,8,29,0,7,16,23
2018,8,29,1,12,21,33
2018,8,29,2,8,17,25
2018,8,29,3,20,14,34
2018,8,29,4,126,52,178
2018,8,29,5,247,164,411
2018,8,29,6,353,186,539
2018,8,29,7,272,147,419
2018,8,29,8,221,148,369
2018,8,29,9,181,165,346
2018,8,29,10,229,212,441
2018,8,29,11,205,187,392
2018,8,29,12,238,258,496
2018,8,29,13,268,359,627
2018,8,29,14,257,295,552
2018,8,29,15,193,236,429
2018,8,29,16,229,213,442
2018,8,29,17,149,154,303
2018,8,29,18,130,133,263
2018,8,29,19,92,126,218
2018,8,29,20,84,99,183
2018,8,29,21,43,63,106
2018,8,29,22,22,27,49
2018,8,29,23,13,27,40
2018,8,30,0,10,13,23
2018,8,30,1,10,18,28
2018,8,30,2,7,8,15
2018,8,30,3,18,14,32
2018,8,30,4,116,52,168
2018,8,30,5,216,131,347
2018,8,30,6,399,185,584
2018,8,30,7,277,183,460
2018,8,30,8,211,182,393
2018,8,30,9,235,194,429
2018,8,30,10,219,215,434
2018,8,30,11,200,195,395
2018,8,30,12,238,281,519
2018,8,30,13,266,357,623
2018,8,30,14,219,283,502
2018,8,30,15,183,191,374
2018,8,30,16,188,173,361
2018,8,30,17,146,176,322
2018,8,30,18,115,154,269
2018,8,30,19,110,126,236
2018,8,30,20,63,84,147
2018,8,30,21,44,41,85
2018,8,30,22,21,27,48
2018,8,30,23,17,25,42
2018,8,31,0,14,29,43
2018,8,31,1,11,27,38
2018,8,31,2,8,19,27
2018,8,31,3,18,15,33
2018,8,31,4,123,57,180
2018,8,31,5,221,138,359
2018,8,31,6,369,173,542
2018,8,31,7,262,159,421
2018,8,31,8,245,183,428
2018,8,31,9,241,195,436
2018,8,31,10,260,196,456
2018,8,31,11,228,241,469
2018,8,31,12,266,319,585
2018,8,31,13,276,361,637
2018,8,31,14,180,306,486
2018,8,31,15,159,196,355
2018,8,31,16,148,147,295
2018,8,31,17,135,127,262
2018,8,31,18,98,114,212
2018,8,31,19,77,89,166
2018,8,31,20,59,75,134
2018,8,31,21,47,60,107
2018,8,31,22,41,51,92
2018,8,31,23,33,47,80
2018,9,1,0,12,42,54
2018,9,1,1,22,31,53
2018,9,1,2,7,16,23
2018,9,1,3,8,7,15
2018,9,1,4,19,18,37
2018,9,1,5,26,22,48
2018,9,1,6,37,44,81
2018,9,1,7,56,51,107
2018,9,1,8,99,64,163
2018,9,1,9,146,85,231
2018,9,1,10,145,135,280
2018,9,1,11,142,158,300
2018,9,1,12,140,148,288
2018,9,1,13,146,178,324
2018,9,1,14,122,163,285
2018,9,1,15,128,180,308
2018,9,1,16,123,148,271
2018,9,1,17,97,107,204
2018,9,1,18,85,87,172
2018,9,1,19,67,86,153
2018,9,1,20,44,59,103
2018,9,1,21,41,62,103
2018,9,1,22,30,45,75
2018,9,1,23,33,43,76
2018,9,2,0,25,49,74
2018,9,2,1,33,49,82
2018,9,2,2,18,40,58
2018,9,2,3,12,16,28
2018,9,2,4,17,8,25
2018,9,2,5,14,16,30
2018,9,2,6,34,28,62
2018,9,2,7,56,41,97
2018,9,2,8,77,58,135
2018,9,2,9,117,94,211
2018,9,2,10,138,114,252
2018,9,2,11,157,181,338
2018,9,2,12,174,209,383
2018,9,2,13,144,187,331
2018,9,2,14,155,225,380
2018,9,2,15,185,197,382
2018,9,2,16,160,173,333
2018,9,2,17,130,166,296
2018,9,2,18,172,173,345
2018,9,2,19,83,111,194
2018,9,2,20,52,53,105
2018,9,2,21,23,37,60
2018,9,2,22,15,21,36
2018,9,2,23,10,17,27
2018,9,3,0,5,9,14
2018,9,3,1,9,13,22
2018,9,3,2,7,8,15
2018,9,3,3,22,13,35
2018,9,3,4,123,54,177
2018,9,3,5,243,148,391
2018,9,3,6,420,189,609
2018,9,3,7,242,176,418
2018,9,3,8,188,167,355
2018,9,3,9,211,180,391
2018,9,3,10,190,186,376
2018,9,3,11,251,209,460
2018,9,3,12,205,249,454
2018,9,3,13,212,311,523
2018,9,3,14,214,316,530
2018,9,3,15,181,195,376
2018,9,3,16,162,157,319
2018,9,3,17,126,130,256
2018,9,3,18,101,144,245
2018,9,3,19,95,110,205
2018,9,3,20,50,78,128
2018,9,3,21,27,35,62
2018,9,3,22,16,21,37
2018,9,3,23,11,9,20
2018,9,4,0,6,23,29
2018,9,4,1,10,11,21
2018,9,4,2,10,10,20
2018,9,4,3,25,10,35
2018,9,4,4,125,49,174
2018,9,4,5,235,138,373
2018,9,4,6,391,201,592
2018,9,4,7,259,162,421
2018,9,4,8,199,150,349
2018,9,4,9,227,185,412
2018,9,4,10,238,221,459
2018,9,4,11,234,224,458
2018,9,4,12,218,270,488
2018,9,4,13,274,348,622
2018,9,4,14,214,328,542
2018,9,4,15,184,163,347
2018,9,4,16,174,176,350
2018,9,4,17,154,174,328
2018,9,4,18,133,145,278
2018,9,4,19,106,136,242
2018,9,4,20,43,81,124
2018,9,4,21,29,49,78
2018,9,4,22,18,22,40
2018,9,4,23,7,20,27
2018,9,5,0,4,20,24
2018,9,5,1,14,13,27
2018,9,5,2,8,13,21
2018,9,5,3,20,8,28
2018,9,5,4,109,50,159
2018,9,5,5,235,136,371
2018,9,5,6,353,188,541
2018,9,5,7,247,167,414
2018,9,5,8,225,176,401
2018,9,5,9,204,184,388
2018,9,5,10,229,210,439
2018,9,5,11,206,179,385
2018,9,5,12,199,278,477
2018,9,5,13,260,316,576
2018,9,5,14,221,297,518
2018,9,5,15,212,179,391
2018,9,5,16,152,144,296
2018,9,5,17,137,175,312
2018,9,5,18,120,146,266
2018,9,5,19,99,130,229
2018,9,5,20,66,90,156
2018,9,5,21,38,57,95
2018,9,5,22,15,29,44
2018,9,5,23,9,20,29
2018,9,6,0,11,15,26
2018,9,6,1,6,11,17
2018,9,6,2,7,10,17
2018,9,6,3,22,8,30
2018,9,6,4,123,53,176
2018,9,6,5,224,130,354
2018,9,6,6,392,215,607
2018,9,6,7,257,178,435
2018,9,6,8,231,150,381
2018,9,6,9,205,153,358
2018,9,6,10,258,226,484
2018,9,6,11,244,199,443
2018,9,6,12,213,275,488
2018,9,6,13,268,338,606
2018,9,6,14,240,328,568
2018,9,6,15,175,191,366
2018,9,6,16,203,144,347
2018,9,6,17,181,189,370
2018,9,6,18,114,139,253
2018,9,6,19,90,106,196
2018,9,6,20,82,84,166
2018,9,6,21,36,40,76
2018,9,6,22,17,23,40
2018,9,6,23,10,23,33
2018,9,7,0,6,19,25
2018,9,7,1,12,21,33
2018,9,7,2,7,13,20
2018,9,7,3,15,10,25
2018,9,7,4,112,53,165
2018,9,7,5,215,133,348
2018,9,7,6,335,190,525
2018,9,7,7,212,146,358
2018,9,7,8,204,157,361
2018,9,7,9,215,171,386
2018,9,7,10,225,226,451
2018,9,7,11,197,253,450
2018,9,7,12,238,324,562
2018,9,7,13,283,356,639
2018,9,7,14,203,266,469
2018,9,7,15,148,186,334
2018,9,7,16,138,141,279
2018,9,7,17,100,126,226
2018,9,7,18,100,133,233
2018,9,7,19,73,99,172
2018,9,7,20,62,66,128
2018,9,7,21,55,84,139
2018,9,7,22,28,47,75
2018,9,7,23,22,35,57
2018,9,8,0,19,28,47
2018,9,8,1,8,37,45
2018,9,8,2,9,19,28
2018,9,8,3,8,13,21
2018,9,8,4,23,13,36
2018,9,8,5,26,25,51
2018,9,8,6,36,43,79
2018,9,8,7,70,55,125
2018,9,8,8,132,78,210
2018,9,8,9,119,111,230
2018,9,8,10,145,135,280
2018,9,8,11,162,152,314
2018,9,8,12,152,172,324
2018,9,8,13,116,179,295
2018,9,8,14,130,196,326
2018,9,8,15,123,145,268
2018,9,8,16,125,137,262
2018,9,8,17,110,121,231
2018,9,8,18,92,105,197
2018,9,8,19,62,76,138
2018,9,8,20,43,63,106
2018,9,8,21,34,58,92
2018,9,8,22,44,55,99
2018,9,8,23,34,49,83
2018,9,9,0,30,44,74
2018,9,9,1,30,59,89
2018,9,9,2,11,34,45
2018,9,9,3,14,22,36
2018,9,9,4,20,15,35
2018,9,9,5,19,12,31
2018,9,9,6,33,28,61
2018,9,9,7,74,40,114
2018,9,9,8,120,68,188
2018,9,9,9,104,104,208
2018,9,9,10,128,141,269
2018,9,9,11,153,199,352
2018,9,9,12,183,208,391
2018,9,9,13,143,173,316
2018,9,9,14,144,197,341
2018,9,9,15,157,176,333
2018,9,9,16,170,172,342
2018,9,9,17,136,167,303
2018,9,9,18,120,142,262
2018,9,9,19,103,139,242
2018,9,9,20,48,55,103
2018,9,9,21,40,34,74
2018,9,9,22,16,22,38
2018,9,9,23,4,13,17
2018,9,10,0,7,18,25
2018,9,10,1,5,9,14
2018,9,10,2,7,6,13
2018,9,10,3,26,12,38
2018,9,10,4,115,53,168
2018,9,10,5,213,137,350
2018,9,10,6,391,180,571
2018,9,10,7,261,149,410
2018,9,10,8,217,174,391
2018,9,10,9,218,176,394
2018,9,10,10,173,203,376
2018,9,10,11,218,232,450
2018,9,10,12,227,261,488
2018,9,10,13,262,331,593
2018,9,10,14,233,326,559
2018,9,10,15,220,198,418
2018,9,10,16,184,169,353
2018,9,10,17,126,161,287
2018,9,10,18,127,148,275
2018,9,10,19,78,120,198
2018,9,10,20,63,94,157
2018,9,10,21,40,45,85
2018,9,10,22,23,22,45
2018,9,10,23,9,9,18
2018,9,11,0,11,11,22
2018,9,11,1,12,9,21
2018,9,11,2,11,6,17
2018,9,11,3,19,9,28
2018,9,11,4,124,51,175
2018,9,11,5,245,141,386
2018,9,11,6,409,242,651
2018,9,11,7,285,166,451
2018,9,11,8,234,164,398
2018,9,11,9,235,189,424
2018,9,11,10,217,187,404
2018,9,11,11,198,199,397
2018,9,11,12,222,283,505
2018,9,11,13,215,360,575
2018,9,11,14,240,316,556
2018,9,11,15,185,211,396
2018,9,11,16,187,146,333
2018,9,11,17,141,159,300
2018,9,11,18,122,137,259
2018,9,11,19,86,109,195
2018,9,11,20,59,126,185
2018,9,11,21,28,44,72
2018,9,11,22,10,18,28
2018,9,11,23,14,16,30
2018,9,12,0,4,16,20
2018,9,12,1,8,12,20
2018,9,12,2,7,8,15
2018,9,12,3,18,12,30
2018,9,12,4,121,53,174
2018,9,12,5,218,147,365
2018,9,12,6,446,225,671
2018,9,12,7,244,159,403
2018,9,12,8,221,182,403
2018,9,12,9,219,201,420
2018,9,12,10,205,206,411
2018,9,12,11,215,202,417
2018,9,12,12,191,240,431
2018,9,12,13,222,327,549
2018,9,12,14,265,302,567
2018,9,12,15,188,199,387
2018,9,12,16,156,173,329
2018,9,12,17,155,151,306
2018,9,12,18,116,154,270
2018,9,12,19,78,115,193
2018,9,12,20,76,411,487
2018,9,12,21,28,215,243
2018,9,12,22,15,77,92
2018,9,12,23,14,56,70
2018,9,13,0,3,52,55
2018,9,13,1,8,38,46
2018,9,13,2,6,49,55
2018,9,13,3,15,56,71
2018,9,13,4,115,48,163
2018,9,13,5,220,155,375
2018,9,13,6,427,187,614
2018,9,13,7,258,169,427
2018,9,13,8,204,171,375
2018,9,13,9,220,188,408
2018,9,13,10,219,208,427
2018,9,13,11,224,206,430
2018,9,13,12,225,263,488
2018,9,13,13,259,308,567
2018,9,13,14,248,307,555
2018,9,13,15,216,207,423
2018,9,13,16,180,180,360
2018,9,13,17,137,170,307
2018,9,13,18,108,136,244
2018,9,13,19,101,133,234
2018,9,13,20,57,113,170
2018,9,13,21,32,63,95
2018,9,13,22,27,24,51
2018,9,13,23,15,19,34
2018,9,14,0,10,33,43
2018,9,14,1,17,23,40
2018,9,14,2,9,11,20
2018,9,14,3,16,12,28
2018,9,14,4,114,54,168
2018,9,14,5,195,126,321
2018,9,14,6,366,194,560
2018,9,14,7,279,158,437
2018,9,14,8,240,168,408
2018,9,14,9,216,182,398
2018,9,14,10,236,218,454
2018,9,14,11,187,228,415
2018,9,14,12,224,295,519
2018,9,14,13,282,348,630
2018,9,14,14,232,305,537
2018,9,14,15,199,205,404
2018,9,14,16,139,154,293
2018,9,14,17,132,119,251
2018,9,14,18,135,114,249
2018,9,14,19,64,135,199
2018,9,14,20,53,71,124
2018,9,14,21,46,60,106
2018,9,14,22,38,58,96
2018,9,14,23,22,46,68
2018,9,15,0,23,48,71
2018,9,15,1,16,53,69
2018,9,15,2,14,29,43
2018,9,15,3,16,9,25
2018,9,15,4,25,11,36
2018,9,15,5,28,24,52
2018,9,15,6,43,40,83
2018,9,15,7,78,53,131
2018,9,15,8,136,88,224
2018,9,15,9,156,110,266
2018,9,15,10,151,173,324
2018,9,15,11,161,154,315
2018,9,15,12,165,180,345
2018,9,15,13,145,173,318
2018,9,15,14,150,189,339
2018,9,15,15,142,170,312
2018,9,15,16,138,165,303
2018,9,15,17,116,127,243
2018,9,15,18,108,122,230
2018,9,15,19,76,80,156
2018,9,15,20,52,78,130
2018,9,15,21,50,66,116
2018,9,15,22,54,70,124
2018,9,15,23,28,54,82
2018,9,16,0,30,64,94
2018,9,16,1,30,66,96
2018,9,16,2,28,41,69
2018,9,16,3,10,14,24
2018,9,16,4,15,11,26
2018,9,16,5,15,18,33
2018,9,16,6,30,12,42
2018,9,16,7,73,37,110
2018,9,16,8,133,57,190
2018,9,16,9,131,82,213
2018,9,16,10,188,218,406
2018,9,16,11,175,212,387
2018,9,16,12,200,200,400
2018,9,16,13,171,217,388
2018,9,16,14,157,254,411
2018,9,16,15,169,198,367
2018,9,16,16,156,157,313
2018,9,16,17,141,172,313
2018,9,16,18,120,144,264
2018,9,16,19,81,103,184
2018,9,16,20,50,70,120
2018,9,16,21,32,44,76
2018,9,16,22,18,19,37
2018,9,16,23,15,22,37
2018,9,17,0,3,9,12
2018,9,17,1,6,7,13
2018,9,17,2,8,6,14
2018,9,17,3,20,12,32
2018,9,17,4,116,48,164
2018,9,17,5,234,157,391
2018,9,17,6,379,219,598
2018,9,17,7,236,148,384
2018,9,17,8,227,166,393
2018,9,17,9,204,182,386
2018,9,17,10,202,205,407
2018,9,17,11,223,226,449
2018,9,17,12,197,263,460
2018,9,17,13,241,301,542
2018,9,17,14,226,319,545
2018,9,17,15,174,207,381
2018,9,17,16,165,146,311
2018,9,17,17,124,127,251
2018,9,17,18,120,136,256
2018,9,17,19,92,125,217
2018,9,17,20,55,86,141
2018,9,17,21,40,35,75
2018,9,17,22,17,18,35
2018,9,17,23,9,10,19
2018,9,18,0,5,13,18
2018,9,18,1,4,5,9
2018,9,18,2,10,5,15
2018,9,18,3,18,13,31
2018,9,18,4,121,43,164
2018,9,18,5,226,167,393
2018,9,18,6,391,210,601
2018,9,18,7,235,165,400
2018,9,18,8,210,143,353
2018,9,18,9,223,196,419
2018,9,18,10,179,177,356
2018,9,18,11,213,222,435
2018,9,18,12,222,231,453
2018,9,18,13,242,309,551
2018,9,18,14,204,304,508
2018,9,18,15,178,183,361
2018,9,18,16,175,142,317
2018,9,18,17,161,157,318
2018,9,18,18,113,122,235
2018,9,18,19,87,97,184
2018,9,18,20,59,86,145
2018,9,18,21,38,61,99
2018,9,18,22,6,25,31
2018,9,18,23,10,20,30
2018,9,19,0,9,15,24
2018,9,19,1,6,19,25
2018,9,19,2,7,9,16
2018,9,19,3,21,15,36
2018,9,19,4,103,50,153
2018,9,19,5,243,167,410
2018,9,19,6,391,215,606
2018,9,19,7,249,163,412
2018,9,19,8,246,191,437
2018,9,19,9,215,182,397
2018,9,19,10,226,227,453
2018,9,19,11,223,224,447
2018,9,19,12,202,250,452
2018,9,19,13,242,328,570
2018,9,19,14,233,300,533
2018,9,19,15,189,214,403
2018,9,19,16,199,165,364
2018,9,19,17,145,133,278
2018,9,19,18,127,134,261
2018,9,19,19,84,110,194
2018,9,19,20,57,109,166
2018,9,19,21,30,40,70
2018,9,19,22,24,23,47
2018,9,19,23,14,21,35
2018,9,20,0,14,20,34
2018,9,20,1,2,13,15
2018,9,20,2,1,5,6
2018,9,20,3,20,17,37
2018,9,20,4,111,62,173
2018,9,20,5,245,159,404
2018,9,20,6,408,210,618
2018,9,20,7,264,178,442
2018,9,20,8,223,187,410
2018,9,20,9,211,184,395
2018,9,20,10,219,222,441
2018,9,20,11,224,212,436
2018,9,20,12,233,264,497
2018,9,20,13,243,317,560
2018,9,20,14,231,297,528
2018,9,20,15,191,194,385
2018,9,20,16,208,172,380
2018,9,20,17,138,161,299
2018,9,20,18,115,127,242
2018,9,20,19,87,104,191
2018,9,20,20,57,95,152
2018,9,20,21,31,39,70
2018,9,20,22,22,23,45
2018,9,20,23,9,23,32
2018,9,21,0,14,21,35
2018,9,21,1,7,9,16
2018,9,21,2,7,9,16
2018,9,21,3,23,11,34
2018,9,21,4,112,44,156
2018,9,21,5,228,152,380
2018,9,21,6,377,210,587
2018,9,21,7,276,184,460
2018,9,21,8,222,153,375
2018,9,21,9,232,197,429
2018,9,21,10,265,229,494
2018,9,21,11,244,238,482
2018,9,21,12,254,314,568
2018,9,21,13,253,361,614
2018,9,21,14,261,317,578
2018,9,21,15,161,192,353
2018,9,21,16,150,151,301
2018,9,21,17,116,144,260
2018,9,21,18,92,107,199
2018,9,21,19,54,79,133
2018,9,21,20,68,76,144
2018,9,21,21,56,67,123
2018,9,21,22,45,56,101
2018,9,21,23,21,35,56
2018,9,22,0,18,31,49
2018,9,22,1,15,23,38
2018,9,22,2,9,18,27
2018,9,22,3,7,5,12
2018,9,22,4,22,17,39
2018,9,22,5,23,21,44
2018,9,22,6,40,36,76
2018,9,22,7,88,60,148
2018,9,22,8,113,89,202
2018,9,22,9,166,100,266
2018,9,22,10,157,138,295
2018,9,22,11,170,186,356
2018,9,22,12,169,195,364
2018,9,22,13,158,173,331
2018,9,22,14,145,211,356
2018,9,22,15,137,157,294
2018,9,22,16,137,153,290
2018,9,22,17,130,145,275
2018,9,22,18,110,124,234
2018,9,22,19,68,87,155
2018,9,22,20,44,68,112
2018,9,22,21,39,65,104
2018,9,22,22,38,48,86
2018,9,22,23,51,56,107
2018,9,23,0,27,47,74
2018,9,23,1,27,52,79
2018,9,23,2,18,43,61
2018,9,23,3,9,24,33
2018,9,23,4,15,11,26
2018,9,23,5,21,21,42
2018,9,23,6,31,15,46
2018,9,23,7,60,45,105
2018,9,23,8,87,67,154
2018,9,23,9,102,100,202
2018,9,23,10,177,154,331
2018,9,23,11,164,161,325
2018,9,23,12,218,206,424
2018,9,23,13,193,238,431
2018,9,23,14,163,255,418
2018,9,23,15,168,239,407
2018,9,23,16,174,174,348
2018,9,23,17,119,169,288
2018,9,23,18,173,148,321
2018,9,23,19,82,105,187
2018,9,23,20,57,75,132
2018,9,23,21,23,33,56
2018,9,23,22,25,17,42
2018,9,23,23,10,11,21
2018,9,24,0,9,14,23
2018,9,24,1,5,10,15
2018,9,24,2,6,11,17
2018,9,24,3,19,12,31
2018,9,24,4,127,55,182
2018,9,24,5,207,136,343
2018,9,24,6,418,207,625
2018,9,24,7,264,175,439
2018,9,24,8,207,147,354
2018,9,24,9,221,179,400
2018,9,24,10,206,190,396
2018,9,24,11,191,184,375
2018,9,24,12,212,238,450
2018,9,24,13,230,321,551
2018,9,24,14,214,330,544
2018,9,24,15,191,211,402
2018,9,24,16,167,162,329
2018,9,24,17,142,146,288
2018,9,24,18,124,125,249
2018,9,24,19,87,112,199
2018,9,24,20,71,95,166
2018,9,24,21,39,34,73
2018,9,24,22,17,16,33
2018,9,24,23,12,6,18
2018,9,25,0,8,12,20
2018,9,25,1,4,8,12
2018,9,25,2,11,3,14
2018,9,25,3,16,9,25
2018,9,25,4,117,62,179
2018,9,25,5,231,142,373
2018,9,25,6,439,202,641
2018,9,25,7,264,184,448
2018,9,25,8,209,175,384
2018,9,25,9,229,180,409
2018,9,25,10,219,181,400
2018,9,25,11,210,215,425
2018,9,25,12,225,239,464
2018,9,25,13,257,329,586
2018,9,25,14,201,308,509
2018,9,25,15,205,214,419
2018,9,25,16,195,177,372
2018,9,25,17,167,169,336
2018,9,25,18,121,141,262
2018,9,25,19,87,138,225
2018,9,25,20,53,394,447
2018,9,25,21,29,76,105
2018,9,25,22,15,40,55
2018,9,25,23,6,17,23
2018,9,26,0,10,16,26
2018,9,26,1,8,17,25
2018,9,26,2,8,5,13
2018,9,26,3,18,9,27
2018,9,26,4,113,45,158
2018,9,26,5,211,152,363
2018,9,26,6,388,221,609
2018,9,26,7,248,158,406
2018,9,26,8,219,165,384
2018,9,26,9,222,188,410
2018,9,26,10,197,175,372
2018,9,26,11,209,200,409
2018,9,26,12,202,263,465
2018,9,26,13,225,285,510
2018,9,26,14,256,304,560
2018,9,26,15,167,182,349
2018,9,26,16,225,147,372
2018,9,26,17,154,145,299
2018,9,26,18,109,137,246
2018,9,26,19,92,108,200
2018,9,26,20,84,94,178
2018,9,26,21,41,33,74
2018,9,26,22,26,22,48
2018,9,26,23,15,21,36
2018,9,27,0,7,17,24
2018,9,27,1,14,13,27
2018,9,27,2,10,8,18
2018,9,27,3,23,10,33
2018,9,27,4,109,56,165
2018,9,27,5,224,135,359
2018,9,27,6,423,199,622
2018,9,27,7,272,153,425
2018,9,27,8,215,166,381
2018,9,27,9,179,171,350
2018,9,27,10,213,197,410
2018,9,27,11,216,207,423
2018,9,27,12,218,245,463
2018,9,27,13,242,308,550
2018,9,27,14,200,294,494
2018,9,27,15,187,206,393
2018,9,27,16,193,186,379
2018,9,27,17,145,158,303
2018,9,27,18,112,125,237
2018,9,27,19,77,129,206
2018,9,27,20,64,123,187
2018,9,27,21,28,44,72
2018,9,27,22,26,35,61
2018,9,27,23,14,28,42
2018,9,28,0,18,31,49
2018,9,28,1,11,29,40
2018,9,28,2,10,12,22
2018,9,28,3,26,13,39
2018,9,28,4,105,52,157
2018,9,28,5,215,147,362
2018,9,28,6,377,208,585
2018,9,28,7,253,174,427
2018,9,28,8,211,185,396
2018,9,28,9,224,201,425
2018,9,28,10,241,202,443
2018,9,28,11,226,225,451
2018,9,28,12,214,276,490
2018,9,28,13,238,339,577
2018,9,28,14,195,264,459
2018,9,28,15,194,195,389
2018,9,28,16,161,182,343
2018,9,28,17,124,128,252
2018,9,28,18,85,154,239
2018,9,28,19,56,91,147
2018,9,28,20,77,71,148
2018,9,28,21,51,68,119
2018,9,28,22,34,57,91
2018,9,28,23,23,33,56
2018,9,29,0,16,41,57
2018,9,29,1,14,29,43
2018,9,29,2,7,26,33
2018,9,29,3,15,17,32
2018,9,29,4,19,8,27
2018,9,29,5,34,30,64
2018,9,29,6,39,39,78
2018,9,29,7,72,48,120
2018,9,29,8,100,90,190
2018,9,29,9,133,116,249
2018,9,29,10,180,134,314
2018,9,29,11,177,162,339
2018,9,29,12,155,158,313
2018,9,29,13,140,166,306
2018,9,29,14,128,176,304
2018,9,29,15,117,154,271
2018,9,29,16,141,158,299
2018,9,29,17,99,105,204
2018,9,29,18,85,115,200
2018,9,29,19,63,70,133
2018,9,29,20,61,85,146
2018,9,29,21,46,71,117
2018,9,29,22,44,53,97
2018,9,29,23,24,52,76
2018,9,30,0,30,51,81
2018,9,30,1,25,62,87
2018,9,30,2,15,35,50
2018,9,30,3,10,17,27
2018,9,30,4,15,14,29
2018,9,30,5,21,18,39
2018,9,30,6,30,16,46
2018,9,30,7,47,44,91
2018,9,30,8,116,44,160
2018,9,30,9,103,79,182
2018,9,30,10,161,166,327
2018,9,30,11,168,178,346
2018,9,30,12,165,202,367
2018,9,30,13,200,196,396
2018,9,30,14,156,254,410
2018,9,30,15,200,195,395
2018,9,30,16,171,171,342
2018,9,30,17,147,184,331
2018,9,30,18,110,135,245
2018,9,30,19,73,106,179
2018,9,30,20,47,64,111
2018,9,30,21,23,41,64
2018,9,30,22,21,24,45
2018,9,30,23,10,16,26
2018,10,1,0,5,12,17
2018,10,1,1,11,20,31
2018,10,1,2,9,3,12
2018,10,1,3,27,11,38
2018,10,1,4,119,57,176
2018,10,1,5,209,154,363
2018,10,1,6,421,222,643
2018,10,1,7,232,132,364
2018,10,1,8,233,166,399
2018,10,1,9,213,176,389
2018,10,1,10,207,196,403
2018,10,1,11,227,221,448
2018,10,1,12,220,231,451
2018,10,1,13,247,325,572
2018,10,1,14,220,333,553
2018,10,1,15,183,187,370
2018,10,1,16,165,143,308
2018,10,1,17,122,107,229
2018,10,1,18,103,122,225
2018,10,1,19,87,127,214
2018,10,1,20,49,79,128
2018,10,1,21,34,38,72
2018,10,1,22,21,25,46
2018,10,1,23,11,15,26
2018,10,2,0,5,7,12
2018,10,2,1,3,11,14
2018,10,2,2,9,3,12
2018,10,2,3,20,12,32
2018,10,2,4,114,45,159
2018,10,2,5,238,162,400
2018,10,2,6,405,222,627
2018,10,2,7,247,164,411
2018,10,2,8,226,158,384
2018,10,2,9,215,197,412
2018,10,2,10,200,195,395
2018,10,2,11,218,223,441
2018,10,2,12,232,265,497
2018,10,2,13,237,325,562
2018,10,2,14,265,337,602
2018,10,2,15,190,201,391
2018,10,2,16,189,156,345
2018,10,2,17,151,170,321
2018,10,2,18,112,135,247
2018,10,2,19,68,118,186
2018,10,2,20,57,79,136
2018,10,2,21,35,46,81
2018,10,2,22,15,21,36
2018,10,2,23,12,22,34
2018,10,3,0,2,9,11
2018,10,3,1,7,12,19
2018,10,3,2,8,9,17
2018,10,3,3,21,14,35
2018,10,3,4,115,55,170
2018,10,3,5,243,166,409
2018,10,3,6,450,221,671
2018,10,3,7,281,130,411
2018,10,3,8,224,179,403
2018,10,3,9,224,177,401
2018,10,3,10,208,171,379
2018,10,3,11,234,214,448
2018,10,3,12,227,270,497
2018,10,3,13,254,353,607
2018,10,3,14,270,341,611
2018,10,3,15,194,221,415
2018,10,3,16,170,179,349
2018,10,3,17,173,165,338
2018,10,3,18,113,154,267
2018,10,3,19,100,120,220
2018,10,3,20,77,81,158
2018,10,3,21,33,48,81
2018,10,3,22,25,28,53
2018,10,3,23,12,21,33
2018,10,4,0,5,25,30
2018,10,4,1,11,20,31
2018,10,4,2,10,26,36
2018,10,4,3,28,12,40
2018,10,4,4,106,51,157
2018,10,4,5,218,141,359
2018,10,4,6,426,225,651
2018,10,4,7,296,157,453
2018,10,4,8,209,165,374
2018,10,4,9,197,167,364
2018,10,4,10,213,201,414
2018,10,4,11,208,231,439
2018,10,4,12,235,263,498
2018,10,4,13,276,352,628
2018,10,4,14,252,333,585
2018,10,4,15,215,206,421
2018,10,4,16,217,195,412
2018,10,4,17,171,199,370
2018,10,4,18,104,145,249
2018,10,4,19,108,125,233
2018,10,4,20,55,102,157
2018,10,4,21,25,48,73
2018,10,4,22,22,25,47
2018,10,4,23,10,21,31
2018,10,5,0,14,17,31
2018,10,5,1,5,20,25
2018,10,5,2,6,7,13
2018,10,5,3,25,8,33
2018,10,5,4,114,51,165
2018,10,5,5,245,137,382
2018,10,5,6,410,190,600
2018,10,5,7,262,152,414
2018,10,5,8,257,186,443
2018,10,5,9,259,186,445
2018,10,5,10,238,216,454
2018,10,5,11,227,238,465
2018,10,5,12,272,330,602
2018,10,5,13,253,363,616
2018,10,5,14,220,294,514
2018,10,5,15,152,189,341
2018,10,5,16,167,135,302
2018,10,5,17,108,132,240
2018,10,5,18,109,109,218
2018,10,5,19,78,100,178
2018,10,5,20,57,72,129
2018,10,5,21,37,46,83
2018,10,5,22,30,49,79
2018,10,5,23,27,35,62
2018,10,6,0,14,35,49
2018,10,6,1,12,35,47
2018,10,6,2,9,18,27
2018,10,6,3,14,11,25
2018,10,6,4,20,17,37
2018,10,6,5,25,27,52
2018,10,6,6,40,40,80
2018,10,6,7,59,43,102
2018,10,6,8,87,81,168
2018,10,6,9,114,99,213
2018,10,6,10,153,119,272
2018,10,6,11,149,134,283
2018,10,6,12,145,178,323
2018,10,6,13,140,160,300
2018,10,6,14,137,157,294
2018,10,6,15,128,157,285
2018,10,6,16,128,125,253
2018,10,6,17,94,113,207
2018,10,6,18,89,85,174
2018,10,6,19,58,62,120
2018,10,6,20,61,67,128
2018,10,6,21,30,62,92
2018,10,6,22,36,57,93
2018,10,6,23,25,46,71
2018,10,7,0,23,42,65
2018,10,7,1,18,42,60
2018,10,7,2,14,42,56
2018,10,7,3,7,17,24
2018,10,7,4,17,16,33
2018,10,7,5,17,16,33
2018,10,7,6,28,18,46
2018,10,7,7,41,35,76
2018,10,7,8,87,74,161
2018,10,7,9,90,69,159
2018,10,7,10,128,133,261
2018,10,7,11,129,163,292
2018,10,7,12,163,186,349
2018,10,7,13,143,189,332
2018,10,7,14,131,195,326
2018,10,7,15,126,163,289
2018,10,7,16,144,149,293
2018,10,7,17,141,171,312
2018,10,7,18,79,120,199
2018,10,7,19,74,82,156
2018,10,7,20,100,72,172
2018,10,7,21,34,31,65
2018,10,7,22,16,21,37
2018,10,7,23,5,15,20
2018,10,8,0,4,14,18
2018,10,8,1,6,11,17
2018,10,8,2,12,8,20
2018,10,8,3,25,9,34
2018,10,8,4,109,53,162
2018,10,8,5,201,144,345
2018,10,8,6,273,162,435
2018,10,8,7,237,155,392
2018,10,8,8,213,143,356
2018,10,8,9,221,155,376
2018,10,8,10,190,199,389
2018,10,8,11,192,198,390
2018,10,8,12,199,233,432
2018,10,8,13,187,252,439
2018,10,8,14,205,281,486
2018,10,8,15,154,174,328
2018,10,8,16,156,151,307
2018,10,8,17,82,145,227
2018,10,8,18,85,107,192
2018,10,8,19,57,100,157
2018,10,8,20,51,313,364
2018,10,8,21,28,151,179
2018,10,8,22,16,76,92
2018,10,8,23,15,47,62
2018,10,9,0,2,25,27
2018,10,9,1,5,29,34
2018,10,9,2,5,36,41
2018,10,9,3,23,22,45
2018,10,9,4,103,50,153
2018,10,9,5,228,143,371
2018,10,9,6,284,166,450
2018,10,9,7,244,146,390
2018,10,9,8,242,154,396
2018,10,9,9,199,161,360
2018,10,9,10,218,176,394
2018,10,9,11,195,202,397
2018,10,9,12,189,265,454
2018,10,9,13,215,247,462
2018,10,9,14,209,303,512
2018,10,9,15,188,176,364
2018,10,9,16,172,156,328
2018,10,9,17,126,139,265
2018,10,9,18,105,119,224
2018,10,9,19,89,108,197
2018,10,9,20,54,262,316
2018,10,9,21,31,135,166
2018,10,9,22,16,58,74
2018,10,9,23,11,22,33
2018,10,10,0,4,13,17
2018,10,10,1,6,18,24
2018,10,10,2,7,18,25
2018,10,10,3,20,12,32
2018,10,10,4,102,48,150
2018,10,10,5,245,134,379
2018,10,10,6,295,157,452
2018,10,10,7,221,150,371
2018,10,10,8,235,166,401
2018,10,10,9,191,165,356
2018,10,10,10,219,183,402
2018,10,10,11,220,214,434
2018,10,10,12,184,281,465
2018,10,10,13,252,273,525
2018,10,10,14,185,254,439
2018,10,10,15,162,188,350
2018,10,10,16,156,169,325
2018,10,10,17,113,130,243
2018,10,10,18,103,120,223
2018,10,10,19,74,101,175
2018,10,10,20,50,87,137
2018,10,10,21,22,48,70
2018,10,10,22,19,56,75
2018,10,10,23,14,70,84
2018,10,11,0,10,27,37
2018,10,11,1,10,28,38
2018,10,11,2,7,31,38
2018,10,11,3,20,38,58
2018,10,11,4,97,36,133
2018,10,11,5,206,131,337
2018,10,11,6,244,151,395
2018,10,11,7,199,138,337
2018,10,11,8,193,151,344
2018,10,11,9,223,157,380
2018,10,11,10,193,214,407
2018,10,11,11,206,211,417
2018,10,11,12,200,231,431
2018,10,11,13,314,323,637
2018,10,11,14,258,382,640
2018,10,11,15,154,166,320
2018,10,11,16,121,159,280
2018,10,11,17,112,135,247
2018,10,11,18,97,114,211
2018,10,11,19,80,91,171
2018,10,11,20,49,77,126
2018,10,11,21,22,46,68
2018,10,11,22,24,29,53
2018,10,11,23,19,23,42
2018,10,12,0,9,28,37
2018,10,12,1,12,18,30
2018,10,12,2,14,18,32
2018,10,12,3,20,18,38
2018,10,12,4,81,49,130
2018,10,12,5,173,113,286
2018,10,12,6,262,121,383
2018,10,12,7,201,123,324
2018,10,12,8,213,137,350
2018,10,12,9,205,173,378
2018,10,12,10,189,205,394
2018,10,12,11,215,194,409
2018,10,12,12,238,256,494
2018,10,12,13,234,313,547
2018,10,12,14,205,274,479
2018,10,12,15,145,182,327
2018,10,12,16,106,126,232
2018,10,12,17,112,117,229
2018,10,12,18,88,98,186
2018,10,12,19,64,68,132
2018,10,12,20,54,68,122
2018,10,12,21,33,54,87
2018,10,12,22,34,49,83
2018,10,12,23,26,51,77
2018,10,13,0,29,38,67
2018,10,13,1,12,38,50
2018,10,13,2,13,26,39
2018,10,13,3,13,8,21
2018,10,13,4,26,13,39
2018,10,13,5,19,27,46
2018,10,13,6,18,26,44
2018,10,13,7,63,40,103
2018,10,13,8,88,66,154
2018,10,13,9,107,88,195
2018,10,13,10,139,124,263
2018,10,13,11,164,120,284
2018,10,13,12,152,174,326
2018,10,13,13,142,178,320
2018,10,13,14,128,153,281
2018,10,13,15,131,142,273
2018,10,13,16,127,113,240
2018,10,13,17,89,106,195
2018,10,13,18,93,87,180
2018,10,13,19,50,69,119
2018,10,13,20,48,61,109
2018,10,13,21,41,54,95
2018,10,13,22,35,61,96
2018,10,13,23,23,47,70
2018,10,14,0,27,48,75
2018,10,14,1,33,65,98
2018,10,14,2,16,45,61
2018,10,14,3,21,16,37
2018,10,14,4,17,13,30
2018,10,14,5,9,14,23
2018,10,14,6,30,20,50
2018,10,14,7,47,28,75
2018,10,14,8,110,64,174
2018,10,14,9,99,69,168
2018,10,14,10,131,107,238
2018,10,14,11,129,154,283
2018,10,14,12,146,150,296
2018,10,14,13,135,165,300
2018,10,14,14,154,208,362
2018,10,14,15,165,171,336
2018,10,14,16,154,155,309
2018,10,14,17,124,129,253
2018,10,14,18,108,134,242
2018,10,14,19,59,89,148
2018,10,14,20,51,47,98
2018,10,14,21,20,41,61
2018,10,14,22,8,14,22
2018,10,14,23,5,10,15
2018,10,15,0,5,14,19
2018,10,15,1,9,9,18
2018,10,15,2,11,12,23
2018,10,15,3,18,12,30
2018,10,15,4,121,56,177
2018,10,15,5,236,150,386
2018,10,15,6,384,195,579
2018,10,15,7,244,145,389
2018,10,15,8,221,166,387
2018,10,15,9,217,158,375
2018,10,15,10,210,195,405
2018,10,15,11,209,179,388
2018,10,15,12,181,231,412
2018,10,15,13,237,297,534
2018,10,15,14,203,285,488
2018,10,15,15,192,214,406
2018,10,15,16,175,156,331
2018,10,15,17,131,158,289
2018,10,15,18,106,158,264
2018,10,15,19,78,115,193
2018,10,15,20,67,79,146
2018,10,15,21,42,39,81
2018,10,15,22,9,19,28
2018,10,15,23,12,8,20
2018,10,16,0,15,9,24
2018,10,16,1,15,13,28
2018,10,16,2,12,12,24
2018,10,16,3,21,14,35
2018,10,16,4,108,50,158
2018,10,16,5,237,134,371
2018,10,16,6,376,194,570
2018,10,16,7,270,182,452
2018,10,16,8,209,160,369
2018,10,16,9,216,182,398
2018,10,16,10,189,215,404
2018,10,16,11,193,203,396
2018,10,16,12,203,233,436
2018,10,16,13,242,300,542
2018,10,16,14,228,288,516
2018,10,16,15,192,175,367
2018,10,16,16,158,147,305
2018,10,16,17,136,148,284
2018,10,16,18,109,135,244
2018,10,16,19,72,122,194
2018,10,16,20,49,107,156
2018,10,16,21,27,44,71
2018,10,16,22,19,11,30
2018,10,16,23,10,19,29
2018,10,17,0,9,13,22
2018,10,17,1,16,20,36
2018,10,17,2,10,13,23
2018,10,17,3,16,16,32
2018,10,17,4,113,47,160
2018,10,17,5,235,149,384
2018,10,17,6,401,208,609
2018,10,17,7,291,162,453
2018,10,17,8,192,158,350
2018,10,17,9,224,156,380
2018,10,17,10,209,196,405
2018,10,17,11,212,210,422
2018,10,17,12,190,247,437
2018,10,17,13,245,313,558
2018,10,17,14,230,292,522
2018,10,17,15,214,210,424
2018,10,17,16,176,162,338
2018,10,17,17,134,149,283
2018,10,17,18,123,121,244
2018,10,17,19,81,122,203
2018,10,17,20,51,95,146
2018,10,17,21,16,45,61
2018,10,17,22,15,25,40
2018,10,17,23,14,19,33
2018,10,18,0,13,19,32
2018,10,18,1,10,12,22
2018,10,18,2,7,10,17
2018,10,18,3,21,9,30
2018,10,18,4,100,65,165
2018,10,18,5,231,143,374
2018,10,18,6,398,202,600
2018,10,18,7,258,171,429
2018,10,18,8,230,175,405
2018,10,18,9,224,158,382
2018,10,18,10,219,218,437
2018,10,18,11,200,222,422
2018,10,18,12,226,267,493
2018,10,18,13,236,302,538
2018,10,18,14,250,322,572
2018,10,18,15,198,186,384
2018,10,18,16,208,174,382
2018,10,18,17,146,161,307
2018,10,18,18,109,115,224
2018,10,18,19,63,86,149
2018,10,18,20,68,285,353
2018,10,18,21,41,183,224
2018,10,18,22,19,73,92
2018,10,18,23,13,64,77
2018,10,19,0,8,52,60
2018,10,19,1,12,41,53
2018,10,19,2,10,20,30
2018,10,19,3,24,17,41
2018,10,19,4,103,54,157
2018,10,19,5,239,128,367
2018,10,19,6,383,181,564
2018,10,19,7,237,160,397
2018,10,19,8,229,156,385
2018,10,19,9,233,192,425
2018,10,19,10,225,200,425
2018,10,19,11,227,251,478
2018,10,19,12,221,311,532
2018,10,19,13,238,333,571
2018,10,19,14,197,271,468
2018,10,19,15,160,180,340
2018,10,19,16,175,164,339
2018,10,19,17,128,147,275
2018,10,19,18,104,134,238
2018,10,19,19,69,86,155
2018,10,19,20,64,69,133
2018,10,19,21,52,73,125
2018,10,19,22,26,53,79
2018,10,19,23,32,45,77
2018,10,20,0,15,26,41
2018,10,20,1,13,37,50
2018,10,20,2,13,22,35
2018,10,20,3,7,12,19
2018,10,20,4,26,11,37
2018,10,20,5,23,28,51
2018,10,20,6,31,26,57
2018,10,20,7,68,54,122
2018,10,20,8,107,69,176
2018,10,20,9,161,122,283
2018,10,20,10,172,129,301
2018,10,20,11,143,159,302
2018,10,20,12,148,176,324
2018,10,20,13,155,162,317
2018,10,20,14,142,193,335
2018,10,20,15,128,149,277
2018,10,20,16,130,141,271
2018,10,20,17,117,119,236
2018,10,20,18,95,95,190
2018,10,20,19,74,71,145
2018,10,20,20,45,85,130
2018,10,20,21,52,70,122
2018,10,20,22,41,74,115
2018,10,20,23,35,52,87
2018,10,21,0,28,48,76
2018,10,21,1,31,59,90
2018,10,21,2,19,43,62
2018,10,21,3,12,14,26
2018,10,21,4,19,15,34
2018,10,21,5,18,24,42
2018,10,21,6,67,13,80
2018,10,21,7,71,36,107
2018,10,21,8,103,73,176
2018,10,21,9,124,93,217
2018,10,21,10,181,176,357
2018,10,21,11,138,202,340
2018,10,21,12,169,183,352
2018,10,21,13,166,197,363
2018,10,21,14,175,239,414
2018,10,21,15,165,149,314
2018,10,21,16,163,145,308
2018,10,21,17,129,141,270
2018,10,21,18,103,127,230
2018,10,21,19,73,93,166
2018,10,21,20,54,70,124
2018,10,21,21,23,35,58
2018,10,21,22,15,21,36
2018,10,21,23,14,12,26
2018,10,22,0,6,15,21
2018,10,22,1,5,13,18
2018,10,22,2,3,3,6
2018,10,22,3,27,10,37
2018,10,22,4,103,56,159
2018,10,22,5,223,138,361
2018,10,22,6,402,195,597
2018,10,22,7,247,136,383
2018,10,22,8,195,150,345
2018,10,22,9,209,173,382
2018,10,22,10,205,191,396
2018,10,22,11,196,231,427
2018,10,22,12,197,243,440
2018,10,22,13,229,313,542
2018,10,22,14,251,313,564
2018,10,22,15,216,185,401
2018,10,22,16,166,165,331
2018,10,22,17,128,145,273
2018,10,22,18,109,126,235
2018,10,22,19,76,90,166
2018,10,22,20,50,76,126
2018,10,22,21,24,41,65
2018,10,22,22,17,14,31
2018,10,22,23,10,15,25
2018,10,23,0,3,6,9
2018,10,23,1,7,6,13
2018,10,23,2,6,7,13
2018,10,23,3,20,15,35
2018,10,23,4,108,48,156
2018,10,23,5,233,145,378
2018,10,23,6,404,193,597
2018,10,23,7,270,149,419
2018,10,23,8,223,160,383
2018,10,23,9,217,167,384
2018,10,23,10,221,192,413
2018,10,23,11,216,199,415
2018,10,23,12,245,259,504
2018,10,23,13,226,293,519
2018,10,23,14,218,310,528
2018,10,23,15,186,161,347
2018,10,23,16,203,143,346
2018,10,23,17,141,152,293
2018,10,23,18,95,113,208
2018,10,23,19,89,121,210
2018,10,23,20,60,83,143
2018,10,23,21,26,83,109
2018,10,23,22,18,46,64
2018,10,23,23,11,22,33
2018,10,24,0,6,12,18
2018,10,24,1,7,9,16
2018,10,24,2,9,11,20
2018,10,24,3,20,11,31
2018,10,24,4,106,59,165
2018,10,24,5,238,144,382
2018,10,24,6,405,170,575
2018,10,24,7,262,145,407
2018,10,24,8,222,155,377
2018,10,24,9,197,167,364
2018,10,24,10,199,219,418
2018,10,24,11,209,182,391
2018,10,24,12,229,242,471
2018,10,24,13,250,318,568
2018,10,24,14,231,304,535
2018,10,24,15,193,199,392
2018,10,24,16,159,152,311
2018,10,24,17,135,132,267
2018,10,24,18,120,139,259
2018,10,24,19,65,102,167
2018,10,24,20,37,78,115
2018,10,24,21,35,40,75
2018,10,24,22,17,10,27
2018,10,24,23,12,20,32
2018,10,25,0,7,13,20
2018,10,25,1,8,10,18
2018,10,25,2,6,10,16
2018,10,25,3,17,10,27
2018,10,25,4,119,45,164
2018,10,25,5,226,145,371
2018,10,25,6,400,186,586
2018,10,25,7,242,148,390
2018,10,25,8,220,151,371
2018,10,25,9,225,171,396
2018,10,25,10,208,200,408
2018,10,25,11,236,209,445
2018,10,25,12,195,251,446
2018,10,25,13,254,299,553
2018,10,25,14,230,304,534
2018,10,25,15,195,190,385
2018,10,25,16,200,173,373
2018,10,25,17,150,142,292
2018,10,25,18,96,104,200
2018,10,25,19,76,105,181
2018,10,25,20,59,78,137
2018,10,25,21,37,57,94
2018,10,25,22,22,30,52
2018,10,25,23,17,22,39
2018,10,26,0,6,23,29
2018,10,26,1,6,24,30
2018,10,26,2,9,18,27
2018,10,26,3,27,13,40
2018,10,26,4,107,54,161
2018,10,26,5,229,139,368
2018,10,26,6,360,152,512
2018,10,26,7,257,157,414
2018,10,26,8,234,150,384
2018,10,26,9,232,191,423
2018,10,26,10,217,238,455
2018,10,26,11,236,222,458
2018,10,26,12,245,272,517
2018,10,26,13,271,335,606
2018,10,26,14,206,272,478
2018,10,26,15,171,161,332
2018,10,26,16,133,162,295
2018,10,26,17,113,173,286
2018,10,26,18,96,110,206
2018,10,26,19,75,84,159
2018,10,26,20,41,72,113
2018,10,26,21,52,63,115
2018,10,26,22,35,49,84
2018,10,26,23,29,46,75
2018,10,27,0,22,28,50
2018,10,27,1,19,42,61
2018,10,27,2,14,15,29
2018,10,27,3,12,16,28
2018,10,27,4,24,11,35
2018,10,27,5,26,21,47
2018,10,27,6,49,42,91
2018,10,27,7,87,54,141
2018,10,27,8,107,86,193
2018,10,27,9,160,118,278
2018,10,27,10,195,141,336
2018,10,27,11,170,160,330
2018,10,27,12,164,202,366
2018,10,27,13,153,245,398
2018,10,27,14,163,197,360
2018,10,27,15,143,160,303
2018,10,27,16,158,148,306
2018,10,27,17,105,134,239
2018,10,27,18,100,97,197
2018,10,27,19,49,73,122
2018,10,27,20,53,82,135
2018,10,27,21,49,70,119
2018,10,27,22,46,65,111
2018,10,27,23,31,44,75
2018,10,28,0,22,47,69
2018,10,28,1,29,64,93
2018,10,28,2,20,36,56
2018,10,28,3,16,21,37
2018,10,28,4,15,14,29
2018,10,28,5,19,12,31
2018,10,28,6,15,16,31
2018,10,28,7,35,20,55
2018,10,28,8,47,31,78
2018,10,28,9,117,69,186
2018,10,28,10,120,92,212
2018,10,28,11,141,148,289
2018,10,28,12,157,200,357
2018,10,28,13,186,196,382
2018,10,28,14,160,206,366
2018,10,28,15,172,200,372
2018,10,28,16,147,198,345
2018,10,28,17,162,168,330
2018,10,28,18,132,173,305
2018,10,28,19,62,92,154
2018,10,28,20,55,73,128
2018,10,28,21,135,79,214
2018,10,28,22,27,32,59
2018,10,28,23,16,22,38
2018,10,29,0,15,13,28
2018,10,29,1,2,8,10
2018,10,29,2,5,9,14
2018,10,29,3,7,8,15
2018,10,29,4,26,13,39
2018,10,29,5,113,59,172
2018,10,29,6,230,144,374
2018,10,29,7,379,165,544
2018,10,29,8,243,176,419
2018,10,29,9,198,145,343
2018,10,29,10,213,191,404
2018,10,29,11,204,213,417
2018,10,29,12,222,222,444
2018,10,29,13,225,242,467
2018,10,29,14,216,292,508
2018,10,29,15,210,310,520
2018,10,29,16,175,177,352
2018,10,29,17,165,164,329
2018,10,29,18,114,119,233
2018,10,29,19,94,127,221
2018,10,29,20,82,103,185
2018,10,29,21,55,65,120
2018,10,29,22,24,27,51
2018,10,29,23,10,21,31
2018,10,30,0,8,19,27
2018,10,30,1,4,5,9
2018,10,30,2,5,8,13
2018,10,30,3,5,6,11
2018,10,30,4,24,13,37
2018,10,30,5,132,54,186
2018,10,30,6,227,146,373
2018,10,30,7,395,202,597
2018,10,30,8,258,149,407
2018,10,30,9,236,185,421
2018,10,30,10,182,183,365
2018,10,30,11,224,199,423
2018,10,30,12,210,186,396
2018,10,30,13,235,264,499
2018,10,30,14,216,281,497
2018,10,30,15,202,290,492
2018,10,30,16,179,188,367
2018,10,30,17,177,141,318
2018,10,30,18,134,139,273
2018,10,30,19,95,126,221
2018,10,30,20,68,86,154
2018,10,30,21,42,94,136
2018,10,30,22,23,36,59
2018,10,30,23,14,18,32
2018,10,31,0,9,16,25
2018,10,31,1,9,10,19
2018,10,31,2,15,14,29
2018,10,31,3,13,8,21
2018,10,31,4,16,9,25
2018,10,31,5,121,47,168
2018,10,31,6,227,141,368
2018,10,31,7,406,217,623
2018,10,31,8,228,144,372
2018,10,31,9,220,170,390
2018,10,31,10,224,154,378
2018,10,31,11,226,184,410
2018,10,31,12,222,216,438
2018,10,31,13,228,255,483
2018,10,31,14,257,298,555
2018,10,31,15,216,288,504
2018,10,31,16,209,182,391
2018,10,31,17,205,175,380
2018,10,31,18,121,161,282
2018,10,31,19,105,151,256
2018,10,31,20,70,112,182
2018,10,31,21,51,78,129
2018,10,31,22,40,56,96
2018,10,31,23,18,26,44
2018,11,1,0,12,23,35
2018,11,1,1,20,28,48
2018,11,1,2,9,14,23
2018,11,1,3,8,19,27
2018,11,1,4,20,14,34
2018,11,1,5,128,48,176
2018,11,1,6,230,153,383
2018,11,1,7,445,211,656
2018,11,1,8,257,172,429
2018,11,1,9,203,175,378
2018,11,1,10,234,198,432
2018,11,1,11,220,218,438
2018,11,1,12,237,230,467
2018,11,1,13,238,300,538
2018,11,1,14,266,318,584
2018,11,1,15,221,309,530
2018,11,1,16,205,205,410
2018,11,1,17,203,180,383
2018,11,1,18,136,156,292
2018,11,1,19,117,127,244
2018,11,1,20,71,120,191
2018,11,1,21,64,101,165
2018,11,1,22,33,53,86
2018,11,1,23,12,26,38
2018,11,2,0,19,33,52
2018,11,2,1,14,22,36
2018,11,2,2,14,11,25
2018,11,2,3,10,13,23
2018,11,2,4,18,17,35
2018,11,2,5,128,60,188
2018,11,2,6,211,128,339
2018,11,2,7,418,196,614
2018,11,2,8,256,158,414
2018,11,2,9,236,158,394
2018,11,2,10,230,192,422
2018,11,2,11,228,260,488
2018,11,2,12,242,240,482
2018,11,2,13,251,278,529
2018,11,2,14,265,371,636
2018,11,2,15,192,277,469
2018,11,2,16,200,184,384
2018,11,2,17,180,151,331
2018,11,2,18,113,126,239
2018,11,2,19,95,125,220
2018,11,2,20,66,82,148
2018,11,2,21,61,66,127
2018,11,2,22,35,52,87
2018,11,2,23,26,44,70
2018,11,3,0,25,29,54
2018,11,3,1,19,27,46
2018,11,3,2,19,46,65
2018,11,3,3,15,20,35
2018,11,3,4,13,11,24
2018,11,3,5,25,10,35
2018,11,3,6,24,20,44
2018,11,3,7,43,31,74
2018,11,3,8,61,47,108
2018,11,3,9,128,80,208
2018,11,3,10,160,112,272
2018,11,3,11,202,160,362
2018,11,3,12,207,184,391
2018,11,3,13,161,225,386
2018,11,3,14,141,250,391
2018,11,3,15,164,210,374
2018,11,3,16,150,144,294
2018,11,3,17,151,166,317
2018,11,3,18,84,117,201
2018,11,3,19,72,75,147
2018,11,3,20,49,85,134
2018,11,3,21,48,67,115
2018,11,3,22,52,70,122
2018,11,3,23,47,62,109
2018,11,4,0,46,61,107
2018,11,4,1,26,48,74
2018,11,4,2,27,50,77
2018,11,4,3,13,34,47
2018,11,4,4,15,22,37
2018,11,4,5,21,19,40
2018,11,4,6,13,12,25
2018,11,4,7,30,12,42
2018,11,4,8,54,19,73
2018,11,4,9,116,67,183
2018,11,4,10,102,92,194
2018,11,4,11,146,155,301
2018,11,4,12,149,198,347
2018,11,4,13,200,198,398
2018,11,4,14,190,208,398
2018,11,4,15,204,241,445
2018,11,4,16,258,164,422
2018,11,4,17,146,216,362
2018,11,4,18,131,247,378
2018,11,4,19,93,128,221
2018,11,4,20,71,94,165
2018,11,4,21,101,61,162
2018,11,4,22,26,27,53
2018,11,4,23,15,33,48
2018,11,5,0,6,14,20
2018,11,5,1,4,8,12
2018,11,5,2,6,12,18
2018,11,5,3,10,5,15
2018,11,5,4,22,15,37
2018,11,5,5,117,44,161
2018,11,5,6,231,147,378
2018,11,5,7,401,191,592
2018,11,5,8,240,185,425
2018,11,5,9,200,138,338
2018,11,5,10,216,175,391
2018,11,5,11,226,184,410
2018,11,5,12,213,200,413
2018,11,5,13,207,218,425
2018,11,5,14,238,322,560
2018,11,5,15,220,300,520
2018,11,5,16,191,195,386
2018,11,5,17,138,181,319
2018,11,5,18,129,141,270
2018,11,5,19,95,129,224
2018,11,5,20,79,86,165
2018,11,5,21,51,90,141
2018,11,5,22,17,34,51
2018,11,5,23,15,21,36
2018,11,6,0,13,15,28
2018,11,6,1,7,7,14
2018,11,6,2,3,11,14
2018,11,6,3,8,8,16
2018,11,6,4,25,17,42
2018,11,6,5,131,54,185
2018,11,6,6,219,126,345
2018,11,6,7,385,189,574
2018,11,6,8,265,182,447
2018,11,6,9,228,171,399
2018,11,6,10,208,170,378
2018,11,6,11,198,188,386
2018,11,6,12,228,181,409
2018,11,6,13,227,259,486
2018,11,6,14,247,324,571
2018,11,6,15,225,318,543
2018,11,6,16,213,198,411
2018,11,6,17,173,135,308
2018,11,6,18,144,137,281
2018,11,6,19,75,134,209
2018,11,6,20,58,127,185
2018,11,6,21,54,80,134
2018,11,6,22,33,39,72
2018,11,6,23,16,13,29
2018,11,7,0,14,21,35
2018,11,7,1,11,16,27
2018,11,7,2,13,9,22
2018,11,7,3,13,10,23
2018,11,7,4,18,9,27
2018,11,7,5,127,45,172
2018,11,7,6,227,131,358
2018,11,7,7,398,182,580
2018,11,7,8,269,150,419
2018,11,7,9,208,146,354
2018,11,7,10,189,187,376
2018,11,7,11,217,201,418
2018,11,7,12,200,209,409
2018,11,7,13,217,244,461
2018,11,7,14,242,281,523
2018,11,7,15,206,276,482
2018,11,7,16,175,190,365
2018,11,7,17,205,168,373
2018,11,7,18,147,158,305
2018,11,7,19,113,143,256
2018,11,7,20,70,115,185
2018,11,7,21,48,93,141
2018,11,7,22,30,47,77
2018,11,7,23,15,35,50
2018,11,8,0,10,28,38
2018,11,8,1,12,27,39
2018,11,8,2,8,16,24
2018,11,8,3,8,16,24
2018,11,8,4,25,19,44
2018,11,8,5,113,52,165
2018,11,8,6,251,141,392
2018,11,8,7,385,184,569
2018,11,8,8,278,135,413
2018,11,8,9,218,174,392
2018,11,8,10,209,189,398
2018,11,8,11,211,203,414
2018,11,8,12,210,228,438
2018,11,8,13,229,234,463
2018,11,8,14,265,321,586
2018,11,8,15,204,284,488
2018,11,8,16,176,194,370
2018,11,8,17,199,151,350
2018,11,8,18,133,153,286
2018,11,8,19,88,103,191
2018,11,8,20,90,106,196
2018,11,8,21,74,65,139
2018,11,8,22,48,52,100
2018,11,8,23,29,29,58
2018,11,9,0,15,10,25
2018,11,9,1,19,39,58
2018,11,9,2,14,32,46
2018,11,9,3,9,29,38
2018,11,9,4,26,18,44
2018,11,9,5,95,49,144
2018,11,9,6,250,117,367
2018,11,9,7,302,179,481
2018,11,9,8,252,162,414
2018,11,9,9,220,174,394
2018,11,9,10,285,188,473
2018,11,9,11,224,223,447
2018,11,9,12,254,238,492
2018,11,9,13,264,308,572
2018,11,9,14,261,326,587
2018,11,9,15,214,285,499
2018,11,9,16,144,195,339
2018,11,9,17,148,165,313
2018,11,9,18,116,123,239
2018,11,9,19,88,104,192
2018,11,9,20,68,76,144
2018,11,9,21,43,63,106
2018,11,9,22,56,69,125
2018,11,9,23,33,50,83
2018,11,10,0,20,29,49
2018,11,10,1,17,35,52
2018,11,10,2,13,33,46
2018,11,10,3,10,21,31
2018,11,10,4,14,10,24
2018,11,10,5,25,14,39
2018,11,10,6,54,31,85
2018,11,10,7,117,61,178
2018,11,10,8,83,54,137
2018,11,10,9,139,80,219
2018,11,10,10,183,118,301
2018,11,10,11,164,159,323
2018,11,10,12,178,199,377
2018,11,10,13,162,196,358
2018,11,10,14,156,265,421
2018,11,10,15,155,195,350
2018,11,10,16,133,176,309
2018,11,10,17,136,138,274
2018,11,10,18,108,132,240
2018,11,10,19,64,96,160
2018,11,10,20,51,63,114
2018,11,10,21,49,62,111
2018,11,10,22,68,73,141
2018,11,10,23,31,54,85
2018,11,11,0,35,50,85
2018,11,11,1,34,59,93
2018,11,11,2,26,57,83
2018,11,11,3,20,38,58
2018,11,11,4,11,24,35
2018,11,11,5,13,14,27
2018,11,11,6,12,14,26
2018,11,11,7,36,15,51
2018,11,11,8,72,30,102
2018,11,11,9,100,72,172
2018,11,11,10,109,83,192
2018,11,11,11,175,138,313
2018,11,11,12,157,195,352
2018,11,11,13,199,178,377
2018,11,11,14,153,234,387
2018,11,11,15,132,214,346
2018,11,11,16,178,194,372
2018,11,11,17,118,118,236
2018,11,11,18,120,144,264
2018,11,11,19,112,136,248
2018,11,11,20,79,91,170
2018,11,11,21,55,61,116
2018,11,11,22,36,43,79
2018,11,11,23,16,19,35
2018,11,12,0,15,19,34
2018,11,12,1,8,9,17
2018,11,12,2,9,16,25
2018,11,12,3,13,8,21
2018,11,12,4,16,10,26
2018,11,12,5,135,46,181
2018,11,12,6,221,125,346
2018,11,12,7,429,204,633
2018,11,12,8,273,191,464
2018,11,12,9,218,173,391
2018,11,12,10,200,166,366
2018,11,12,11,200,197,397
2018,11,12,12,215,196,411
2018,11,12,13,216,255,471
2018,11,12,14,251,300,551
2018,11,12,15,225,296,521
2018,11,12,16,175,197,372
2018,11,12,17,152,141,293
2018,11,12,18,133,136,269
2018,11,12,19,82,112,194
2018,11,12,20,71,98,169
2018,11,12,21,60,51,111
2018,11,12,22,34,40,74
2018,11,12,23,14,18,32
2018,11,13,0,8,12,20
2018,11,13,1,7,15,22
2018,11,13,2,11,20,31
2018,11,13,3,5,17,22
2018,11,13,4,28,17,45
2018,11,13,5,122,48,170
2018,11,13,6,251,131,382
2018,11,13,7,415,203,618
2018,11,13,8,258,157,415
2018,11,13,9,225,168,393
2018,11,13,10,231,172,403
2018,11,13,11,208,181,389
2018,11,13,12,196,192,388
2018,11,13,13,192,248,440
2018,11,13,14,274,338,612
2018,11,13,15,200,317,517
2018,11,13,16,188,211,399
2018,11,13,17,143,153,296
2018,11,13,18,154,142,296
2018,11,13,19,109,121,230
2018,11,13,20,84,104,188
2018,11,13,21,65,117,182
2018,11,13,22,36,37,73
2018,11,13,23,16,24,40
2018,11,14,0,11,12,23
2018,11,14,1,3,13,16
2018,11,14,2,5,7,12
2018,11,14,3,4,8,12
2018,11,14,4,13,16,29
2018,11,14,5,118,57,175
2018,11,14,6,235,134,369
2018,11,14,7,388,200,588
2018,11,14,8,262,159,421
2018,11,14,9,239,161,400
2018,11,14,10,213,173,386
2018,11,14,11,215,185,400
2018,11,14,12,216,210,426
2018,11,14,13,226,252,478
2018,11,14,14,253,296,549
2018,11,14,15,261,308,569
2018,11,14,16,209,238,447
2018,11,14,17,167,178,345
2018,11,14,18,130,125,255
2018,11,14,19,112,112,224
2018,11,14,20,81,103,184
2018,11,14,21,57,74,131
2018,11,14,22,36,44,80
2018,11,14,23,22,22,44
2018,11,15,0,9,23,32
2018,11,15,1,10,19,29
2018,11,15,2,12,23,35
2018,11,15,3,9,10,19
2018,11,15,4,31,13,44
2018,11,15,5,110,52,162
2018,11,15,6,214,120,334
2018,11,15,7,393,204,597
2018,11,15,8,247,167,414
2018,11,15,9,223,166,389
2018,11,15,10,189,184,373
2018,11,15,11,182,213,395
2018,11,15,12,216,173,389
2018,11,15,13,230,257,487
2018,11,15,14,295,288,583
2018,11,15,15,243,346,589
2018,11,15,16,187,200,387
2018,11,15,17,185,160,345
2018,11,15,18,133,140,273
2018,11,15,19,106,131,237
2018,11,15,20,82,109,191
2018,11,15,21,49,96,145
2018,11,15,22,33,46,79
2018,11,15,23,14,34,48
2018,11,16,0,11,25,36
2018,11,16,1,9,29,38
2018,11,16,2,15,36,51
2018,11,16,3,9,16,25
2018,11,16,4,28,11,39
2018,11,16,5,120,57,177
2018,11,16,6,242,122,364
2018,11,16,7,392,180,572
2018,11,16,8,262,158,420
2018,11,16,9,193,176,369
2018,11,16,10,231,186,417
2018,11,16,11,235,210,445
2018,11,16,12,225,201,426
2018,11,16,13,235,291,526
2018,11,16,14,276,325,601
2018,11,16,15,178,252,430
2018,11,16,16,152,195,347
2018,11,16,17,167,143,310
2018,11,16,18,129,123,252
2018,11,16,19,98,95,193
2018,11,16,20,69,88,157
2018,11,16,21,49,71,120
2018,11,16,22,47,77,124
2018,11,16,23,29,67,96
2018,11,17,0,22,51,73
2018,11,17,1,15,33,48
2018,11,17,2,11,35,46
2018,11,17,3,12,31,43
2018,11,17,4,12,18,30
2018,11,17,5,28,12,40
2018,11,17,6,28,24,52
2018,11,17,7,43,28,71
2018,11,17,8,66,45,111
2018,11,17,9,108,68,176
2018,11,17,10,121,67,188
2018,11,17,11,131,113,244
2018,11,17,12,165,159,324
2018,11,17,13,160,174,334
2018,11,17,14,150,188,338
2018,11,17,15,137,175,312
2018,11,17,16,158,168,326
2018,11,17,17,130,117,247
2018,11,17,18,114,103,217
2018,11,17,19,66,87,153
2018,11,17,20,56,69,125
2018,11,17,21,46,67,113
2018,11,17,22,51,75,126
2018,11,17,23,41,49,90
2018,11,18,0,33,45,78
2018,11,18,1,35,57,92
2018,11,18,2,27,64,91
2018,11,18,3,17,36,53
2018,11,18,4,17,17,34
2018,11,18,5,21,14,35
2018,11,18,6,21,19,40
2018,11,18,7,23,17,40
2018,11,18,8,71,25,96
2018,11,18,9,116,62,178
2018,11,18,10,100,85,185
2018,11,18,11,163,151,314
2018,11,18,12,150,191,341
2018,11,18,13,189,184,373
2018,11,18,14,176,195,371
2018,11,18,15,168,207,375
2018,11,18,16,121,149,270
2018,11,18,17,152,135,287
2018,11,18,18,128,147,275
2018,11,18,19,116,149,265
2018,11,18,20,74,78,152
2018,11,18,21,55,76,131
2018,11,18,22,28,40,68
2018,11,18,23,11,17,28
2018,11,19,0,11,18,29
2018,11,19,1,9,10,19
2018,11,19,2,9,11,20
2018,11,19,3,7,13,20
2018,11,19,4,30,7,37
2018,11,19,5,123,54,177
2018,11,19,6,207,131,338
2018,11,19,7,393,202,595
2018,11,19,8,267,176,443
2018,11,19,9,196,136,332
2018,11,19,10,180,157,337
2018,11,19,11,200,179,379
2018,11,19,12,193,208,401
2018,11,19,13,223,236,459
2018,11,19,14,224,287,511
2018,11,19,15,199,292,491
2018,11,19,16,174,181,355
2018,11,19,17,162,161,323
2018,11,19,18,136,140,276
2018,11,19,19,116,137,253
2018,11,19,20,61,88,149
2018,11,19,21,53,67,120
2018,11,19,22,34,43,77
2018,11,19,23,19,22,41
2018,11,20,0,6,14,20
2018,11,20,1,4,10,14
2018,11,20,2,6,12,18
2018,11,20,3,5,4,9
2018,11,20,4,21,11,32
2018,11,20,5,109,46,155
2018,11,20,6,213,140,353
2018,11,20,7,403,192,595
2018,11,20,8,251,190,441
2018,11,20,9,224,163,387
2018,11,20,10,204,172,376
2018,11,20,11,196,187,383
2018,11,20,12,211,187,398
2018,11,20,13,214,251,465
2018,11,20,14,254,301,555
2018,11,20,15,205,305,510
2018,11,20,16,192,189,381
2018,11,20,17,175,159,334
2018,11,20,18,140,121,261
2018,11,20,19,105,108,213
2018,11,20,20,75,108,183
2018,11,20,21,59,98,157
2018,11,20,22,21,36,57
2018,11,20,23,14,23,37
2018,11,21,0,8,10,18
2018,11,21,1,11,15,26
2018,11,21,2,5,11,16
2018,11,21,3,8,16,24
2018,11,21,4,17,8,25
2018,11,21,5,109,48,157
2018,11,21,6,225,111,336
2018,11,21,7,420,207,627
2018,11,21,8,241,166,407
2018,11,21,9,237,171,408
2018,11,21,10,214,187,401
2018,11,21,11,203,174,377
2018,11,21,12,222,189,411
2018,11,21,13,207,251,458
2018,11,21,14,235,280,515
2018,11,21,15,207,323,530
2018,11,21,16,210,197,407
2018,11,21,17,162,158,320
2018,11,21,18,133,147,280
2018,11,21,19,107,150,257
2018,11,21,20,79,98,177
2018,11,21,21,50,288,338
2018,11,21,22,27,138,165
2018,11,21,23,19,61,80
2018,11,22,0,11,34,45
2018,11,22,1,13,17,30
2018,11,22,2,7,19,26
2018,11,22,3,8,9,17
2018,11,22,4,26,11,37
2018,11,22,5,112,45,157
2018,11,22,6,205,111,316
2018,11,22,7,398,174,572
2018,11,22,8,256,153,409
2018,11,22,9,198,160,358
2018,11,22,10,207,155,362
2018,11,22,11,191,187,378
2018,11,22,12,209,211,420
2018,11,22,13,201,233,434
2018,11,22,14,249,284,533
2018,11,22,15,239,303,542
2018,11,22,16,188,189,377
2018,11,22,17,177,168,345
2018,11,22,18,130,154,284
2018,11,22,19,102,136,238
2018,11,22,20,79,117,196
2018,11,22,21,65,86,151
2018,11,22,22,40,54,94
2018,11,22,23,13,24,37
2018,11,23,0,13,17,30
2018,11,23,1,5,16,21
2018,11,23,2,12,42,54
2018,11,23,3,5,16,21
2018,11,23,4,20,13,33
2018,11,23,5,124,47,171
2018,11,23,6,229,130,359
2018,11,23,7,367,182,549
2018,11,23,8,262,142,404
2018,11,23,9,217,159,376
2018,11,23,10,212,189,401
2018,11,23,11,220,238,458
2018,11,23,12,189,230,419
2018,11,23,13,237,257,494
2018,11,23,14,240,359,599
2018,11,23,15,190,229,419
2018,11,23,16,176,181,357
2018,11,23,17,167,148,315
2018,11,23,18,133,133,266
2018,11,23,19,91,98,189
2018,11,23,20,82,90,172
2018,11,23,21,57,73,130
2018,11,23,22,47,60,107
2018,11,23,23,36,47,83
2018,11,24,0,30,67,97
2018,11,24,1,23,26,49
2018,11,24,2,23,41,64
2018,11,24,3,16,41,57
2018,11,24,4,11,14,25
2018,11,24,5,26,14,40
2018,11,24,6,22,18,40
2018,11,24,7,43,47,90
2018,11,24,8,54,37,91
2018,11,24,9,95,73,168
2018,11,24,10,145,100,245
2018,11,24,11,175,125,300
2018,11,24,12,168,149,317
2018,11,24,13,215,177,392
2018,11,24,14,408,190,598
2018,11,24,15,443,194,637
2018,11,24,16,185,528,713
2018,11,24,17,141,222,363
2018,11,24,18,81,134,215
2018,11,24,19,111,94,205
2018,11,24,20,56,97,153
2018,11,24,21,63,67,130
2018,11,24,22,55,77,132
2018,11,24,23,39,52,91
2018,11,25,0,34,50,84
2018,11,25,1,26,53,79
2018,11,25,2,31,49,80
2018,11,25,3,15,36,51
2018,11,25,4,12,16,28
2018,11,25,5,18,15,33
2018,11,25,6,16,16,32
2018,11,25,7,30,12,42
2018,11,25,8,47,28,75
2018,11,25,9,97,72,169
2018,11,25,10,103,77,180
2018,11,25,11,142,150,292
2018,11,25,12,152,170,322
2018,11,25,13,159,178,337
2018,11,25,14,155,178,333
2018,11,25,15,169,194,363
2018,11,25,16,142,163,305
2018,11,25,17,133,133,266
2018,11,25,18,140,151,291
2018,11,25,19,104,144,248
2018,11,25,20,69,103,172
2018,11,25,21,55,45,100
2018,11,25,22,23,49,72
2018,11,25,23,17,22,39
2018,11,26,0,6,19,25
2018,11,26,1,6,11,17
2018,11,26,2,7,13,20
2018,11,26,3,5,6,11
2018,11,26,4,23,11,34
2018,11,26,5,112,53,165
2018,11,26,6,221,147,368
2018,11,26,7,379,179,558
2018,11,26,8,278,149,427
2018,11,26,9,191,155,346
2018,11,26,10,182,156,338
2018,11,26,11,210,182,392
2018,11,26,12,210,195,405
2018,11,26,13,216,234,450
2018,11,26,14,227,301,528
2018,11,26,15,208,274,482
2018,11,26,16,166,185,351
2018,11,26,17,137,157,294
2018,11,26,18,115,123,238
2018,11,26,19,105,141,246
2018,11,26,20,75,80,155
2018,11,26,21,54,66,120
2018,11,26,22,20,29,49
2018,11,26,23,13,19,32
2018,11,27,0,6,13,19
2018,11,27,1,4,7,11
2018,11,27,2,6,8,14
2018,11,27,3,7,12,19
2018,11,27,4,20,8,28
2018,11,27,5,119,50,169
2018,11,27,6,224,134,358
2018,11,27,7,399,177,576
2018,11,27,8,270,163,433
2018,11,27,9,217,176,393
2018,11,27,10,208,171,379
2018,11,27,11,217,207,424
2018,11,27,12,204,202,406
2018,11,27,13,197,271,468
2018,11,27,14,277,301,578
2018,11,27,15,244,306,550
2018,11,27,16,149,180,329
2018,11,27,17,164,168,332
2018,11,27,18,127,144,271
2018,11,27,19,92,110,202
2018,11,27,20,65,97,162
2018,11,27,21,57,103,160
2018,11,27,22,16,51,67
2018,11,27,23,15,73,88
2018,11,28,0,12,29,41
2018,11,28,1,6,31,37
2018,11,28,2,6,8,14
2018,11,28,3,7,11,18
2018,11,28,4,20,13,33
2018,11,28,5,110,51,161
2018,11,28,6,238,143,381
2018,11,28,7,371,201,572
2018,11,28,8,255,172,427
2018,11,28,9,244,165,409
2018,11,28,10,234,175,409
2018,11,28,11,211,195,406
2018,11,28,12,223,213,436
2018,11,28,13,209,232,441
2018,11,28,14,285,344,629
2018,11,28,15,227,266,493
2018,11,28,16,183,198,381
2018,11,28,17,194,186,380
2018,11,28,18,105,152,257
2018,11,28,19,102,138,240
2018,11,28,20,71,116,187
2018,11,28,21,62,71,133
2018,11,28,22,38,50,88
2018,11,28,23,26,24,50
2018,11,29,0,12,24,36
2018,11,29,1,6,11,17
2018,11,29,2,6,21,27
2018,11,29,3,7,13,20
2018,11,29,4,16,8,24
2018,11,29,5,112,46,158
2018,11,29,6,232,146,378
2018,11,29,7,374,196,570
2018,11,29,8,242,158,400
2018,11,29,9,221,171,392
2018,11,29,10,271,188,459
2018,11,29,11,204,195,399
2018,11,29,12,242,211,453
2018,11,29,13,199,260,459
2018,11,29,14,267,315,582
2018,11,29,15,230,293,523
2018,11,29,16,208,199,407
2018,11,29,17,215,167,382
2018,11,29,18,152,150,302
2018,11,29,19,106,148,254
2018,11,29,20,77,112,189
2018,11,29,21,53,94,147
2018,11,29,22,33,61,94
2018,11,29,23,16,26,42
2018,11,30,0,13,29,42
2018,11,30,1,9,18,27
2018,11,30,2,9,25,34
2018,11,30,3,10,16,26
2018,11,30,4,18,13,31
2018,11,30,5,118,57,175
2018,11,30,6,236,138,374
2018,11,30,7,391,207,598
2018,11,30,8,259,149,408
2018,11,30,9,234,169,403
2018,11,30,10,238,182,420
2018,11,30,11,236,205,441
2018,11,30,12,247,217,464
2018,11,30,13,254,315,569
2018,11,30,14,268,358,626
2018,11,30,15,225,292,517
2018,11,30,16,170,172,342
2018,11,30,17,178,193,371
2018,11,30,18,135,138,273
2018,11,30,19,98,121,219
2018,11,30,20,67,68,135
2018,11,30,21,64,75,139
2018,11,30,22,61,74,135
2018,11,30,23,49,55,104
2018,12,1,0,25,37,62
2018,12,1,1,22,37,59
2018,12,1,2,22,34,56
2018,12,1,3,18,40,58
2018,12,1,4,11,15,26
2018,12,1,5,23,15,38
2018,12,1,6,28,27,55
2018,12,1,7,41,32,73
2018,12,1,8,81,53,134
2018,12,1,9,117,94,211
2018,12,1,10,168,119,287
2018,12,1,11,169,166,335
2018,12,1,12,194,162,356
2018,12,1,13,183,225,408
2018,12,1,14,148,180,328
2018,12,1,15,170,217,387
2018,12,1,16,146,163,309
2018,12,1,17,123,165,288
2018,12,1,18,98,120,218
2018,12,1,19,69,83,152
2018,12,1,20,63,68,131
2018,12,1,21,57,80,137
2018,12,1,22,46,77,123
2018,12,1,23,49,57,106
2018,12,2,0,26,50,76
2018,12,2,1,27,46,73
2018,12,2,2,27,48,75
2018,12,2,3,11,35,46
2018,12,2,4,15,24,39
2018,12,2,5,16,16,32
2018,12,2,6,10,15,25
2018,12,2,7,31,17,48
2018,12,2,8,54,30,84
2018,12,2,9,107,85,192
2018,12,2,10,128,96,224
2018,12,2,11,139,163,302
2018,12,2,12,166,163,329
2018,12,2,13,207,210,417
2018,12,2,14,171,182,353
2018,12,2,15,151,207,358
2018,12,2,16,156,189,345
2018,12,2,17,161,176,337
2018,12,2,18,138,183,321
2018,12,2,19,97,140,237
2018,12,2,20,66,95,161
2018,12,2,21,60,63,123
2018,12,2,22,24,38,62
2018,12,2,23,20,32,52
2018,12,3,0,8,17,25
2018,12,3,1,14,9,23
2018,12,3,2,9,20,29
2018,12,3,3,11,11,22
2018,12,3,4,24,10,34
2018,12,3,5,137,57,194
2018,12,3,6,254,125,379
2018,12,3,7,426,231,657
2018,12,3,8,239,162,401
2018,12,3,9,216,142,358
2018,12,3,10,177,181,358
2018,12,3,11,244,196,440
2018,12,3,12,216,229,445
2018,12,3,13,225,230,455
2018,12,3,14,238,317,555
2018,12,3,15,222,312,534
2018,12,3,16,220,190,410
2018,12,3,17,156,167,323
2018,12,3,18,141,160,301
2018,12,3,19,111,124,235
2018,12,3,20,80,125,205
2018,12,3,21,58,65,123
2018,12,3,22,30,33,63
2018,12,3,23,19,19,38
2018,12,4,0,12,18,30
2018,12,4,1,10,12,22
2018,12,4,2,5,17,22
2018,12,4,3,8,20,28
2018,12,4,4,19,12,31
2018,12,4,5,135,44,179
2018,12,4,6,229,139,368
2018,12,4,7,420,205,625
2018,12,4,8,268,167,435
2018,12,4,9,216,172,388
2018,12,4,10,198,198,396
2018,12,4,11,213,185,398
2018,12,4,12,224,226,450
2018,12,4,13,213,245,458
2018,12,4,14,243,322,565
2018,12,4,15,211,287,498
2018,12,4,16,183,187,370
2018,12,4,17,189,166,355
2018,12,4,18,130,129,259
2018,12,4,19,91,129,220
2018,12,4,20,72,125,197
2018,12,4,21,70,80,150
2018,12,4,22,34,60,94
2018,12,4,23,26,17,43
2018,12,5,0,7,21,28
2018,12,5,1,10,15,25
2018,12,5,2,3,15,18
2018,12,5,3,14,13,27
2018,12,5,4,16,14,30
2018,12,5,5,105,59,164
2018,12,5,6,233,123,356
2018,12,5,7,401,197,598
2018,12,5,8,282,131,413
2018,12,5,9,239,193,432
2018,12,5,10,200,172,372
2018,12,5,11,235,207,442
2018,12,5,12,208,227,435
2018,12,5,13,205,268,473
2018,12,5,14,262,323,585
2018,12,5,15,219,292,511
2018,12,5,16,214,224,438
2018,12,5,17,172,178,350
2018,12,5,18,139,131,270
2018,12,5,19,95,134,229
2018,12,5,20,66,96,162
2018,12,5,21,77,100,177
2018,12,5,22,45,91,136
2018,12,5,23,18,34,52
2018,12,6,0,12,20,32
2018,12,6,1,7,14,21
2018,12,6,2,5,13,18
2018,12,6,3,15,11,26
2018,12,6,4,22,15,37
2018,12,6,5,113,55,168
2018,12,6,6,251,124,375
2018,12,6,7,419,192,611
2018,12,6,8,263,138,401
2018,12,6,9,224,154,378
2018,12,6,10,207,181,388
2018,12,6,11,212,196,408
2018,12,6,12,214,220,434
2018,12,6,13,237,233,470
2018,12,6,14,249,341,590
2018,12,6,15,244,330,574
2018,12,6,16,224,213,437
2018,12,6,17,190,166,356
2018,12,6,18,128,142,270
2018,12,6,19,116,117,233
2018,12,6,20,76,120,196
2018,12,6,21,63,85,148
2018,12,6,22,34,46,80
2018,12,6,23,26,34,60
2018,12,7,0,14,32,46
2018,12,7,1,10,33,43
2018,12,7,2,6,27,33
2018,12,7,3,13,20,33
2018,12,7,4,20,8,28
2018,12,7,5,134,57,191
2018,12,7,6,240,137,377
2018,12,7,7,384,189,573
2018,12,7,8,237,158,395
2018,12,7,9,223,183,406
2018,12,7,10,214,184,398
2018,12,7,11,218,218,436
2018,12,7,12,238,236,474
2018,12,7,13,248,290,538
2018,12,7,14,251,387,638
2018,12,7,15,207,296,503
2018,12,7,16,196,211,407
2018,12,7,17,225,189,414
2018,12,7,18,116,149,265
2018,12,7,19,90,109,199
2018,12,7,20,76,103,179
2018,12,7,21,60,77,137
2018,12,7,22,61,77,138
2018,12,7,23,61,61,122
2018,12,8,0,31,58,89
2018,12,8,1,31,43,74
2018,12,8,2,23,38,61
2018,12,8,3,12,36,48
2018,12,8,4,11,16,27
2018,12,8,5,28,8,36
2018,12,8,6,22,26,48
2018,12,8,7,36,26,62
2018,12,8,8,68,56,124
2018,12,8,9,108,75,183
2018,12,8,10,149,111,260
2018,12,8,11,175,161,336
2018,12,8,12,187,186,373
2018,12,8,13,181,184,365
2018,12,8,14,181,223,404
2018,12,8,15,198,210,408
2018,12,8,16,137,181,318
2018,12,8,17,151,146,297
2018,12,8,18,99,166,265
2018,12,8,19,76,79,155
2018,12,8,20,73,95,168
2018,12,8,21,43,68,111
2018,12,8,22,48,83,131
2018,12,8,23,46,69,115
2018,12,9,0,33,49,82
2018,12,9,1,22,35,57
2018,12,9,2,16,48,64
2018,12,9,3,20,40,60
2018,12,9,4,15,20,35
2018,12,9,5,17,10,27
2018,12,9,6,19,14,33
2018,12,9,7,34,19,53
2018,12,9,8,50,28,78
2018,12,9,9,86,36,122
2018,12,9,10,141,94,235
2018,12,9,11,159,141,300
2018,12,9,12,149,158,307
2018,12,9,13,212,189,401
2018,12,9,14,141,212,353
2018,12,9,15,171,238,409
2018,12,9,16,125,149,274
2018,12,9,17,141,126,267
2018,12,9,18,130,137,267
2018,12,9,19,98,138,236
2018,12,9,20,68,95,163
2018,12,9,21,53,64,117
2018,12,9,22,29,38,67
2018,12,9,23,27,27,54
2018,12,10,0,7,17,24
2018,12,10,1,3,8,11
2018,12,10,2,2,15,17
2018,12,10,3,16,15,31
2018,12,10,4,16,9,25
2018,12,10,5,120,51,171
2018,12,10,6,222,146,368
2018,12,10,7,433,196,629
2018,12,10,8,276,159,435
2018,12,10,9,230,145,375
2018,12,10,10,205,200,405
2018,12,10,11,194,177,371
2018,12,10,12,202,217,419
2018,12,10,13,235,250,485
2018,12,10,14,253,295,548
2018,12,10,15,208,326,534
2018,12,10,16,240,229,469
2018,12,10,17,151,177,328
2018,12,10,18,124,146,270
2018,12,10,19,110,136,246
2018,12,10,20,85,93,178
2018,12,10,21,71,65,136
2018,12,10,22,44,67,111
2018,12,10,23,23,25,48
2018,12,11,0,11,12,23
2018,12,11,1,4,12,16
2018,12,11,2,17,20,37
2018,12,11,3,12,9,21
2018,12,11,4,15,9,24
2018,12,11,5,117,58,175
2018,12,11,6,230,135,365
2018,12,11,7,440,193,633
2018,12,11,8,258,169,427
2018,12,11,9,200,144,344
2018,12,11,10,204,180,384
2018,12,11,11,202,192,394
2018,12,11,12,229,181,410
2018,12,11,13,204,250,454
2018,12,11,14,251,323,574
2018,12,11,15,217,329,546
2018,12,11,16,159,189,348
2018,12,11,17,163,149,312
2018,12,11,18,111,160,271
2018,12,11,19,112,124,236
2018,12,11,20,65,90,155
2018,12,11,21,44,330,374
2018,12,11,22,40,225,265
2018,12,11,23,16,96,112
2018,12,12,0,14,46,60
2018,12,12,1,9,33,42
2018,12,12,2,9,48,57
2018,12,12,3,12,35,47
2018,12,12,4,15,22,37
2018,12,12,5,113,54,167
2018,12,12,6,204,128,332
2018,12,12,7,394,186,580
2018,12,12,8,253,156,409
2018,12,12,9,197,149,346
2018,12,12,10,208,185,393
2018,12,12,11,219,221,440
2018,12,12,12,244,202,446
2018,12,12,13,227,272,499
2018,12,12,14,246,324,570
2018,12,12,15,247,274,521
2018,12,12,16,156,200,356
2018,12,12,17,152,170,322
2018,12,12,18,126,124,250
2018,12,12,19,122,124,246
2018,12,12,20,77,112,189
2018,12,12,21,67,348,415
2018,12,12,22,33,264,297
2018,12,12,23,23,93,116
2018,12,13,0,8,62,70
2018,12,13,1,8,56,64
2018,12,13,2,11,40,51
2018,12,13,3,11,27,38
2018,12,13,4,20,43,63
2018,12,13,5,111,45,156
2018,12,13,6,216,123,339
2018,12,13,7,392,195,587
2018,12,13,8,278,169,447
2018,12,13,9,200,159,359
2018,12,13,10,206,174,380
2018,12,13,11,242,191,433
2018,12,13,12,209,213,422
2018,12,13,13,256,272,528
2018,12,13,14,285,292,577
2018,12,13,15,244,313,557
2018,12,13,16,215,261,476
2018,12,13,17,167,167,334
2018,12,13,18,130,153,283
2018,12,13,19,100,120,220
2018,12,13,20,88,136,224
2018,12,13,21,86,97,183
2018,12,13,22,59,80,139
2018,12,13,23,28,34,62
2018,12,14,0,26,42,68
2018,12,14,1,14,35,49
2018,12,14,2,24,39,63
2018,12,14,3,18,21,39
2018,12,14,4,19,13,32
2018,12,14,5,114,40,154
2018,12,14,6,228,134,362
2018,12,14,7,404,194,598
2018,12,14,8,257,153,410
2018,12,14,9,219,156,375
2018,12,14,10,250,199,449
2018,12,14,11,233,229,462
2018,12,14,12,228,229,457
2018,12,14,13,225,313,538
2018,12,14,14,292,334,626
2018,12,14,15,200,305,505
2018,12,14,16,184,205,389
2018,12,14,17,195,180,375
2018,12,14,18,153,153,306
2018,12,14,19,92,166,258
2018,12,14,20,72,82,154
2018,12,14,21,55,82,137
2018,12,14,22,57,73,130
2018,12,14,23,50,54,104
2018,12,15,0,31,37,68
2018,12,15,1,23,43,66
2018,12,15,2,12,45,57
2018,12,15,3,17,39,56
2018,12,15,4,14,17,31
2018,12,15,5,25,13,38
2018,12,15,6,33,26,59
2018,12,15,7,44,44,88
2018,12,15,8,60,48,108
2018,12,15,9,108,83,191
2018,12,15,10,147,105,252
2018,12,15,11,145,150,295
2018,12,15,12,219,207,426
2018,12,15,13,187,195,382
2018,12,15,14,162,219,381
2018,12,15,15,180,228,408
2018,12,15,16,166,176,342
2018,12,15,17,151,193,344
2018,12,15,18,129,184,313
2018,12,15,19,95,116,211
2018,12,15,20,55,68,123
2018,12,15,21,50,78,128
2018,12,15,22,54,68,122
2018,12,15,23,44,65,109
2018,12,16,0,28,41,69
2018,12,16,1,31,53,84
2018,12,16,2,20,55,75
2018,12,16,3,15,38,53
2018,12,16,4,15,19,34
2018,12,16,5,13,13,26
2018,12,16,6,16,20,36
2018,12,16,7,30,14,44
2018,12,16,8,33,25,58
2018,12,16,9,93,44,137
2018,12,16,10,131,85,216
2018,12,16,11,152,154,306
2018,12,16,12,188,202,390
2018,12,16,13,193,181,374
2018,12,16,14,168,173,341
2018,12,16,15,184,246,430
2018,12,16,16,169,156,325
2018,12,16,17,140,141,281
2018,12,16,18,160,213,373
2018,12,16,19,86,142,228
2018,12,16,20,88,98,186
2018,12,16,21,56,65,121
2018,12,16,22,29,47,76
2018,12,16,23,25,24,49
2018,12,17,0,7,19,26
2018,12,17,1,7,11,18
2018,12,17,2,10,9,19
2018,12,17,3,12,10,22
2018,12,17,4,17,13,30
2018,12,17,5,117,56,173
2018,12,17,6,232,115,347
2018,12,17,7,361,171,532
2018,12,17,8,222,171,393
2018,12,17,9,229,150,379
2018,12,17,10,220,186,406
2018,12,17,11,234,193,427
2018,12,17,12,204,219,423
2018,12,17,13,242,225,467
2018,12,17,14,240,305,545
2018,12,17,15,212,311,523
2018,12,17,16,192,186,378
2018,12,17,17,170,165,335
2018,12,17,18,135,152,287
2018,12,17,19,105,129,234
2018,12,17,20,83,107,190
2018,12,17,21,53,65,118
2018,12,17,22,27,34,61
2018,12,17,23,25,22,47
2018,12,18,0,14,15,29
2018,12,18,1,10,22,32
2018,12,18,2,10,12,22
2018,12,18,3,3,10,13
2018,12,18,4,19,15,34
2018,12,18,5,120,53,173
2018,12,18,6,246,115,361
2018,12,18,7,382,188,570
2018,12,18,8,243,175,418
2018,12,18,9,221,178,399
2018,12,18,10,229,199,428
2018,12,18,11,241,202,443
2018,12,18,12,266,227,493
2018,12,18,13,198,260,458
2018,12,18,14,249,331,580
2018,12,18,15,230,304,534
2018,12,18,16,209,182,391
2018,12,18,17,176,137,313
2018,12,18,18,167,159,326
2018,12,18,19,113,166,279
2018,12,18,20,79,138,217
2018,12,18,21,46,282,328
2018,12,18,22,37,203,240
2018,12,18,23,16,80,96
2018,12,19,0,9,36,45
2018,12,19,1,14,40,54
2018,12,19,2,7,41,48
2018,12,19,3,13,27,40
2018,12,19,4,26,20,46
2018,12,19,5,106,48,154
2018,12,19,6,215,120,335
2018,12,19,7,363,193,556
2018,12,19,8,239,156,395
2018,12,19,9,242,193,435
2018,12,19,10,248,186,434
2018,12,19,11,239,228,467
2018,12,19,12,250,242,492
2018,12,19,13,246,274,520
2018,12,19,14,258,303,561
2018,12,19,15,246,303,549
2018,12,19,16,212,175,387
2018,12,19,17,228,152,380
2018,12,19,18,297,159,456
2018,12,19,19,83,158,241
2018,12,19,20,90,112,202
2018,12,19,21,74,75,149
2018,12,19,22,43,59,102
2018,12,19,23,38,32,70
2018,12,20,0,19,31,50
2018,12,20,1,13,24,37
2018,12,20,2,18,20,38
2018,12,20,3,11,12,23
2018,12,20,4,20,11,31
2018,12,20,5,97,43,140
2018,12,20,6,188,120,308
2018,12,20,7,372,171,543
2018,12,20,8,263,129,392
2018,12,20,9,235,173,408
2018,12,20,10,247,220,467
2018,12,20,11,294,254,548
2018,12,20,12,243,245,488
2018,12,20,13,266,293,559
2018,12,20,14,278,337,615
2018,12,20,15,239,327,566
2018,12,20,16,183,184,367
2018,12,20,17,181,196,377
2018,12,20,18,135,158,293
2018,12,20,19,107,170,277
2018,12,20,20,79,98,177
2018,12,20,21,68,128,196
2018,12,20,22,39,40,79
2018,12,20,23,19,36,55
2018,12,21,0,15,37,52
2018,12,21,1,14,27,41
2018,12,21,2,13,31,44
2018,12,21,3,12,16,28
2018,12,21,4,16,10,26
2018,12,21,5,102,43,145
2018,12,21,6,169,95,264
2018,12,21,7,315,145,460
2018,12,21,8,256,161,417
2018,12,21,9,213,199,412
2018,12,21,10,250,186,436
2018,12,21,11,244,274,518
2018,12,21,12,270,259,529
2018,12,21,13,260,288,548
2018,12,21,14,233,317,550
2018,12,21,15,234,272,506
2018,12,21,16,179,174,353
2018,12,21,17,157,150,307
2018,12,21,18,114,124,238
2018,12,21,19,96,124,220
2018,12,21,20,64,85,149
2018,12,21,21,53,89,142
2018,12,21,22,49,80,129
2018,12,21,23,32,55,87
2018,12,22,0,26,40,66
2018,12,22,1,24,35,59
2018,12,22,2,10,28,38
2018,12,22,3,11,32,43
2018,12,22,4,10,10,20
2018,12,22,5,19,20,39
2018,12,22,6,23,15,38
2018,12,22,7,31,32,63
2018,12,22,8,56,45,101
2018,12,22,9,104,82,186
2018,12,22,10,155,107,262
2018,12,22,11,179,146,325
2018,12,22,12,154,175,329
2018,12,22,13,171,178,349
2018,12,22,14,164,183,347
2018,12,22,15,157,164,321
2018,12,22,16,139,150,289
2018,12,22,17,128,142,270
2018,12,22,18,117,116,233
2018,12,22,19,104,116,220
2018,12,22,20,50,58,108
2018,12,22,21,50,54,104
2018,12,22,22,37,56,93
2018,12,22,23,38,42,80
2018,12,23,0,28,36,64
2018,12,23,1,16,30,46
2018,12,23,2,22,41,63
2018,12,23,3,14,35,49
2018,12,23,4,11,15,26
2018,12,23,5,19,11,30
2018,12,23,6,15,15,30
2018,12,23,7,29,14,43
2018,12,23,8,33,29,62
2018,12,23,9,50,46,96
2018,12,23,10,82,87,169
2018,12,23,11,130,124,254
2018,12,23,12,185,140,325
2018,12,23,13,208,177,385
2018,12,23,14,159,160,319
2018,12,23,15,151,139,290
2018,12,23,16,149,139,288
2018,12,23,17,120,118,238
2018,12,23,18,85,107,192
2018,12,23,19,80,111,191
2018,12,23,20,56,72,128
2018,12,23,21,44,39,83
2018,12,23,22,33,39,72
2018,12,23,23,18,32,50
2018,12,24,0,15,19,34
2018,12,24,1,6,18,24
2018,12,24,2,7,12,19
2018,12,24,3,13,8,21
2018,12,24,4,11,3,14
2018,12,24,5,28,14,42
2018,12,24,6,37,38,75
2018,12,24,7,38,41,79
2018,12,24,8,41,40,81
2018,12,24,9,75,84,159
2018,12,24,10,121,106,227
2018,12,24,11,140,160,300
2018,12,24,12,133,133,266
2018,12,24,13,146,125,271
2018,12,24,14,130,125,255
2018,12,24,15,110,144,254
2018,12,24,16,92,84,176
2018,12,24,17,42,52,94
2018,12,24,18,34,31,65
2018,12,24,19,52,44,96
2018,12,24,20,39,55,94
2018,12,24,21,85,71,156
2018,12,24,22,84,58,142
2018,12,24,23,41,47,88
2018,12,25,0,33,32,65
2018,12,25,1,10,11,21
2018,12,25,2,8,14,22
2018,12,25,3,6,5,11
2018,12,25,4,4,6,10
2018,12,25,5,12,8,20
2018,12,25,6,11,10,21
2018,12,25,7,14,11,25
2018,12,25,8,18,4,22
2018,12,25,9,30,16,46
2018,12,25,10,26,21,47
2018,12,25,11,55,64,119
2018,12,25,12,80,81,161
2018,12,25,13,97,93,190
2018,12,25,14,86,88,174
2018,12,25,15,91,103,194
2018,12,25,16,81,94,175
2018,12,25,17,62,72,134
2018,12,25,18,70,62,132
2018,12,25,19,72,77,149
2018,12,25,20,53,73,126
2018,12,25,21,54,55,109
2018,12,25,22,35,46,81
2018,12,25,23,22,38,60
2018,12,26,0,15,18,33
2018,12,26,1,10,11,21
2018,12,26,2,9,11,20
2018,12,26,3,7,12,19
2018,12,26,4,2,4,6
2018,12,26,5,14,10,24
2018,12,26,6,18,7,25
2018,12,26,7,20,10,30
2018,12,26,8,24,19,43
2018,12,26,9,42,35,77
2018,12,26,10,65,53,118
2018,12,26,11,89,148,237
2018,12,26,12,93,97,190
2018,12,26,13,113,134,247
2018,12,26,14,124,121,245
2018,12,26,15,87,106,193
2018,12,26,16,79,81,160
2018,12,26,17,85,109,194
2018,12,26,18,114,110,224
2018,12,26,19,86,91,177
2018,12,26,20,77,95,172
2018,12,26,21,46,64,110
2018,12,26,22,31,45,76
2018,12,26,23,33,45,78
2018,12,27,0,24,35,59
2018,12,27,1,23,36,59
2018,12,27,2,14,26,40
2018,12,27,3,13,32,45
2018,12,27,4,22,23,45
2018,12,27,5,43,21,64
2018,12,27,6,75,52,127
2018,12,27,7,82,64,146
2018,12,27,8,96,59,155
2018,12,27,9,94,90,184
2018,12,27,10,147,106,253
2018,12,27,11,151,146,297
2018,12,27,12,164,136,300
2018,12,27,13,164,191,355
2018,12,27,14,137,175,312
2018,12,27,15,125,161,286
2018,12,27,16,127,109,236
2018,12,27,17,115,95,210
2018,12,27,18,101,101,202
2018,12,27,19,89,76,165
2018,12,27,20,55,71,126
2018,12,27,21,49,104,153
2018,12,27,22,31,97,128
2018,12,27,23,27,36,63
2018,12,28,0,15,30,45
2018,12,28,1,7,13,20
2018,12,28,2,13,19,32
2018,12,28,3,7,9,16
2018,12,28,4,9,5,14
2018,12,28,5,39,12,51
2018,12,28,6,67,42,109
2018,12,28,7,75,53,128
2018,12,28,8,105,53,158
2018,12,28,9,112,85,197
2018,12,28,10,133,109,242
2018,12,28,11,160,136,296
2018,12,28,12,164,163,327
2018,12,28,13,181,171,352
2018,12,28,14,150,154,304
2018,12,28,15,112,153,265
2018,12,28,16,124,130,254
2018,12,28,17,106,117,223
2018,12,28,18,97,112,209
2018,12,28,19,86,69,155
2018,12,28,20,56,67,123
2018,12,28,21,42,46,88
2018,12,28,22,28,54,82
2018,12,28,23,32,38,70
2018,12,29,0,24,32,56
2018,12,29,1,7,23,30
2018,12,29,2,10,29,39
2018,12,29,3,8,23,31
2018,12,29,4,6,9,15
2018,12,29,5,19,12,31
2018,12,29,6,14,28,42
2018,12,29,7,16,18,34
2018,12,29,8,30,20,50
2018,12,29,9,61,45,106
2018,12,29,10,70,60,130
2018,12,29,11,105,106,211
2018,12,29,12,102,112,214
2018,12,29,13,124,124,248
2018,12,29,14,118,145,263
2018,12,29,15,109,112,221
2018,12,29,16,101,98,199
2018,12,29,17,109,112,221
2018,12,29,18,80,79,159
2018,12,29,19,72,88,160
2018,12,29,20,62,57,119
2018,12,29,21,36,49,85
2018,12,29,22,51,61,112
2018,12,29,23,44,53,97
2018,12,30,0,21,27,48
2018,12,30,1,27,21,48
2018,12,30,2,25,40,65
2018,12,30,3,13,29,42
2018,12,30,4,9,9,18
2018,12,30,5,18,7,25
2018,12,30,6,12,15,27
2018,12,30,7,18,5,23
2018,12,30,8,23,17,40
2018,12,30,9,46,37,83
2018,12,30,10,68,55,123
2018,12,30,11,103,79,182
2018,12,30,12,109,110,219
2018,12,30,13,146,140,286
2018,12,30,14,111,153,264
2018,12,30,15,106,146,252
2018,12,30,16,114,116,230
2018,12,30,17,98,106,204
2018,12,30,18,97,108,205
2018,12,30,19,88,103,191
2018,12,30,20,60,72,132
2018,12,30,21,41,48,89
2018,12,30,22,33,40,73
2018,12,30,23,29,41,70
2018,12,31,0,12,24,36
2018,12,31,1,11,11,22
2018,12,31,2,6,13,19
2018,12,31,3,7,8,15
2018,12,31,4,8,6,14
2018,12,31,5,31,12,43
2018,12,31,6,46,35,81
2018,12,31,7,40,41,81
2018,12,31,8,54,51,105
2018,12,31,9,60,66,126
2018,12,31,10,93,108,201
2018,12,31,11,151,122,273
2018,12,31,12,118,131,249
2018,12,31,13,117,127,244
2018,12,31,14,93,102,195
2018,12,31,15,115,109,224
2018,12,31,16,111,102,213
2018,12,31,17,99,101,200
2018,12,31,18,81,79,160
2018,12,31,19,63,68,131
2018,12,31,20,83,77,160
2018,12,31,21,62,64,126
2018,12,31,22,51,52,103
2018,12,31,23,54,71,125
2019,1,1,0,62,73,135
2019,1,1,1,58,70,128
2019,1,1,2,60,74,134
2019,1,1,3,36,54,90
2019,1,1,4,29,32,61
2019,1,1,5,22,27,49
2019,1,1,6,15,14,29
2019,1,1,7,11,12,23
2019,1,1,8,20,9,29
2019,1,1,9,25,20,45
2019,1,1,10,38,33,71
2019,1,1,11,48,56,104
2019,1,1,12,75,78,153
2019,1,1,13,99,96,195
2019,1,1,14,126,124,250
2019,1,1,15,113,136,249
2019,1,1,16,108,112,220
2019,1,1,17,121,103,224
2019,1,1,18,99,89,188
2019,1,1,19,87,99,186
2019,1,1,20,62,71,133
2019,1,1,21,53,70,123
2019,1,1,22,25,36,61
2019,1,1,23,23,19,42
2019,1,2,0,8,10,18
2019,1,2,1,3,9,12
2019,1,2,2,9,8,17
2019,1,2,3,7,6,13
2019,1,2,4,15,9,24
2019,1,2,5,86,49,135
2019,1,2,6,193,115,308
2019,1,2,7,268,130,398
2019,1,2,8,196,118,314
2019,1,2,9,154,120,274
2019,1,2,10,194,146,340
2019,1,2,11,181,160,341
2019,1,2,12,200,200,400
2019,1,2,13,193,203,396
2019,1,2,14,189,251,440
2019,1,2,15,169,271,440
2019,1,2,16,133,148,281
2019,1,2,17,143,112,255
2019,1,2,18,91,92,183
2019,1,2,19,81,105,186
2019,1,2,20,59,65,124
2019,1,2,21,35,58,93
2019,1,2,22,32,180,212
2019,1,2,23,22,34,56
2019,1,3,0,7,16,23
2019,1,3,1,7,13,20
2019,1,3,2,6,11,17
2019,1,3,3,8,11,19
2019,1,3,4,16,8,24
2019,1,3,5,93,44,137
2019,1,3,6,190,115,305
2019,1,3,7,349,170,519
2019,1,3,8,186,142,328
2019,1,3,9,183,135,318
2019,1,3,10,185,146,331
2019,1,3,11,190,179,369
2019,1,3,12,170,184,354
2019,1,3,13,172,206,378
2019,1,3,14,213,285,498
2019,1,3,15,195,261,456
2019,1,3,16,138,147,285
2019,1,3,17,125,133,258
2019,1,3,18,114,122,236
2019,1,3,19,91,96,187
2019,1,3,20,64,83,147
2019,1,3,21,39,55,94
2019,1,3,22,35,46,81
2019,1,3,23,12,25,37
2019,1,4,0,11,15,26
2019,1,4,1,9,18,27
2019,1,4,2,7,12,19
2019,1,4,3,6,10,16
2019,1,4,4,18,4,22
2019,1,4,5,97,45,142
2019,1,4,6,190,110,300
2019,1,4,7,365,157,522
2019,1,4,8,212,128,340
2019,1,4,9,186,119,305
2019,1,4,10,210,169,379
2019,1,4,11,194,184,378
2019,1,4,12,193,198,391
2019,1,4,13,202,229,431
2019,1,4,14,249,328,577
2019,1,4,15,175,274,449
2019,1,4,16,163,160,323
2019,1,4,17,131,141,272
2019,1,4,18,107,112,219
2019,1,4,19,76,97,173
2019,1,4,20,68,80,148
2019,1,4,21,37,47,84
2019,1,4,22,41,61,102
2019,1,4,23,35,38,73
2019,1,5,0,16,27,43
2019,1,5,1,10,28,38
2019,1,5,2,10,36,46
2019,1,5,3,12,17,29
2019,1,5,4,6,7,13
2019,1,5,5,17,10,27
2019,1,5,6,20,24,44
2019,1,5,7,26,13,39
2019,1,5,8,44,34,78
2019,1,5,9,86,46,132
2019,1,5,10,112,72,184
2019,1,5,11,142,107,249
2019,1,5,12,136,172,308
2019,1,5,13,167,139,306
2019,1,5,14,158,166,324
2019,1,5,15,153,159,312
2019,1,5,16,120,128,248
2019,1,5,17,149,164,313
2019,1,5,18,99,113,212
2019,1,5,19,82,79,161
2019,1,5,20,49,58,107
2019,1,5,21,46,52,98
2019,1,5,22,34,56,90
2019,1,5,23,37,51,88
2019,1,6,0,30,35,65
2019,1,6,1,17,39,56
2019,1,6,2,22,50,72
2019,1,6,3,14,30,44
2019,1,6,4,8,16,24
2019,1,6,5,20,7,27
2019,1,6,6,7,14,21
2019,1,6,7,21,10,31
2019,1,6,8,35,28,63
2019,1,6,9,79,43,122
2019,1,6,10,93,64,157
2019,1,6,11,102,125,227
2019,1,6,12,139,129,268
2019,1,6,13,167,149,316
2019,1,6,14,140,157,297
2019,1,6,15,135,202,337
2019,1,6,16,138,143,281
2019,1,6,17,124,118,242
2019,1,6,18,125,137,262
2019,1,6,19,78,130,208
2019,1,6,20,64,95,159
2019,1,6,21,50,60,110
2019,1,6,22,38,34,72
2019,1,6,23,20,23,43
2019,1,7,0,10,13,23
2019,1,7,1,1,13,14
2019,1,7,2,16,19,35
2019,1,7,3,8,10,18
2019,1,7,4,25,7,32
2019,1,7,5,115,55,170
2019,1,7,6,210,132,342
2019,1,7,7,397,175,572
2019,1,7,8,235,139,374
2019,1,7,9,201,123,324
2019,1,7,10,201,187,388
2019,1,7,11,205,204,409
2019,1,7,12,200,205,405
2019,1,7,13,178,232,410
2019,1,7,14,215,309,524
2019,1,7,15,238,320,558
2019,1,7,16,176,169,345
2019,1,7,17,131,159,290
2019,1,7,18,118,145,263
2019,1,7,19,89,101,190
2019,1,7,20,63,94,157
2019,1,7,21,54,59,113
2019,1,7,22,32,40,72
2019,1,7,23,20,19,39
2019,1,8,0,14,11,25
2019,1,8,1,5,5,10
2019,1,8,2,7,8,15
2019,1,8,3,9,8,17
2019,1,8,4,17,10,27
2019,1,8,5,121,48,169
2019,1,8,6,213,130,343
2019,1,8,7,368,184,552
2019,1,8,8,222,136,358
2019,1,8,9,226,158,384
2019,1,8,10,198,164,362
2019,1,8,11,193,158,351
2019,1,8,12,220,212,432
2019,1,8,13,210,252,462
2019,1,8,14,238,260,498
2019,1,8,15,196,324,520
2019,1,8,16,175,169,344
2019,1,8,17,177,134,311
2019,1,8,18,126,144,270
2019,1,8,19,106,108,214
2019,1,8,20,64,105,169
2019,1,8,21,48,78,126
2019,1,8,22,28,30,58
2019,1,8,23,11,15,26
2019,1,9,0,7,7,14
2019,1,9,1,4,12,16
2019,1,9,2,6,10,16
2019,1,9,3,9,12,21
2019,1,9,4,13,8,21
2019,1,9,5,107,53,160
2019,1,9,6,221,137,358
2019,1,9,7,373,182,555
2019,1,9,8,253,115,368
2019,1,9,9,179,162,341
2019,1,9,10,217,159,376
2019,1,9,11,212,210,422
2019,1,9,12,189,209,398
2019,1,9,13,202,235,437
2019,1,9,14,199,291,490
2019,1,9,15,193,299,492
2019,1,9,16,167,191,358
2019,1,9,17,165,152,317
2019,1,9,18,93,125,218
2019,1,9,19,91,108,199
2019,1,9,20,81,85,166
2019,1,9,21,48,79,127
2019,1,9,22,28,40,68
2019,1,9,23,16,26,42
2019,1,10,0,10,13,23
2019,1,10,1,12,22,34
2019,1,10,2,6,12,18
2019,1,10,3,10,6,16
2019,1,10,4,14,8,22
2019,1,10,5,117,49,166
2019,1,10,6,209,131,340
2019,1,10,7,395,183,578
2019,1,10,8,273,135,408
2019,1,10,9,212,149,361
2019,1,10,10,183,162,345
2019,1,10,11,188,209,397
2019,1,10,12,207,175,382
2019,1,10,13,193,258,451
2019,1,10,14,218,295,513
2019,1,10,15,215,301,516
2019,1,10,16,156,195,351
2019,1,10,17,163,139,302
2019,1,10,18,118,143,261
2019,1,10,19,103,103,206
2019,1,10,20,73,85,158
2019,1,10,21,54,87,141
2019,1,10,22,28,44,72
2019,1,10,23,20,37,57
2019,1,11,0,15,23,38
2019,1,11,1,7,21,28
2019,1,11,2,4,23,27
2019,1,11,3,7,12,19
2019,1,11,4,17,15,32
2019,1,11,5,109,40,149
2019,1,11,6,217,127,344
2019,1,11,7,362,188,550
2019,1,11,8,270,129,399
2019,1,11,9,220,158,378
2019,1,11,10,204,174,378
2019,1,11,11,193,210,403
2019,1,11,12,187,206,393
2019,1,11,13,221,255,476
2019,1,11,14,271,320,591
2019,1,11,15,188,289,477
2019,1,11,16,128,182,310
2019,1,11,17,112,136,248
2019,1,11,18,118,116,234
2019,1,11,19,76,84,160
2019,1,11,20,61,77,138
2019,1,11,21,53,66,119
2019,1,11,22,40,71,111
2019,1,11,23,45,55,100
2019,1,12,0,31,30,61
2019,1,12,1,18,22,40
2019,1,12,2,16,30,46
2019,1,12,3,13,30,43
2019,1,12,4,8,9,17
2019,1,12,5,25,11,36
2019,1,12,6,35,26,61
2019,1,12,7,35,29,64
2019,1,12,8,58,42,100
2019,1,12,9,103,51,154
2019,1,12,10,132,82,214
2019,1,12,11,137,125,262
2019,1,12,12,152,154,306
2019,1,12,13,181,174,355
2019,1,12,14,123,188,311
2019,1,12,15,138,151,289
2019,1,12,16,130,144,274
2019,1,12,17,114,137,251
2019,1,12,18,119,121,240
2019,1,12,19,67,83,150
2019,1,12,20,45,57,102
2019,1,12,21,43,59,102
2019,1,12,22,43,60,103
2019,1,12,23,30,58,88
2019,1,13,0,30,46,76
2019,1,13,1,26,62,88
2019,1,13,2,18,53,71
2019,1,13,3,8,39,47
2019,1,13,4,12,25,37
2019,1,13,5,19,9,28
2019,1,13,6,20,25,45
2019,1,13,7,28,19,47
2019,1,13,8,43,22,65
2019,1,13,9,92,50,142
2019,1,13,10,87,59,146
2019,1,13,11,154,150,304
2019,1,13,12,124,158,282
2019,1,13,13,211,221,432
2019,1,13,14,147,198,345
2019,1,13,15,152,192,344
2019,1,13,16,161,148,309
2019,1,13,17,139,124,263
2019,1,13,18,131,141,272
2019,1,13,19,97,124,221
2019,1,13,20,75,118,193
2019,1,13,21,48,75,123
2019,1,13,22,31,49,80
2019,1,13,23,21,24,45
2019,1,14,0,9,12,21
2019,1,14,1,5,10,15
2019,1,14,2,10,17,27
2019,1,14,3,7,5,12
2019,1,14,4,17,11,28
2019,1,14,5,109,53,162
2019,1,14,6,212,118,330
2019,1,14,7,358,177,535
2019,1,14,8,259,185,444
2019,1,14,9,224,161,385
2019,1,14,10,202,174,376
2019,1,14,11,178,177,355
2019,1,14,12,189,170,359
2019,1,14,13,192,224,416
2019,1,14,14,226,332,558
2019,1,14,15,210,327,537
2019,1,14,16,162,193,355
2019,1,14,17,163,134,297
2019,1,14,18,98,117,215
2019,1,14,19,98,116,214
2019,1,14,20,67,100,167
2019,1,14,21,43,70,113
2019,1,14,22,24,22,46
2019,1,14,23,23,15,38
2019,1,15,0,11,13,24
2019,1,15,1,10,13,23
2019,1,15,2,12,26,38
2019,1,15,3,10,20,30
2019,1,15,4,15,12,27
2019,1,15,5,116,47,163
2019,1,15,6,217,132,349
2019,1,15,7,337,176,513
2019,1,15,8,257,121,378
2019,1,15,9,185,163,348
2019,1,15,10,204,177,381
2019,1,15,11,205,161,366
2019,1,15,12,188,203,391
2019,1,15,13,229,257,486
2019,1,15,14,207,313,520
2019,1,15,15,198,268,466
2019,1,15,16,185,156,341
2019,1,15,17,192,138,330
2019,1,15,18,154,145,299
2019,1,15,19,96,133,229
2019,1,15,20,80,106,186
2019,1,15,21,54,86,140
2019,1,15,22,21,36,57
2019,1,15,23,18,21,39
2019,1,16,0,8,18,26
2019,1,16,1,1,9,10
2019,1,16,2,9,10,19
2019,1,16,3,7,4,11
2019,1,16,4,13,8,21
2019,1,16,5,114,50,164
2019,1,16,6,229,122,351
2019,1,16,7,387,183,570
2019,1,16,8,253,141,394
2019,1,16,9,197,154,351
2019,1,16,10,216,159,375
2019,1,16,11,216,204,420
2019,1,16,12,210,188,398
2019,1,16,13,212,261,473
2019,1,16,14,248,297,545
2019,1,16,15,228,297,525
2019,1,16,16,177,186,363
2019,1,16,17,178,152,330
2019,1,16,18,128,127,255
2019,1,16,19,107,117,224
2019,1,16,20,81,108,189
2019,1,16,21,55,67,122
2019,1,16,22,34,40,74
2019,1,16,23,15,31,46
2019,1,17,0,8,11,19
2019,1,17,1,10,17,27
2019,1,17,2,6,7,13
2019,1,17,3,6,9,15
2019,1,17,4,16,9,25
2019,1,17,5,112,41,153
2019,1,17,6,214,129,343
2019,1,17,7,375,181,556
2019,1,17,8,242,169,411
2019,1,17,9,231,151,382
2019,1,17,10,194,146,340
2019,1,17,11,188,187,375
2019,1,17,12,199,195,394
2019,1,17,13,194,233,427
2019,1,17,14,227,292,519
2019,1,17,15,222,306,528
2019,1,17,16,180,208,388
2019,1,17,17,169,178,347
2019,1,17,18,120,141,261
2019,1,17,19,106,110,216
2019,1,17,20,76,96,172
2019,1,17,21,82,69,151
2019,1,17,22,40,43,83
2019,1,17,23,20,22,42
2019,1,18,0,13,19,32
2019,1,18,1,21,24,45
2019,1,18,2,21,26,47
2019,1,18,3,14,12,26
2019,1,18,4,21,5,26
2019,1,18,5,98,49,147
2019,1,18,6,214,112,326
2019,1,18,7,369,193,562
2019,1,18,8,277,136,413
2019,1,18,9,211,139,350
2019,1,18,10,221,166,387
2019,1,18,11,184,207,391
2019,1,18,12,215,207,422
2019,1,18,13,240,249,489
2019,1,18,14,249,326,575
2019,1,18,15,161,299,460
2019,1,18,16,141,152,293
2019,1,18,17,133,130,263
2019,1,18,18,116,111,227
2019,1,18,19,78,95,173
2019,1,18,20,66,65,131
2019,1,18,21,42,53,95
2019,1,18,22,41,56,97
2019,1,18,23,35,50,85
2019,1,19,0,24,39,63
2019,1,19,1,22,33,55
2019,1,19,2,19,48,67
2019,1,19,3,12,24,36
2019,1,19,4,10,8,18
2019,1,19,5,30,11,41
2019,1,19,6,23,25,48
2019,1,19,7,33,30,63
2019,1,19,8,44,40,84
2019,1,19,9,118,76,194
2019,1,19,10,123,76,199
2019,1,19,11,111,135,246
2019,1,19,12,150,138,288
2019,1,19,13,148,169,317
2019,1,19,14,164,194,358
2019,1,19,15,142,166,308
2019,1,19,16,126,139,265
2019,1,19,17,144,135,279
2019,1,19,18,115,117,232
2019,1,19,19,62,82,144
2019,1,19,20,44,68,112
2019,1,19,21,44,59,103
2019,1,19,22,49,79,128
2019,1,19,23,37,65,102
2019,1,20,0,37,61,98
2019,1,20,1,19,68,87
2019,1,20,2,28,53,81
2019,1,20,3,16,43,59
2019,1,20,4,12,15,27
2019,1,20,5,19,13,32
2019,1,20,6,17,18,35
2019,1,20,7,26,21,47
2019,1,20,8,36,25,61
2019,1,20,9,86,46,132
2019,1,20,10,78,67,145
2019,1,20,11,117,122,239
2019,1,20,12,120,122,242
2019,1,20,13,176,175,351
2019,1,20,14,140,167,307
2019,1,20,15,138,205,343
2019,1,20,16,138,155,293
2019,1,20,17,131,127,258
2019,1,20,18,107,136,243
2019,1,20,19,108,127,235
2019,1,20,20,63,95,158
2019,1,20,21,60,79,139
2019,1,20,22,35,30,65
2019,1,20,23,17,24,41
2019,1,21,0,8,22,30
2019,1,21,1,10,7,17
2019,1,21,2,4,11,15
2019,1,21,3,14,7,21
2019,1,21,4,16,14,30
2019,1,21,5,119,54,173
2019,1,21,6,237,147,384
2019,1,21,7,414,218,632
2019,1,21,8,313,179,492
2019,1,21,9,192,144,336
2019,1,21,10,225,180,405
2019,1,21,11,180,201,381
2019,1,21,12,195,213,408
2019,1,21,13,207,264,471
2019,1,21,14,239,326,565
2019,1,21,15,204,321,525
2019,1,21,16,190,195,385
2019,1,21,17,167,145,312
2019,1,21,18,115,155,270
2019,1,21,19,125,130,255
2019,1,21,20,59,102,161
2019,1,21,21,70,64,134
2019,1,21,22,32,54,86
2019,1,21,23,22,21,43
2019,1,22,0,13,13,26
2019,1,22,1,7,5,12
2019,1,22,2,4,5,9
2019,1,22,3,12,10,22
2019,1,22,4,17,13,30
2019,1,22,5,120,50,170
2019,1,22,6,239,129,368
2019,1,22,7,404,194,598
2019,1,22,8,254,129,383
2019,1,22,9,197,171,368
2019,1,22,10,191,166,357
2019,1,22,11,216,181,397
2019,1,22,12,220,205,425
2019,1,22,13,224,242,466
2019,1,22,14,219,339,558
2019,1,22,15,198,301,499
2019,1,22,16,155,177,332
2019,1,22,17,153,160,313
2019,1,22,18,159,124,283
2019,1,22,19,89,103,192
2019,1,22,20,74,129,203
2019,1,22,21,51,89,140
2019,1,22,22,29,39,68
2019,1,22,23,11,21,32
2019,1,23,0,13,24,37
2019,1,23,1,8,11,19
2019,1,23,2,10,16,26
2019,1,23,3,11,15,26
2019,1,23,4,20,16,36
2019,1,23,5,123,45,168
2019,1,23,6,227,138,365
2019,1,23,7,401,191,592
2019,1,23,8,229,152,381
2019,1,23,9,202,132,334
2019,1,23,10,203,183,386
2019,1,23,11,206,203,409
2019,1,23,12,207,230,437
2019,1,23,13,246,244,490
2019,1,23,14,217,335,552
2019,1,23,15,220,297,517
2019,1,23,16,168,191,359
2019,1,23,17,163,156,319
2019,1,23,18,144,136,280
2019,1,23,19,131,116,247
2019,1,23,20,83,96,179
2019,1,23,21,51,80,131
2019,1,23,22,30,41,71
2019,1,23,23,18,23,41
2019,1,24,0,8,17,25
2019,1,24,1,11,19,30
2019,1,24,2,9,20,29
2019,1,24,3,15,15,30
2019,1,24,4,18,9,27
2019,1,24,5,103,44,147
2019,1,24,6,223,130,353
2019,1,24,7,394,181,575
2019,1,24,8,230,127,357
2019,1,24,9,180,171,351
2019,1,24,10,213,163,376
2019,1,24,11,183,176,359
2019,1,24,12,196,198,394
2019,1,24,13,189,238,427
2019,1,24,14,232,308,540
2019,1,24,15,216,300,516
2019,1,24,16,156,196,352
2019,1,24,17,175,173,348
2019,1,24,18,131,130,261
2019,1,24,19,96,107,203
2019,1,24,20,72,88,160
2019,1,24,21,65,96,161
2019,1,24,22,28,42,70
2019,1,24,23,16,25,41
2019,1,25,0,16,29,45
2019,1,25,1,10,27,37
2019,1,25,2,10,29,39
2019,1,25,3,9,15,24
2019,1,25,4,14,9,23
2019,1,25,5,100,52,152
2019,1,25,6,206,132,338
2019,1,25,7,375,173,548
2019,1,25,8,230,129,359
2019,1,25,9,226,155,381
2019,1,25,10,220,185,405
2019,1,25,11,201,210,411
2019,1,25,12,211,209,420
2019,1,25,13,212,267,479
2019,1,25,14,244,327,571
2019,1,25,15,189,285,474
2019,1,25,16,139,168,307
2019,1,25,17,146,107,253
2019,1,25,18,90,119,209
2019,1,25,19,86,72,158
2019,1,25,20,70,62,132
2019,1,25,21,57,65,122
2019,1,25,22,49,67,116
2019,1,25,23,30,44,74
2019,1,26,0,26,31,57
2019,1,26,1,15,27,42
2019,1,26,2,20,30,50
2019,1,26,3,17,25,42
2019,1,26,4,10,12,22
2019,1,26,5,21,13,34
2019,1,26,6,20,24,44
2019,1,26,7,41,42,83
2019,1,26,8,81,58,139
2019,1,26,9,86,56,142
2019,1,26,10,113,93,206
2019,1,26,11,120,118,238
2019,1,26,12,135,139,274
2019,1,26,13,130,154,284
2019,1,26,14,131,187,318
2019,1,26,15,105,149,254
2019,1,26,16,120,131,251
2019,1,26,17,136,127,263
2019,1,26,18,88,113,201
2019,1,26,19,67,91,158
2019,1,26,20,47,62,109
2019,1,26,21,42,48,90
2019,1,26,22,48,62,110
2019,1,26,23,29,61,90
2019,1,27,0,39,51,90
2019,1,27,1,29,52,81
2019,1,27,2,27,64,91
2019,1,27,3,20,28,48
2019,1,27,4,15,21,36
2019,1,27,5,12,16,28
2019,1,27,6,13,12,25
2019,1,27,7,25,21,46
2019,1,27,8,52,37,89
2019,1,27,9,96,45,141
2019,1,27,10,87,69,156
2019,1,27,11,130,128,258
2019,1,27,12,130,167,297
2019,1,27,13,133,202,335
2019,1,27,14,141,180,321
2019,1,27,15,141,164,305
2019,1,27,16,166,149,315
2019,1,27,17,118,106,224
2019,1,27,18,111,139,250
2019,1,27,19,84,132,216
2019,1,27,20,59,73,132
2019,1,27,21,38,64,102
2019,1,27,22,31,32,63
2019,1,27,23,15,20,35
2019,1,28,0,8,17,25
2019,1,28,1,3,9,12
2019,1,28,2,6,12,18
2019,1,28,3,8,10,18
2019,1,28,4,17,9,26
2019,1,28,5,107,56,163
2019,1,28,6,214,136,350
2019,1,28,7,407,206,613
2019,1,28,8,231,158,389
2019,1,28,9,206,154,360
2019,1,28,10,194,169,363
2019,1,28,11,202,185,387
2019,1,28,12,189,191,380
2019,1,28,13,192,224,416
2019,1,28,14,198,295,493
2019,1,28,15,181,299,480
2019,1,28,16,201,195,396
2019,1,28,17,164,160,324
2019,1,28,18,106,137,243
2019,1,28,19,90,115,205
2019,1,28,20,74,91,165
2019,1,28,21,65,81,146
2019,1,28,22,25,29,54
2019,1,28,23,15,28,43
2019,1,29,0,10,16,26
2019,1,29,1,8,9,17
2019,1,29,2,6,11,17
2019,1,29,3,8,3,11
2019,1,29,4,23,9,32
2019,1,29,5,116,54,170
2019,1,29,6,236,124,360
2019,1,29,7,392,201,593
2019,1,29,8,229,160,389
2019,1,29,9,200,169,369
2019,1,29,10,201,151,352
2019,1,29,11,164,163,327
2019,1,29,12,194,183,377
2019,1,29,13,191,228,419
2019,1,29,14,210,267,477
2019,1,29,15,200,304,504
2019,1,29,16,179,162,341
2019,1,29,17,151,129,280
2019,1,29,18,132,128,260
2019,1,29,19,82,110,192
2019,1,29,20,68,107,175
2019,1,29,21,44,62,106
2019,1,29,22,19,42,61
2019,1,29,23,12,23,35
2019,1,30,0,10,22,32
2019,1,30,1,10,13,23
2019,1,30,2,14,45,59
2019,1,30,3,9,11,20
2019,1,30,4,17,13,30
2019,1,30,5,108,46,154
2019,1,30,6,236,142,378
2019,1,30,7,395,200,595
2019,1,30,8,256,144,400
2019,1,30,9,189,160,349
2019,1,30,10,226,170,396
2019,1,30,11,206,200,406
2019,1,30,12,203,194,397
2019,1,30,13,222,227,449
2019,1,30,14,216,322,538
2019,1,30,15,229,310,539
2019,1,30,16,201,214,415
2019,1,30,17,179,159,338
2019,1,30,18,134,129,263
2019,1,30,19,97,120,217
2019,1,30,20,76,107,183
2019,1,30,21,46,80,126
2019,1,30,22,27,42,69
2019,1,30,23,18,33,51
2019,1,31,0,6,18,24
2019,1,31,1,5,18,23
2019,1,31,2,12,13,25
2019,1,31,3,5,11,16
2019,1,31,4,17,13,30
2019,1,31,5,119,44,163
2019,1,31,6,254,128,382
2019,1,31,7,395,184,579
2019,1,31,8,270,155,425
2019,1,31,9,206,164,370
2019,1,31,10,211,177,388
2019,1,31,11,246,218,464
2019,1,31,12,220,210,430
2019,1,31,13,222,223,445
2019,1,31,14,232,315,547
2019,1,31,15,194,293,487
2019,1,31,16,177,192,369
2019,1,31,17,163,176,339
2019,1,31,18,124,130,254
2019,1,31,19,93,102,195
2019,1,31,20,83,124,207
2019,1,31,21,72,91,163
2019,1,31,22,49,49,98
2019,1,31,23,28,34,62
2019,2,1,0,19,40,59
2019,2,1,1,8,43,51
2019,2,1,2,8,35,43
2019,2,1,3,6,31,37
2019,2,1,4,20,35,55
2019,2,1,5,102,46,148
2019,2,1,6,227,128,355
2019,2,1,7,277,181,458
2019,2,1,8,234,145,379
2019,2,1,9,230,137,367
2019,2,1,10,231,183,414
2019,2,1,11,197,177,374
2019,2,1,12,202,217,419
2019,2,1,13,215,253,468
2019,2,1,14,253,322,575
2019,2,1,15,185,252,437
2019,2,1,16,150,166,316
2019,2,1,17,124,131,255
2019,2,1,18,108,120,228
2019,2,1,19,72,109,181
2019,2,1,20,62,72,134
2019,2,1,21,51,58,109
2019,2,1,22,45,54,99
2019,2,1,23,34,51,85
2019,2,2,0,22,36,58
2019,2,2,1,16,47,63
2019,2,2,2,20,47,67
2019,2,2,3,12,23,35
2019,2,2,4,8,15,23
2019,2,2,5,29,16,45
2019,2,2,6,23,33,56
2019,2,2,7,31,25,56
2019,2,2,8,53,34,87
2019,2,2,9,76,58,134
2019,2,2,10,104,76,180
2019,2,2,11,129,97,226
2019,2,2,12,126,130,256
2019,2,2,13,157,140,297
2019,2,2,14,129,156,285
2019,2,2,15,109,141,250
2019,2,2,16,135,127,262
2019,2,2,17,118,112,230
2019,2,2,18,90,97,187
2019,2,2,19,70,81,151
2019,2,2,20,56,77,133
2019,2,2,21,35,68,103
2019,2,2,22,33,55,88
2019,2,2,23,35,60,95
2019,2,3,0,29,31,60
2019,2,3,1,27,44,71
2019,2,3,2,21,65,86
2019,2,3,3,14,35,49
2019,2,3,4,16,17,33
2019,2,3,5,16,16,32
2019,2,3,6,21,13,34
2019,2,3,7,29,10,39
2019,2,3,8,32,43,75
2019,2,3,9,96,42,138
2019,2,3,10,55,46,101
2019,2,3,13,169,167,336
2019,2,3,14,133,166,299
2019,2,3,15,131,184,315
2019,2,3,16,143,153,296
2019,2,3,17,136,118,254
2019,2,3,18,127,141,268
2019,2,3,19,101,139,240
2019,2,3,20,62,95,157
2019,2,3,21,63,59,122
2019,2,3,22,22,36,58
2019,2,3,23,18,21,39
2019,2,4,0,12,13,25
2019,2,4,1,7,15,22
2019,2,4,2,4,8,12
2019,2,4,3,10,13,23
2019,2,4,4,22,16,38
2019,2,4,5,105,54,159
2019,2,4,6,221,135,356
2019,2,4,7,366,190,556
2019,2,4,8,240,135,375
2019,2,4,9,187,147,334
2019,2,4,10,181,168,349
2019,2,4,11,179,188,367
2019,2,4,12,169,188,357
2019,2,4,13,202,239,441
2019,2,4,14,227,289,516
2019,2,4,15,187,308,495
2019,2,4,16,180,180,360
2019,2,4,17,162,142,304
2019,2,4,18,106,133,239
2019,2,4,19,101,114,215
2019,2,4,20,75,93,168
2019,2,4,21,53,68,121
2019,2,4,22,27,30,57
2019,2,4,23,21,20,41
2019,2,5,0,17,17,34
2019,2,5,1,4,13,17
2019,2,5,2,7,6,13
2019,2,5,3,11,7,18
2019,2,5,4,16,14,30
2019,2,5,5,102,54,156
2019,2,5,6,232,123,355
2019,2,5,7,374,193,567
2019,2,5,8,252,143,395
2019,2,5,9,227,149,376
2019,2,5,10,227,171,398
2019,2,5,11,178,195,373
2019,2,5,12,202,201,403
2019,2,5,13,224,222,446
2019,2,5,14,242,308,550
2019,2,5,15,222,364,586
2019,2,5,16,196,164,360
2019,2,5,17,176,142,318
2019,2,5,18,153,158,311
2019,2,5,19,85,109,194
2019,2,5,20,75,121,196
2019,2,5,21,74,86,160
2019,2,5,22,39,46,85
2019,2,5,23,20,29,49
2019,2,6,0,7,11,18
2019,2,6,1,7,7,14
2019,2,6,2,12,12,24
2019,2,6,3,18,3,21
2019,2,6,4,21,16,37
2019,2,6,5,119,47,166
2019,2,6,6,237,117,354
2019,2,6,7,410,181,591
2019,2,6,8,241,142,383
2019,2,6,9,211,160,371
2019,2,6,10,184,169,353
2019,2,6,11,189,166,355
2019,2,6,12,197,197,394
2019,2,6,13,175,253,428
2019,2,6,14,234,301,535
2019,2,6,15,222,301,523
2019,2,6,16,162,183,345
2019,2,6,17,179,170,349
2019,2,6,18,143,148,291
2019,2,6,19,102,101,203
2019,2,6,20,65,123,188
2019,2,6,21,50,91,141
2019,2,6,22,31,63,94
2019,2,6,23,18,25,43
2019,2,7,0,9,12,21
2019,2,7,1,6,19,25
2019,2,7,2,5,15,20
2019,2,7,3,8,13,21
2019,2,7,4,17,14,31
2019,2,7,5,115,48,163
2019,2,7,6,211,132,343
2019,2,7,7,388,178,566
2019,2,7,8,248,125,373
2019,2,7,9,198,172,370
2019,2,7,10,207,166,373
2019,2,7,11,197,203,400
2019,2,7,12,195,208,403
2019,2,7,13,222,260,482
2019,2,7,14,261,309,570
2019,2,7,15,219,293,512
2019,2,7,16,205,201,406
2019,2,7,17,156,163,319
2019,2,7,18,126,140,266
2019,2,7,19,97,125,222
2019,2,7,20,77,96,173
2019,2,7,21,52,82,134
2019,2,7,22,32,61,93
2019,2,7,23,18,39,57
2019,2,8,0,14,23,37
2019,2,8,1,14,21,35
2019,2,8,2,7,16,23
2019,2,8,3,8,11,19
2019,2,8,4,17,6,23
2019,2,8,5,114,49,163
2019,2,8,6,228,127,355
2019,2,8,7,383,199,582
2019,2,8,8,260,170,430
2019,2,8,9,213,164,377
2019,2,8,10,198,158,356
2019,2,8,11,175,209,384
2019,2,8,12,197,196,393
2019,2,8,13,229,270,499
2019,2,8,14,302,343,645
2019,2,8,15,189,327,516
2019,2,8,16,158,184,342
2019,2,8,17,119,125,244
2019,2,8,18,108,103,211
2019,2,8,19,80,82,162
2019,2,8,20,70,94,164
2019,2,8,21,49,70,119
2019,2,8,22,35,36,71
2019,2,8,23,28,46,74
2019,2,9,0,22,29,51
2019,2,9,1,22,31,53
2019,2,9,2,12,37,49
2019,2,9,3,14,25,39
2019,2,9,4,13,10,23
2019,2,9,5,30,4,34
2019,2,9,6,30,32,62
2019,2,9,7,37,29,66
2019,2,9,8,71,44,115
2019,2,9,9,87,49,136
2019,2,9,10,119,100,219
2019,2,9,11,154,132,286
2019,2,9,12,148,137,285
2019,2,9,13,149,155,304
2019,2,9,14,126,146,272
2019,2,9,15,133,150,283
2019,2,9,16,111,149,260
2019,2,9,17,145,125,270
2019,2,9,18,129,129,258
2019,2,9,19,70,91,161
2019,2,9,20,56,73,129
2019,2,9,21,42,189,231
2019,2,9,22,35,218,253
2019,2,9,23,40,67,107
2019,2,10,0,28,44,72
2019,2,10,1,32,54,86
2019,2,10,2,24,54,78
2019,2,10,3,18,44,62
2019,2,10,4,18,13,31
2019,2,10,5,16,13,29
2019,2,10,6,19,20,39
2019,2,10,7,29,15,44
2019,2,10,8,52,31,83
2019,2,10,9,72,55,127
2019,2,10,10,107,79,186
2019,2,10,11,116,133,249
2019,2,10,12,147,162,309
2019,2,10,13,164,180,344
2019,2,10,14,148,165,313
2019,2,10,15,163,186,349
2019,2,10,16,141,153,294
2019,2,10,17,141,124,265
2019,2,10,18,127,132,259
2019,2,10,19,108,112,220
2019,2,10,20,82,92,174
2019,2,10,21,58,74,132
2019,2,10,22,31,32,63
2019,2,10,23,18,21,39
2019,2,11,0,3,7,10
2019,2,11,1,4,8,12
2019,2,11,2,7,14,21
2019,2,11,3,13,14,27
2019,2,11,4,25,5,30
2019,2,11,5,125,52,177
2019,2,11,6,219,142,361
2019,2,11,7,399,183,582
2019,2,11,8,255,148,403
2019,2,11,9,199,155,354
2019,2,11,10,204,161,365
2019,2,11,11,180,174,354
2019,2,11,12,198,195,393
2019,2,11,13,178,223,401
2019,2,11,14,232,310,542
2019,2,11,15,177,298,475
2019,2,11,16,200,187,387
2019,2,11,17,154,147,301
2019,2,11,18,122,126,248
2019,2,11,19,85,123,208
2019,2,11,20,81,131,212
2019,2,11,21,54,70,124
2019,2,11,22,32,39,71
2019,2,11,23,18,17,35
2019,2,12,0,8,13,21
2019,2,12,1,7,9,16
2019,2,12,2,6,6,12
2019,2,12,3,10,6,16
2019,2,12,4,27,8,35
2019,2,12,5,131,47,178
2019,2,12,6,223,124,347
2019,2,12,7,408,200,608
2019,2,12,8,247,171,418
2019,2,12,9,222,162,384
2019,2,12,10,190,184,374
2019,2,12,11,188,184,372
2019,2,12,12,206,183,389
2019,2,12,13,189,256,445
2019,2,12,14,240,327,567
2019,2,12,15,224,307,531
2019,2,12,16,170,182,352
2019,2,12,17,181,158,339
2019,2,12,18,156,117,273
2019,2,12,19,100,132,232
2019,2,12,20,70,116,186
2019,2,12,21,46,90,136
2019,2,12,22,40,156,196
2019,2,12,23,10,14,24
2019,2,13,0,14,13,27
2019,2,13,1,6,5,11
2019,2,13,2,5,9,14
2019,2,13,3,9,13,22
2019,2,13,4,17,5,22
2019,2,13,5,107,53,160
2019,2,13,6,252,117,369
2019,2,13,7,396,175,571
2019,2,13,8,242,150,392
2019,2,13,9,228,163,391
2019,2,13,10,206,151,357
2019,2,13,11,177,168,345
2019,2,13,12,195,197,392
2019,2,13,13,203,256,459
2019,2,13,14,281,345,626
2019,2,13,15,207,320,527
2019,2,13,16,183,205,388
2019,2,13,17,174,151,325
2019,2,13,18,130,142,272
2019,2,13,19,100,109,209
2019,2,13,20,68,99,167
2019,2,13,21,34,71,105
2019,2,13,22,18,50,68
2019,2,13,23,11,30,41
2019,2,14,0,6,17,23
2019,2,14,1,3,9,12
2019,2,14,2,5,19,24
2019,2,14,3,10,14,24
2019,2,14,4,16,13,29
2019,2,14,5,125,49,174
2019,2,14,6,231,138,369
2019,2,14,7,427,214,641
2019,2,14,8,276,130,406
2019,2,14,9,226,177,403
2019,2,14,10,188,169,357
2019,2,14,11,182,191,373
2019,2,14,12,215,201,416
2019,2,14,13,223,240,463
2019,2,14,14,262,326,588
2019,2,14,15,213,323,536
2019,2,14,16,183,179,362
2019,2,14,17,185,170,355
2019,2,14,18,113,161,274
2019,2,14,19,96,123,219
2019,2,14,20,60,118,178
2019,2,14,21,60,86,146
2019,2,14,22,22,35,57
2019,2,14,23,14,22,36
2019,2,15,0,10,22,32
2019,2,15,1,14,27,41
2019,2,15,2,8,36,44
2019,2,15,3,10,12,22
2019,2,15,4,21,16,37
2019,2,15,5,127,39,166
2019,2,15,6,231,133,364
2019,2,15,7,379,180,559
2019,2,15,8,272,129,401
2019,2,15,9,221,154,375
2019,2,15,10,219,159,378
2019,2,15,11,190,194,384
2019,2,15,12,234,216,450
2019,2,15,13,209,266,475
2019,2,15,14,275,336,611
2019,2,15,15,162,267,429
2019,2,15,16,188,184,372
2019,2,15,17,137,153,290
2019,2,15,18,125,139,264
2019,2,15,19,85,103,188
2019,2,15,20,75,94,169
2019,2,15,21,54,80,134
2019,2,15,22,56,67,123
2019,2,15,23,35,62,97
2019,2,16,0,24,28,52
2019,2,16,1,17,36,53
2019,2,16,2,13,40,53
2019,2,16,3,12,11,23
2019,2,16,4,12,18,30
2019,2,16,5,25,14,39
2019,2,16,6,22,18,40
2019,2,16,7,41,29,70
2019,2,16,8,70,50,120
2019,2,16,9,120,70,190
2019,2,16,10,127,105,232
2019,2,16,11,142,127,269
2019,2,16,12,144,134,278
2019,2,16,13,156,174,330
2019,2,16,14,144,210,354
2019,2,16,15,126,166,292
2019,2,16,16,123,160,283
2019,2,16,17,132,126,258
2019,2,16,18,88,98,186
2019,2,16,19,64,109,173
2019,2,16,20,52,64,116
2019,2,16,21,52,62,114
2019,2,16,22,42,62,104
2019,2,16,23,44,51,95
2019,2,17,0,30,55,85
2019,2,17,1,34,54,88
2019,2,17,2,18,56,74
2019,2,17,3,16,37,53
2019,2,17,4,23,18,41
2019,2,17,5,18,14,32
2019,2,17,6,16,12,28
2019,2,17,7,33,16,49
2019,2,17,8,53,30,83
2019,2,17,9,99,42,141
2019,2,17,10,122,71,193
2019,2,17,11,133,131,264
2019,2,17,12,155,151,306
2019,2,17,13,157,176,333
2019,2,17,14,160,199,359
2019,2,17,15,143,224,367
2019,2,17,16,134,161,295
2019,2,17,17,143,154,297
2019,2,17,18,145,123,268
2019,2,17,19,89,118,207
2019,2,17,20,70,107,177
2019,2,17,21,47,72,119
2019,2,17,22,26,40,66
2019,2,17,23,10,20,30
2019,2,18,0,13,15,28
2019,2,18,1,8,15,23
2019,2,18,2,2,8,10
2019,2,18,3,11,11,22
2019,2,18,4,26,17,43
2019,2,18,5,126,58,184
2019,2,18,6,228,128,356
2019,2,18,7,422,176,598
2019,2,18,8,240,138,378
2019,2,18,9,216,157,373
2019,2,18,10,192,147,339
2019,2,18,11,204,178,382
2019,2,18,12,185,190,375
2019,2,18,13,180,257,437
2019,2,18,14,213,302,515
2019,2,18,15,179,292,471
2019,2,18,16,193,210,403
2019,2,18,17,169,160,329
2019,2,18,18,136,130,266
2019,2,18,19,117,140,257
2019,2,18,20,60,86,146
2019,2,18,21,58,81,139
2019,2,18,22,22,46,68
2019,2,18,23,13,20,33
2019,2,19,0,8,11,19
2019,2,19,1,3,9,12
2019,2,19,2,10,8,18
2019,2,19,3,16,9,25
2019,2,19,4,30,15,45
2019,2,19,5,132,55,187
2019,2,19,6,265,144,409
2019,2,19,7,462,217,679
2019,2,19,8,282,163,445
2019,2,19,9,218,202,420
2019,2,19,10,230,177,407
2019,2,19,11,208,188,396
2019,2,19,12,218,183,401
2019,2,19,13,228,273,501
2019,2,19,14,243,291,534
2019,2,19,15,223,335,558
2019,2,19,16,211,198,409
2019,2,19,17,178,175,353
2019,2,19,18,136,169,305
2019,2,19,19,101,146,247
2019,2,19,20,86,125,211
2019,2,19,21,49,78,127
2019,2,19,22,47,66,113
2019,2,19,23,22,15,37
2019,2,20,0,9,21,30
2019,2,20,1,11,31,42
2019,2,20,2,4,19,23
2019,2,20,3,14,24,38
2019,2,20,4,21,12,33
2019,2,20,5,109,53,162
2019,2,20,6,231,135,366
2019,2,20,7,451,199,650
2019,2,20,8,316,163,479
2019,2,20,9,223,182,405
2019,2,20,10,227,176,403
2019,2,20,11,193,208,401
2019,2,20,12,217,213,430
2019,2,20,13,194,246,440
2019,2,20,14,269,346,615
2019,2,20,15,237,295,532
2019,2,20,16,209,218,427
2019,2,20,17,168,172,340
2019,2,20,18,155,174,329
2019,2,20,19,104,125,229
2019,2,20,20,88,100,188
2019,2,20,21,47,80,127
2019,2,20,22,48,50,98
2019,2,20,23,17,17,34
2019,2,21,0,10,20,30
2019,2,21,1,12,19,31
2019,2,21,2,4,21,25
2019,2,21,3,7,10,17
2019,2,21,4,19,18,37
2019,2,21,5,116,60,176
2019,2,21,6,232,132,364
2019,2,21,7,449,221,670
2019,2,21,8,270,132,402
2019,2,21,9,230,159,389
2019,2,21,10,210,189,399
2019,2,21,11,211,204,415
2019,2,21,12,220,202,422
2019,2,21,13,213,239,452
2019,2,21,14,223,325,548
2019,2,21,15,213,306,519
2019,2,21,16,186,172,358
2019,2,21,17,162,162,324
2019,2,21,18,130,159,289
2019,2,21,19,91,122,213
2019,2,21,20,80,114,194
2019,2,21,21,65,87,152
2019,2,21,22,40,63,103
2019,2,21,23,20,47,67
2019,2,22,0,14,24,38
2019,2,22,1,5,26,31
2019,2,22,2,11,25,36
2019,2,22,3,11,17,28
2019,2,22,4,20,15,35
2019,2,22,5,120,53,173
2019,2,22,6,249,136,385
2019,2,22,7,398,192,590
2019,2,22,8,262,144,406
2019,2,22,9,220,171,391
2019,2,22,10,248,175,423
2019,2,22,11,168,221,389
2019,2,22,12,224,209,433
2019,2,22,13,235,363,598
2019,2,22,14,267,340,607
2019,2,22,15,172,291,463
2019,2,22,16,148,176,324
2019,2,22,17,126,133,259
2019,2,22,18,103,125,228
2019,2,22,19,80,81,161
2019,2,22,20,51,73,124
2019,2,22,21,44,64,108
2019,2,22,22,45,50,95
2019,2,22,23,28,45,73
2019,2,23,0,31,41,72
2019,2,23,1,16,32,48
2019,2,23,2,11,27,38
2019,2,23,3,21,24,45
2019,2,23,4,11,8,19
2019,2,23,5,21,11,32
2019,2,23,6,24,25,49
2019,2,23,7,37,36,73
2019,2,23,8,66,48,114
2019,2,23,9,87,55,142
2019,2,23,10,107,85,192
2019,2,23,11,125,108,233
2019,2,23,12,117,125,242
2019,2,23,13,149,171,320
2019,2,23,14,120,161,281
2019,2,23,15,135,146,281
2019,2,23,16,113,160,273
2019,2,23,17,128,138,266
2019,2,23,18,90,118,208
2019,2,23,19,67,91,158
2019,2,23,20,37,70,107
2019,2,23,21,34,74,108
2019,2,23,22,47,62,109
2019,2,23,23,43,64,107
2019,2,24,0,23,37,60
2019,2,24,1,20,49,69
2019,2,24,2,15,44,59
2019,2,24,3,13,26,39
2019,2,24,4,6,8,14
2019,2,24,5,17,22,39
2019,2,24,6,10,18,28
2019,2,24,7,28,13,41
2019,2,24,8,45,45,90
2019,2,24,9,81,48,129
2019,2,24,10,81,75,156
2019,2,24,11,116,117,233
2019,2,24,12,140,155,295
2019,2,24,13,150,165,315
2019,2,24,14,136,151,287
2019,2,24,15,114,172,286
2019,2,24,16,145,134,279
2019,2,24,17,104,124,228
2019,2,24,18,100,115,215
2019,2,24,19,82,130,212
2019,2,24,20,67,73,140
2019,2,24,21,46,62,108
2019,2,24,22,34,42,76
2019,2,24,23,14,20,34
2019,2,25,0,10,6,16
2019,2,25,1,6,7,13
2019,2,25,2,6,9,15
2019,2,25,3,10,6,16
2019,2,25,4,16,6,22
2019,2,25,5,118,59,177
2019,2,25,6,225,116,341
2019,2,25,7,283,160,443
2019,2,25,8,237,146,383
2019,2,25,9,221,150,371
2019,2,25,10,184,175,359
2019,2,25,11,190,183,373
2019,2,25,12,197,219,416
2019,2,25,13,212,230,442
2019,2,25,14,185,276,461
2019,2,25,15,193,279,472
2019,2,25,16,151,165,316
2019,2,25,17,132,131,263
2019,2,25,18,98,118,216
2019,2,25,19,95,118,213
2019,2,25,20,72,91,163
2019,2,25,21,56,68,124
2019,2,25,22,23,30,53
2019,2,25,23,15,17,32
2019,2,26,0,16,10,26
2019,2,26,1,3,11,14
2019,2,26,2,4,10,14
2019,2,26,3,9,5,14
2019,2,26,4,16,7,23
2019,2,26,5,112,38,150
2019,2,26,6,211,114,325
2019,2,26,7,311,161,472
2019,2,26,8,210,151,361
2019,2,26,9,181,123,304
2019,2,26,10,208,168,376
2019,2,26,11,154,165,319
2019,2,26,12,169,198,367
2019,2,26,13,222,213,435
2019,2,26,14,183,279,462
2019,2,26,15,188,274,462
2019,2,26,16,159,169,328
2019,2,26,17,171,143,314
2019,2,26,18,122,114,236
2019,2,26,19,99,111,210
2019,2,26,20,61,83,144
2019,2,26,21,48,76,124
2019,2,26,22,26,71,97
2019,2,26,23,17,40,57
2019,2,27,0,12,30,42
2019,2,27,1,7,8,15
2019,2,27,2,5,19,24
2019,2,27,3,5,10,15
2019,2,27,4,17,6,23
2019,2,27,5,104,50,154
2019,2,27,6,212,115,327
2019,2,27,7,270,157,427
2019,2,27,8,227,128,355
2019,2,27,9,190,162,352
2019,2,27,10,199,160,359
2019,2,27,11,207,157,364
2019,2,27,12,183,204,387
2019,2,27,13,176,230,406
2019,2,27,14,202,235,437
2019,2,27,15,175,279,454
2019,2,27,16,146,133,279
2019,2,27,17,151,157,308
2019,2,27,18,109,106,215
2019,2,27,19,89,107,196
2019,2,27,20,52,95,147
2019,2,27,21,55,68,123
2019,2,27,22,33,40,73
2019,2,27,23,16,28,44
2019,2,28,0,13,20,33
2019,2,28,1,3,14,17
2019,2,28,2,9,14,23
2019,2,28,3,12,10,22
2019,2,28,4,17,11,28
2019,2,28,5,99,51,150
2019,2,28,6,211,119,330
2019,2,28,7,267,133,400
2019,2,28,8,225,124,349
2019,2,28,9,179,148,327
2019,2,28,10,182,168,350
2019,2,28,11,167,200,367
2019,2,28,12,172,182,354
2019,2,28,13,165,211,376
2019,2,28,14,232,261,493
2019,2,28,15,172,275,447
2019,2,28,16,134,164,298
2019,2,28,17,138,130,268
2019,2,28,18,119,105,224
2019,2,28,19,76,113,189
2019,2,28,20,75,88,163
2019,2,28,21,51,75,126
2019,2,28,22,24,36,60
2019,2,28,23,21,21,42
2019,3,1,0,7,16,23
2019,3,1,1,14,23,37
2019,3,1,2,8,25,33
2019,3,1,3,7,14,21
2019,3,1,4,17,8,25
2019,3,1,5,94,48,142
2019,3,1,6,190,117,307
2019,3,1,7,261,129,390
2019,3,1,8,185,115,300
2019,3,1,9,165,146,311
2019,3,1,10,160,142,302
2019,3,1,11,189,196,385
2019,3,1,12,176,165,341
2019,3,1,13,204,216,420
2019,3,1,14,191,246,437
2019,3,1,15,161,230,391
2019,3,1,16,145,160,305
2019,3,1,17,118,154,272
2019,3,1,18,102,104,206
2019,3,1,19,79,109,188
2019,3,1,20,66,80,146
2019,3,1,21,54,60,114
2019,3,1,22,35,59,94
2019,3,1,23,27,45,72
2019,3,2,0,20,21,41
2019,3,2,1,17,38,55
2019,3,2,2,22,34,56
2019,3,2,3,13,25,38
2019,3,2,4,12,7,19
2019,3,2,5,18,19,37
2019,3,2,6,24,25,49
2019,3,2,7,37,25,62
2019,3,2,8,43,40,83
2019,3,2,9,78,56,134
2019,3,2,10,99,92,191
2019,3,2,11,136,128,264
2019,3,2,12,115,128,243
2019,3,2,13,130,167,297
2019,3,2,14,111,138,249
2019,3,2,15,119,129,248
2019,3,2,16,100,130,230
2019,3,2,17,104,122,226
2019,3,2,18,104,106,210
2019,3,2,19,71,74,145
2019,3,2,20,44,66,110
2019,3,2,21,35,63,98
2019,3,2,22,44,52,96
2019,3,2,23,35,48,83
2019,3,3,0,24,37,61
2019,3,3,1,27,46,73
2019,3,3,2,28,40,68
2019,3,3,3,19,31,50
2019,3,3,4,9,18,27
2019,3,3,5,17,13,30
2019,3,3,6,12,12,24
2019,3,3,7,20,14,34
2019,3,3,8,42,34,76
2019,3,3,9,89,55,144
2019,3,3,10,78,65,143
2019,3,3,11,125,121,246
2019,3,3,12,117,130,247
2019,3,3,13,154,156,310
2019,3,3,14,108,153,261
2019,3,3,15,121,191,312
2019,3,3,16,123,126,249
2019,3,3,17,129,128,257
2019,3,3,18,140,128,268
2019,3,3,19,107,121,228
2019,3,3,20,61,91,152
2019,3,3,21,49,60,109
2019,3,3,22,21,36,57
2019,3,3,23,17,17,34
2019,3,4,0,5,20,25
2019,3,4,1,3,7,10
2019,3,4,2,2,9,11
2019,3,4,3,9,7,16
2019,3,4,4,20,14,34
2019,3,4,5,116,52,168
2019,3,4,6,222,160,382
2019,3,4,7,399,194,593
2019,3,4,8,240,153,393
2019,3,4,9,197,163,360
2019,3,4,10,187,163,350
2019,3,4,11,179,171,350
2019,3,4,12,217,224,441
2019,3,4,13,202,232,434
2019,3,4,14,237,338,575
2019,3,4,15,234,292,526
2019,3,4,16,201,232,433
2019,3,4,17,163,151,314
2019,3,4,18,116,145,261
2019,3,4,19,108,123,231
2019,3,4,20,65,116,181
2019,3,4,21,46,67,113
2019,3,4,22,25,38,63
2019,3,4,23,22,22,44
2019,3,5,0,10,14,24
2019,3,5,1,5,7,12
2019,3,5,2,3,22,25
2019,3,5,3,12,10,22
2019,3,5,4,25,12,37
2019,3,5,5,125,40,165
2019,3,5,6,222,138,360
2019,3,5,7,400,190,590
2019,3,5,8,240,168,408
2019,3,5,9,222,170,392
2019,3,5,10,229,181,410
2019,3,5,11,217,195,412
2019,3,5,12,196,220,416
2019,3,5,13,219,240,459
2019,3,5,14,233,337,570
2019,3,5,15,199,516,715
2019,3,5,16,173,312,485
2019,3,5,17,174,165,339
2019,3,5,18,129,121,250
2019,3,5,19,92,127,219
2019,3,5,20,74,116,190
2019,3,5,21,49,91,140
2019,3,5,22,43,44,87
2019,3,5,23,13,19,32
2019,3,6,0,10,20,30
2019,3,6,1,6,15,21
2019,3,6,2,5,12,17
2019,3,6,3,9,6,15
2019,3,6,4,17,9,26
2019,3,6,5,114,41,155
2019,3,6,6,241,134,375
2019,3,6,7,407,184,591
2019,3,6,8,226,154,380
2019,3,6,9,221,128,349
2019,3,6,10,218,165,383
2019,3,6,11,200,202,402
2019,3,6,12,200,227,427
2019,3,6,13,222,273,495
2019,3,6,14,253,315,568
2019,3,6,15,225,325,550
2019,3,6,16,203,212,415
2019,3,6,17,183,174,357
2019,3,6,18,117,160,277
2019,3,6,19,103,136,239
2019,3,6,20,72,130,202
2019,3,6,21,63,56,119
2019,3,6,22,41,60,101
2019,3,6,23,21,29,50
2019,3,7,0,5,12,17
2019,3,7,1,5,15,20
2019,3,7,2,6,20,26
2019,3,7,3,18,8,26
2019,3,7,4,19,8,27
2019,3,7,5,111,41,152
2019,3,7,6,232,148,380
2019,3,7,7,403,200,603
2019,3,7,8,273,163,436
2019,3,7,9,203,159,362
2019,3,7,10,204,173,377
2019,3,7,11,207,200,407
2019,3,7,12,212,217,429
2019,3,7,13,191,222,413
2019,3,7,14,240,325,565
2019,3,7,15,213,302,515
2019,3,7,16,189,206,395
2019,3,7,17,189,187,376
2019,3,7,18,123,157,280
2019,3,7,19,87,123,210
2019,3,7,20,74,106,180
2019,3,7,21,60,237,297
2019,3,7,22,33,169,202
2019,3,7,23,19,51,70
2019,3,8,0,8,36,44
2019,3,8,1,12,44,56
2019,3,8,2,10,40,50
2019,3,8,3,9,30,39
2019,3,8,4,22,31,53
2019,3,8,5,130,51,181
2019,3,8,6,253,146,399
2019,3,8,7,399,190,589
2019,3,8,8,230,152,382
2019,3,8,9,200,156,356
2019,3,8,10,216,188,404
2019,3,8,11,224,213,437
2019,3,8,12,245,241,486
2019,3,8,13,207,270,477
2019,3,8,14,265,369,634
2019,3,8,15,196,306,502
2019,3,8,16,168,177,345
2019,3,8,17,138,148,286
2019,3,8,18,125,136,261
2019,3,8,19,77,105,182
2019,3,8,20,73,75,148
2019,3,8,21,56,70,126
2019,3,8,22,51,58,109
2019,3,8,23,29,52,81
2019,3,9,0,19,41,60
2019,3,9,1,19,41,60
2019,3,9,2,18,40,58
2019,3,9,3,11,20,31
2019,3,9,4,9,20,29
2019,3,9,5,20,10,30
2019,3,9,6,25,30,55
2019,3,9,7,33,25,58
2019,3,9,8,74,54,128
2019,3,9,9,93,67,160
2019,3,9,10,109,107,216
2019,3,9,11,142,135,277
2019,3,9,12,148,135,283
2019,3,9,13,125,160,285
2019,3,9,14,132,164,296
2019,3,9,15,135,172,307
2019,3,9,16,123,144,267
2019,3,9,17,111,127,238
2019,3,9,18,101,103,204
2019,3,9,19,76,97,173
2019,3,9,20,51,77,128
2019,3,9,21,41,63,104
2019,3,9,22,35,70,105
2019,3,9,23,49,67,116
2019,3,10,0,33,48,81
2019,3,10,1,30,60,90
2019,3,10,2,26,64,90
2019,3,10,3,13,35,48
2019,3,10,4,13,17,30
2019,3,10,5,14,10,24
2019,3,10,6,19,13,32
2019,3,10,7,30,21,51
2019,3,10,8,58,31,89
2019,3,10,9,86,43,129
2019,3,10,10,122,68,190
2019,3,10,11,161,154,315
2019,3,10,12,127,158,285
2019,3,10,13,157,199,356
2019,3,10,14,137,198,335
2019,3,10,15,149,205,354
2019,3,10,16,156,150,306
2019,3,10,17,120,133,253
2019,3,10,18,113,158,271
2019,3,10,19,119,120,239
2019,3,10,20,66,87,153
2019,3,10,21,55,74,129
2019,3,10,22,25,41,66
2019,3,10,23,14,14,28
2019,3,11,0,8,21,29
2019,3,11,1,7,2,9
2019,3,11,2,5,8,13
2019,3,11,3,8,4,12
2019,3,11,4,17,16,33
2019,3,11,5,128,49,177
2019,3,11,6,228,149,377
2019,3,11,7,397,213,610
2019,3,11,8,265,158,423
2019,3,11,9,200,136,336
2019,3,11,10,171,181,352
2019,3,11,11,205,201,406
2019,3,11,12,190,203,393
2019,3,11,13,171,238,409
2019,3,11,14,243,303,546
2019,3,11,15,188,327,515
2019,3,11,16,187,187,374
2019,3,11,17,182,178,360
2019,3,11,18,161,149,310
2019,3,11,19,102,131,233
2019,3,11,20,69,99,168
2019,3,11,21,55,72,127
2019,3,11,22,22,39,61
2019,3,11,23,17,21,38
2019,3,12,0,12,14,26
2019,3,12,1,3,8,11
2019,3,12,2,1,16,17
2019,3,12,3,6,21,27
2019,3,12,4,22,32,54
2019,3,12,5,118,58,176
2019,3,12,6,234,148,382
2019,3,12,7,454,202,656
2019,3,12,8,247,159,406
2019,3,12,9,199,167,366
2019,3,12,10,162,163,325
2019,3,12,11,222,196,418
2019,3,12,12,194,190,384
2019,3,12,13,209,250,459
2019,3,12,14,251,361,612
2019,3,12,15,254,329,583
2019,3,12,16,198,195,393
2019,3,12,17,213,141,354
2019,3,12,18,125,137,262
2019,3,12,19,88,146,234
2019,3,12,20,59,136,195
2019,3,12,21,42,82,124
2019,3,12,22,31,37,68
2019,3,12,23,11,13,24
2019,3,13,0,9,10,19
2019,3,13,1,3,9,12
2019,3,13,2,11,14,25
2019,3,13,3,9,7,16
2019,3,13,4,18,16,34
2019,3,13,5,109,45,154
2019,3,13,6,244,159,403
2019,3,13,7,430,186,616
2019,3,13,8,251,156,407
2019,3,13,9,210,162,372
2019,3,13,10,224,194,418
2019,3,13,11,219,217,436
2019,3,13,12,221,251,472
2019,3,13,13,179,262,441
2019,3,13,14,224,348,572
2019,3,13,15,233,304,537
2019,3,13,16,181,198,379
2019,3,13,17,182,181,363
2019,3,13,18,123,150,273
2019,3,13,19,140,144,284
2019,3,13,20,64,127,191
2019,3,13,21,62,76,138
2019,3,13,22,24,59,83
2019,3,13,23,15,30,45
2019,3,14,0,10,15,25
2019,3,14,1,17,14,31
2019,3,14,2,6,15,21
2019,3,14,3,11,10,21
2019,3,14,4,20,6,26
2019,3,14,5,112,58,170
2019,3,14,6,241,153,394
2019,3,14,7,435,159,594
2019,3,14,8,246,184,430
2019,3,14,9,198,163,361
2019,3,14,10,219,169,388
2019,3,14,11,184,194,378
2019,3,14,12,205,222,427
2019,3,14,13,211,238,449
2019,3,14,14,221,326,547
2019,3,14,15,219,304,523
2019,3,14,16,188,178,366
2019,3,14,17,196,149,345
2019,3,14,18,142,141,283
2019,3,14,19,97,133,230
2019,3,14,20,71,112,183
2019,3,14,21,49,101,150
2019,3,14,22,31,54,85
2019,3,14,23,9,28,37
2019,3,15,0,12,27,39
2019,3,15,1,16,29,45
2019,3,15,2,12,22,34
2019,3,15,3,6,10,16
2019,3,15,4,17,8,25
2019,3,15,5,110,53,163
2019,3,15,6,224,164,388
2019,3,15,7,406,194,600
2019,3,15,8,255,155,410
2019,3,15,9,203,177,380
2019,3,15,10,237,155,392
2019,3,15,11,220,222,442
2019,3,15,12,204,232,436
2019,3,15,13,213,281,494
2019,3,15,14,258,329,587
2019,3,15,15,179,289,468
2019,3,15,16,151,171,322
2019,3,15,17,145,137,282
2019,3,15,18,102,118,220
2019,3,15,19,88,110,198
2019,3,15,20,67,105,172
2019,3,15,21,60,69,129
2019,3,15,22,30,62,92
2019,3,15,23,17,33,50
2019,3,16,0,25,44,69
2019,3,16,1,24,38,62
2019,3,16,2,15,43,58
2019,3,16,3,15,30,45
2019,3,16,4,6,5,11
2019,3,16,5,27,19,46
2019,3,16,6,27,22,49
2019,3,16,7,48,33,81
2019,3,16,8,72,53,125
2019,3,16,9,125,93,218
2019,3,16,10,134,103,237
2019,3,16,11,140,142,282
2019,3,16,12,158,158,316
2019,3,16,13,120,173,293
2019,3,16,14,154,154,308
2019,3,16,15,155,163,318
2019,3,16,16,123,150,273
2019,3,16,17,134,135,269
2019,3,16,18,128,130,258
2019,3,16,19,81,96,177
2019,3,16,20,60,67,127
2019,3,16,21,37,68,105
2019,3,16,22,48,76,124
2019,3,16,23,44,72,116
2019,3,17,0,35,59,94
2019,3,17,1,25,67,92
2019,3,17,2,33,75,108
2019,3,17,3,13,44,57
2019,3,17,4,14,14,28
2019,3,17,5,16,18,34
2019,3,17,6,22,15,37
2019,3,17,7,30,24,54
2019,3,17,8,53,43,96
2019,3,17,9,100,53,153
2019,3,17,10,118,88,206
2019,3,17,11,143,155,298
2019,3,17,12,128,179,307
2019,3,17,13,188,197,385
2019,3,17,14,174,198,372
2019,3,17,15,126,208,334
2019,3,17,16,138,176,314
2019,3,17,17,150,137,287
2019,3,17,18,130,137,267
2019,3,17,19,118,134,252
2019,3,17,20,63,78,141
2019,3,17,21,49,57,106
2019,3,17,22,28,38,66
2019,3,17,23,14,20,34
2019,3,18,0,9,12,21
2019,3,18,1,6,12,18
2019,3,18,2,3,7,10
2019,3,18,3,6,12,18
2019,3,18,4,23,7,30
2019,3,18,5,98,51,149
2019,3,18,6,242,147,389
2019,3,18,7,408,207,615
2019,3,18,8,244,129,373
2019,3,18,9,190,158,348
2019,3,18,10,185,165,350
2019,3,18,11,203,195,398
2019,3,18,12,182,202,384
2019,3,18,13,202,226,428
2019,3,18,14,220,310,530
2019,3,18,15,191,293,484
2019,3,18,16,206,201,407
2019,3,18,17,184,170,354
2019,3,18,18,128,136,264
2019,3,18,19,109,137,246
2019,3,18,20,73,109,182
2019,3,18,21,47,88,135
2019,3,18,22,23,30,53
2019,3,18,23,18,18,36
2019,3,19,0,9,16,25
2019,3,19,1,6,6,12
2019,3,19,2,3,8,11
2019,3,19,3,8,9,17
2019,3,19,4,18,10,28
2019,3,19,5,107,51,158
2019,3,19,6,276,147,423
2019,3,19,7,417,233,650
2019,3,19,8,254,167,421
2019,3,19,9,260,202,462
2019,3,19,10,226,180,406
2019,3,19,11,205,201,406
2019,3,19,12,194,218,412
2019,3,19,13,229,221,450
2019,3,19,14,253,313,566
2019,3,19,15,213,296,509
2019,3,19,16,191,191,382
2019,3,19,17,215,173,388
2019,3,19,18,120,152,272
2019,3,19,19,91,127,218
2019,3,19,20,73,126,199
2019,3,19,21,56,74,130
2019,3,19,22,26,35,61
2019,3,19,23,11,24,35
2019,3,20,0,15,22,37
2019,3,20,1,6,16,22
2019,3,20,2,2,12,14
2019,3,20,3,9,7,16
2019,3,20,4,24,17,41
2019,3,20,5,93,59,152
2019,3,20,6,249,152,401
2019,3,20,7,412,204,616
2019,3,20,8,285,178,463
2019,3,20,9,205,164,369
2019,3,20,10,200,188,388
2019,3,20,11,218,219,437
2019,3,20,12,217,202,419
2019,3,20,13,197,223,420
2019,3,20,14,243,316,559
2019,3,20,15,219,302,521
2019,3,20,16,209,205,414
2019,3,20,17,164,166,330
2019,3,20,18,121,163,284
2019,3,20,19,97,121,218
2019,3,20,20,85,102,187
2019,3,20,21,49,75,124
2019,3,20,22,25,85,110
2019,3,20,23,16,26,42
2019,3,21,0,13,15,28
2019,3,21,1,5,20,25
2019,3,21,2,7,13,20
2019,3,21,3,9,13,22
2019,3,21,4,18,7,25
2019,3,21,5,102,61,163
2019,3,21,6,264,141,405
2019,3,21,7,411,201,612
2019,3,21,8,280,159,439
2019,3,21,9,193,177,370
2019,3,21,10,218,163,381
2019,3,21,11,204,182,386
2019,3,21,12,195,202,397
2019,3,21,13,218,261,479
2019,3,21,14,251,297,548
2019,3,21,15,208,425,633
2019,3,21,16,214,235,449
2019,3,21,17,181,173,354
2019,3,21,18,132,149,281
2019,3,21,19,104,122,226
2019,3,21,20,80,109,189
2019,3,21,21,61,106,167
2019,3,21,22,24,47,71
2019,3,21,23,15,30,45
2019,3,22,0,11,35,46
2019,3,22,1,14,25,39
2019,3,22,2,7,25,32
2019,3,22,3,10,13,23
2019,3,22,4,19,14,33
2019,3,22,5,110,43,153
2019,3,22,6,257,142,399
2019,3,22,7,373,193,566
2019,3,22,8,260,151,411
2019,3,22,9,243,177,420
2019,3,22,10,229,212,441
2019,3,22,11,221,222,443
2019,3,22,12,216,211,427
2019,3,22,13,237,286,523
2019,3,22,14,267,338,605
2019,3,22,15,215,296,511
2019,3,22,16,144,186,330
2019,3,22,17,131,140,271
2019,3,22,18,121,138,259
2019,3,22,19,101,104,205
2019,3,22,20,61,106,167
2019,3,22,21,46,79,125
2019,3,22,22,36,61,97
2019,3,22,23,32,33,65
2019,3,23,0,21,36,57
2019,3,23,1,22,36,58
2019,3,23,2,13,32,45
2019,3,23,3,9,25,34
2019,3,23,4,10,14,24
2019,3,23,5,25,17,42
2019,3,23,6,22,21,43
2019,3,23,7,44,35,79
2019,3,23,8,60,56,116
2019,3,23,9,100,83,183
2019,3,23,10,98,97,195
2019,3,23,11,153,127,280
2019,3,23,12,143,158,301
2019,3,23,13,168,174,342
2019,3,23,14,151,177,328
2019,3,23,15,127,165,292
2019,3,23,16,115,140,255
2019,3,23,17,127,151,278
2019,3,23,18,113,124,237
2019,3,23,19,73,83,156
2019,3,23,20,56,74,130
2019,3,23,21,48,61,109
2019,3,23,22,52,76,128
2019,3,23,23,31,56,87
2019,3,24,0,35,50,85
2019,3,24,1,19,44,63
2019,3,24,2,23,53,76
2019,3,24,3,22,44,66
2019,3,24,4,6,19,25
2019,3,24,5,12,20,32
2019,3,24,6,26,15,41
2019,3,24,7,31,25,56
2019,3,24,8,42,33,75
2019,3,24,9,109,60,169
2019,3,24,10,129,102,231
2019,3,24,11,163,154,317
2019,3,24,12,135,176,311
2019,3,24,13,157,171,328
2019,3,24,14,166,183,349
2019,3,24,15,137,210,347
2019,3,24,16,156,179,335
2019,3,24,17,152,137,289
2019,3,24,18,121,133,254
2019,3,24,19,121,131,252
2019,3,24,20,88,111,199
2019,3,24,21,35,73,108
2019,3,24,22,35,36,71
2019,3,24,23,17,19,36
2019,3,25,0,8,9,17
2019,3,25,1,7,9,16
2019,3,25,2,5,9,14
2019,3,25,3,7,6,13
2019,3,25,4,25,13,38
2019,3,25,5,115,57,172
2019,3,25,6,237,148,385
2019,3,25,7,386,195,581
2019,3,25,8,244,149,393
2019,3,25,9,216,173,389
2019,3,25,10,207,181,388
2019,3,25,11,191,207,398
2019,3,25,12,183,201,384
2019,3,25,13,188,257,445
2019,3,25,14,207,303,510
2019,3,25,15,210,303,513
2019,3,25,16,221,190,411
2019,3,25,17,162,169,331
2019,3,25,18,118,142,260
2019,3,25,19,104,156,260
2019,3,25,20,72,103,175
2019,3,25,21,57,74,131
2019,3,25,22,27,43,70
2019,3,25,23,13,19,32
2019,3,26,0,8,13,21
2019,3,26,1,4,14,18
2019,3,26,2,5,9,14
2019,3,26,3,9,7,16
2019,3,26,4,24,7,31
2019,3,26,5,120,51,171
2019,3,26,6,251,156,407
2019,3,26,7,434,180,614
2019,3,26,8,243,157,400
2019,3,26,9,193,165,358
2019,3,26,10,206,173,379
2019,3,26,11,193,201,394
2019,3,26,12,168,193,361
2019,3,26,13,199,268,467
2019,3,26,14,244,333,577
2019,3,26,15,211,318,529
2019,3,26,16,212,191,403
2019,3,26,17,187,151,338
2019,3,26,18,149,139,288
2019,3,26,19,102,114,216
2019,3,26,20,66,121,187
2019,3,26,21,58,337,395
2019,3,26,22,35,174,209
2019,3,26,23,11,76,87
2019,3,27,0,8,50,58
2019,3,27,1,7,31,38
2019,3,27,2,3,32,35
2019,3,27,3,4,36,40
2019,3,27,4,22,35,57
2019,3,27,5,112,54,166
2019,3,27,6,260,142,402
2019,3,27,7,413,191,604
2019,3,27,8,248,173,421
2019,3,27,9,236,167,403
2019,3,27,10,206,169,375
2019,3,27,11,224,201,425
2019,3,27,12,217,222,439
2019,3,27,13,196,259,455
2019,3,27,14,223,329,552
2019,3,27,15,256,307,563
2019,3,27,16,192,208,400
2019,3,27,17,153,188,341
2019,3,27,18,137,159,296
2019,3,27,19,116,117,233
2019,3,27,20,82,108,190
2019,3,27,21,85,86,171
2019,3,27,22,48,52,100
2019,3,27,23,18,14,32
2019,3,28,0,15,17,32
2019,3,28,1,4,13,17
2019,3,28,2,9,14,23
2019,3,28,3,13,11,24
2019,3,28,4,22,12,34
2019,3,28,5,119,46,165
2019,3,28,6,253,129,382
2019,3,28,7,462,198,660
2019,3,28,8,263,174,437
2019,3,28,9,205,168,373
2019,3,28,10,196,177,373
2019,3,28,11,225,205,430
2019,3,28,12,195,221,416
2019,3,28,13,194,262,456
2019,3,28,14,271,339,610
2019,3,28,15,215,309,524
2019,3,28,16,202,203,405
2019,3,28,17,175,164,339
2019,3,28,18,155,166,321
2019,3,28,19,96,137,233
2019,3,28,20,77,119,196
2019,3,28,21,61,98,159
2019,3,28,22,27,47,74
2019,3,28,23,21,27,48
2019,3,29,0,11,24,35
2019,3,29,1,15,24,39
2019,3,29,2,6,25,31
2019,3,29,3,10,11,21
2019,3,29,4,23,6,29
2019,3,29,5,119,49,168
2019,3,29,6,248,150,398
2019,3,29,7,360,168,528
2019,3,29,8,255,158,413
2019,3,29,9,229,165,394
2019,3,29,10,234,199,433
2019,3,29,11,221,208,429
2019,3,29,12,192,211,403
2019,3,29,13,249,282,531
2019,3,29,14,278,345,623
2019,3,29,15,198,315,513
2019,3,29,16,153,158,311
2019,3,29,17,134,166,300
2019,3,29,18,144,138,282
2019,3,29,19,91,92,183
2019,3,29,20,59,82,141
2019,3,29,21,56,73,129
2019,3,29,22,36,54,90
2019,3,29,23,30,49,79
2019,3,30,0,18,42,60
2019,3,30,1,13,30,43
2019,3,30,2,15,40,55
2019,3,30,3,11,25,36
2019,3,30,4,10,15,25
2019,3,30,5,19,12,31
2019,3,30,6,29,31,60
2019,3,30,7,46,25,71
2019,3,30,8,94,43,137
2019,3,30,9,125,92,217
2019,3,30,10,147,130,277
2019,3,30,11,166,164,330
2019,3,30,12,146,178,324
2019,3,30,13,159,165,324
2019,3,30,14,165,212,377
2019,3,30,15,117,174,291
2019,3,30,16,120,146,266
2019,3,30,17,138,153,291
2019,3,30,18,89,118,207
2019,3,30,19,83,90,173
2019,3,30,20,62,63,125
2019,3,30,21,40,69,109
2019,3,30,22,50,67,117
2019,3,30,23,37,68,105
2019,3,31,0,33,44,77
2019,3,31,1,33,55,88
2019,3,31,2,18,53,71
2019,3,31,3,18,32,50
2019,3,31,4,12,9,21
2019,3,31,5,19,17,36
2019,3,31,6,22,21,43
2019,3,31,7,34,34,68
2019,3,31,8,88,53,141
2019,3,31,9,112,82,194
2019,3,31,10,160,135,295
2019,3,31,11,149,188,337
2019,3,31,12,182,194,376
2019,3,31,13,164,193,357
2019,3,31,14,152,228,380
2019,3,31,15,145,150,295
2019,3,31,16,123,148,271
2019,3,31,17,128,126,254
2019,3,31,18,110,153,263
2019,3,31,19,77,110,187
2019,3,31,20,61,80,141
2019,3,31,21,34,42,76
2019,3,31,22,14,18,32
2019,3,31,23,15,11,26
2019,4,1,0,10,14,24
2019,4,1,1,12,12,24
2019,4,1,2,6,7,13
2019,4,1,3,24,11,35
2019,4,1,4,101,60,161
2019,4,1,5,248,147,395
2019,4,1,6,400,193,593
2019,4,1,7,256,165,421
2019,4,1,8,201,153,354
2019,4,1,9,190,170,360
2019,4,1,10,187,157,344
2019,4,1,11,211,211,422
2019,4,1,12,221,253,474
2019,4,1,13,205,313,518
2019,4,1,14,198,281,479
2019,4,1,15,171,191,362
2019,4,1,16,169,170,339
2019,4,1,17,147,166,313
2019,4,1,18,99,142,241
2019,4,1,19,93,108,201
2019,4,1,20,52,65,117
2019,4,1,21,30,34,64
2019,4,1,22,13,14,27
2019,4,1,23,6,14,20
2019,4,2,0,8,7,15
2019,4,2,1,3,12,15
2019,4,2,2,9,5,14
2019,4,2,3,16,8,24
2019,4,2,4,100,53,153
2019,4,2,5,230,151,381
2019,4,2,6,370,174,544
2019,4,2,7,243,191,434
2019,4,2,8,227,181,408
2019,4,2,9,266,173,439
2019,4,2,10,198,197,395
2019,4,2,11,211,221,432
2019,4,2,12,210,245,455
2019,4,2,13,237,311,548
2019,4,2,14,231,322,553
2019,4,2,15,198,209,407
2019,4,2,16,171,152,323
2019,4,2,17,141,155,296
2019,4,2,18,107,161,268
2019,4,2,19,85,87,172
2019,4,2,20,43,102,145
2019,4,2,21,31,36,67
2019,4,2,22,12,19,31
2019,4,2,23,5,16,21
2019,4,3,0,8,10,18
2019,4,3,1,7,15,22
2019,4,3,2,4,3,7
2019,4,3,3,19,8,27
2019,4,3,4,111,52,163
2019,4,3,5,246,133,379
2019,4,3,6,416,202,618
2019,4,3,7,248,149,397
2019,4,3,8,226,152,378
2019,4,3,9,216,166,382
2019,4,3,10,221,212,433
2019,4,3,11,235,175,410
2019,4,3,12,211,262,473
2019,4,3,13,246,302,548
2019,4,3,14,211,328,539
2019,4,3,15,193,195,388
2019,4,3,16,136,159,295
2019,4,3,17,134,155,289
2019,4,3,18,96,117,213
2019,4,3,19,71,113,184
2019,4,3,20,66,88,154
2019,4,3,21,40,64,104
2019,4,3,22,23,16,39
2019,4,3,23,14,17,31
2019,4,4,0,10,13,23
2019,4,4,1,6,24,30
2019,4,4,2,12,11,23
2019,4,4,3,16,12,28
2019,4,4,4,96,46,142
2019,4,4,5,219,137,356
2019,4,4,6,416,204,620
2019,4,4,7,269,162,431
2019,4,4,8,252,175,427
2019,4,4,9,192,182,374
2019,4,4,10,196,222,418
2019,4,4,11,202,217,419
2019,4,4,12,242,248,490
2019,4,4,13,234,343,577
2019,4,4,14,214,277,491
2019,4,4,15,168,181,349
2019,4,4,16,157,179,336
2019,4,4,17,128,165,293
2019,4,4,18,117,133,250
2019,4,4,19,81,118,199
2019,4,4,20,62,93,155
2019,4,4,21,39,46,85
2019,4,4,22,13,27,40
2019,4,4,23,17,18,35
2019,4,5,0,4,29,33
2019,4,5,1,3,21,24
2019,4,5,2,6,13,19
2019,4,5,3,22,11,33
2019,4,5,4,97,41,138
2019,4,5,5,221,137,358
2019,4,5,6,389,174,563
2019,4,5,7,211,136,347
2019,4,5,8,210,151,361
2019,4,5,9,192,165,357
2019,4,5,10,206,214,420
2019,4,5,11,233,229,462
2019,4,5,12,233,300,533
2019,4,5,13,264,336,600
2019,4,5,14,194,262,456
2019,4,5,15,138,196,334
2019,4,5,16,161,149,310
2019,4,5,17,130,137,267
2019,4,5,18,91,113,204
2019,4,5,19,69,71,140
2019,4,5,20,62,67,129
2019,4,5,21,50,52,102
2019,4,5,22,37,37,74
2019,4,5,23,27,41,68
2019,4,6,0,22,35,57
2019,4,6,1,13,44,57
2019,4,6,2,7,16,23
2019,4,6,3,11,18,29
2019,4,6,4,20,9,29
2019,4,6,5,28,28,56
2019,4,6,6,57,43,100
2019,4,6,7,63,60,123
2019,4,6,8,86,79,165
2019,4,6,9,117,92,209
2019,4,6,10,163,117,280
2019,4,6,11,141,157,298
2019,4,6,12,173,168,341
2019,4,6,13,129,159,288
2019,4,6,14,145,161,306
2019,4,6,15,134,176,310
2019,4,6,16,110,148,258
2019,4,6,17,92,122,214
2019,4,6,18,96,101,197
2019,4,6,19,70,70,140
2019,4,6,20,47,75,122
2019,4,6,21,36,59,95
2019,4,6,22,25,50,75
2019,4,6,23,30,41,71
2019,4,7,0,25,54,79
2019,4,7,1,24,52,76
2019,4,7,2,19,37,56
2019,4,7,3,8,12,20
2019,4,7,4,10,14,24
2019,4,7,5,18,18,36
2019,4,7,6,36,17,53
2019,4,7,7,53,41,94
2019,4,7,8,97,71,168
2019,4,7,9,125,74,199
2019,4,7,10,146,124,270
2019,4,7,11,143,174,317
2019,4,7,12,170,152,322
2019,4,7,13,160,157,317
2019,4,7,14,155,232,387
2019,4,7,15,167,191,358
2019,4,7,16,138,170,308
2019,4,7,17,124,224,348
2019,4,7,18,100,137,237
2019,4,7,19,89,92,181
2019,4,7,20,120,74,194
2019,4,7,21,27,33,60
2019,4,7,22,18,20,38
2019,4,7,23,12,11,23
2019,4,8,0,4,10,14
2019,4,8,1,6,8,14
2019,4,8,2,3,9,12
2019,4,8,3,24,10,34
2019,4,8,4,111,50,161
2019,4,8,5,224,153,377
2019,4,8,6,380,190,570
2019,4,8,7,253,139,392
2019,4,8,8,209,144,353
2019,4,8,9,202,195,397
2019,4,8,10,202,214,416
2019,4,8,11,192,176,368
2019,4,8,12,194,270,464
2019,4,8,13,251,274,525
2019,4,8,14,284,337,621
2019,4,8,15,180,194,374
2019,4,8,16,159,156,315
2019,4,8,17,129,175,304
2019,4,8,18,108,140,248
2019,4,8,19,71,103,174
2019,4,8,20,67,110,177
2019,4,8,21,29,30,59
2019,4,8,22,16,24,40
2019,4,8,23,12,15,27
2019,4,9,0,10,5,15
2019,4,9,1,13,7,20
2019,4,9,2,13,14,27
2019,4,9,3,18,13,31
2019,4,9,4,116,33,149
2019,4,9,5,234,141,375
2019,4,9,6,418,192,610
2019,4,9,7,243,149,392
2019,4,9,8,226,201,427
2019,4,9,9,213,163,376
2019,4,9,10,192,226,418
2019,4,9,11,220,215,435
2019,4,9,12,208,272,480
2019,4,9,13,236,298,534
2019,4,9,14,202,297,499
2019,4,9,15,172,207,379
2019,4,9,16,211,165,376
2019,4,9,17,157,151,308
2019,4,9,18,121,161,282
2019,4,9,19,70,136,206
2019,4,9,20,66,83,149
2019,4,9,21,41,41,82
2019,4,9,22,15,18,33
2019,4,9,23,8,14,22
2019,4,10,0,7,12,19
2019,4,10,1,5,8,13
2019,4,10,2,2,5,7
2019,4,10,3,23,12,35
2019,4,10,4,112,49,161
2019,4,10,5,253,129,382
2019,4,10,6,372,169,541
2019,4,10,7,240,125,365
2019,4,10,8,231,165,396
2019,4,10,9,211,177,388
2019,4,10,10,227,189,416
2019,4,10,11,194,227,421
2019,4,10,12,227,286,513
2019,4,10,13,233,304,537
2019,4,10,14,209,285,494
2019,4,10,15,208,225,433
2019,4,10,16,153,150,303
2019,4,10,17,132,125,257
2019,4,10,18,145,134,279
2019,4,10,19,96,94,190
2019,4,10,20,47,60,107
2019,4,10,21,32,58,90
2019,4,10,22,18,14,32
2019,4,10,23,14,26,40
2019,4,11,0,13,12,25
2019,4,11,1,4,19,23
2019,4,11,2,9,14,23
2019,4,11,3,17,10,27
2019,4,11,4,110,52,162
2019,4,11,5,237,143,380
2019,4,11,6,404,194,598
2019,4,11,7,266,153,419
2019,4,11,8,205,175,380
2019,4,11,9,221,191,412
2019,4,11,10,198,207,405
2019,4,11,11,226,223,449
2019,4,11,12,214,246,460
2019,4,11,13,237,355,592
2019,4,11,14,214,298,512
2019,4,11,15,183,153,336
2019,4,11,16,178,182,360
2019,4,11,17,137,142,279
2019,4,11,18,94,147,241
2019,4,11,19,92,137,229
2019,4,11,20,78,94,172
2019,4,11,21,47,52,99
2019,4,11,22,18,20,38
2019,4,11,23,22,22,44
2019,4,12,0,15,28,43
2019,4,12,1,9,19,28
2019,4,12,2,19,10,29
2019,4,12,3,24,6,30
2019,4,12,4,95,47,142
2019,4,12,5,214,123,337
2019,4,12,6,399,208,607
2019,4,12,7,273,179,452
2019,4,12,8,224,184,408
2019,4,12,9,196,167,363
2019,4,12,10,240,233,473
2019,4,12,11,254,252,506
2019,4,12,12,257,288,545
2019,4,12,13,255,298,553
2019,4,12,14,194,273,467
2019,4,12,15,137,181,318
2019,4,12,16,143,144,287
2019,4,12,17,111,124,235
2019,4,12,18,94,90,184
2019,4,12,19,66,96,162
2019,4,12,20,62,68,130
2019,4,12,21,37,63,100
2019,4,12,22,28,37,65
2019,4,12,23,23,31,54
2019,4,13,0,14,30,44
2019,4,13,1,18,38,56
2019,4,13,2,15,25,40
2019,4,13,3,18,12,30
2019,4,13,4,22,19,41
2019,4,13,5,28,27,55
2019,4,13,6,38,35,73
2019,4,13,7,72,49,121
2019,4,13,8,81,79,160
2019,4,13,9,136,92,228
2019,4,13,10,127,116,243
2019,4,13,11,145,141,286
2019,4,13,12,132,126,258
2019,4,13,13,105,148,253
2019,4,13,14,124,136,260
2019,4,13,15,108,125,233
2019,4,13,16,101,115,216
2019,4,13,17,100,106,206
2019,4,13,18,69,85,154
2019,4,13,19,76,79,155
2019,4,13,20,41,67,108
2019,4,13,21,43,68,111
2019,4,13,22,26,41,67
2019,4,13,23,23,37,60
2019,4,14,0,32,54,86
2019,4,14,1,21,49,70
2019,4,14,2,7,30,37
2019,4,14,3,10,17,27
2019,4,14,4,15,12,27
2019,4,14,5,12,17,29
2019,4,14,6,41,10,51
2019,4,14,7,40,34,74
2019,4,14,8,69,51,120
2019,4,14,9,77,84,161
2019,4,14,10,118,102,220
2019,4,14,11,112,112,224
2019,4,14,12,138,133,271
2019,4,14,13,129,146,275
2019,4,14,14,110,160,270
2019,4,14,15,110,125,235
2019,4,14,16,111,124,235
2019,4,14,17,96,105,201
2019,4,14,18,104,121,225
2019,4,14,19,68,97,165
2019,4,14,20,39,65,104
2019,4,14,21,33,38,71
2019,4,14,22,24,33,57
2019,4,14,23,15,19,34
2019,4,15,0,11,16,27
2019,4,15,1,7,15,22
2019,4,15,2,9,9,18
2019,4,15,3,17,10,27
2019,4,15,4,58,42,100
2019,4,15,5,150,87,237
2019,4,15,6,179,117,296
2019,4,15,7,185,114,299
2019,4,15,8,158,124,282
2019,4,15,9,177,159,336
2019,4,15,10,151,147,298
2019,4,15,11,157,166,323
2019,4,15,12,173,194,367
2019,4,15,13,191,217,408
2019,4,15,14,133,181,314
2019,4,15,15,112,136,248
2019,4,15,16,103,130,233
2019,4,15,17,81,96,177
2019,4,15,18,80,98,178
2019,4,15,19,90,80,170
2019,4,15,20,47,57,104
2019,4,15,21,29,48,77
2019,4,15,22,19,22,41
2019,4,15,23,10,16,26
2019,4,16,0,8,10,18
2019,4,16,1,6,8,14
2019,4,16,2,9,20,29
2019,4,16,3,12,10,22
2019,4,16,4,63,39,102
2019,4,16,5,121,72,193
2019,4,16,6,176,92,268
2019,4,16,7,163,108,271
2019,4,16,8,137,134,271
2019,4,16,9,177,125,302
2019,4,16,10,126,164,290
2019,4,16,11,163,163,326
2019,4,16,12,152,163,315
2019,4,16,13,175,206,381
2019,4,16,14,134,181,315
2019,4,16,15,126,116,242
2019,4,16,16,107,101,208
2019,4,16,17,93,116,209
2019,4,16,18,79,80,159
2019,4,16,19,66,73,139
2019,4,16,20,38,140,178
2019,4,16,21,39,151,190
2019,4,16,22,20,63,83
2019,4,16,23,5,36,41
2019,4,17,0,14,12,26
2019,4,17,1,18,13,31
2019,4,17,2,11,7,18
2019,4,17,3,12,10,22
2019,4,17,4,52,22,74
2019,4,17,5,111,53,164
2019,4,17,6,110,61,171
2019,4,17,7,117,91,208
2019,4,17,8,124,104,228
2019,4,17,9,169,118,287
2019,4,17,10,162,168,330
2019,4,17,11,133,134,267
2019,4,17,12,129,132,261
2019,4,17,13,109,143,252
2019,4,17,14,105,118,223
2019,4,17,15,109,101,210
2019,4,17,16,100,102,202
2019,4,17,17,94,100,194
2019,4,17,18,68,75,143
2019,4,17,19,62,77,139
2019,4,17,20,33,43,76
2019,4,17,21,31,43,74
2019,4,17,22,22,35,57
2019,4,17,23,11,16,27
2019,4,18,0,11,21,32
2019,4,18,1,10,21,31
2019,4,18,2,2,16,18
2019,4,18,3,9,8,17
2019,4,18,4,8,9,17
2019,4,18,5,16,17,33
2019,4,18,6,19,20,39
2019,4,18,7,31,33,64
2019,4,18,8,44,40,84
2019,4,18,9,75,73,148
2019,4,18,10,84,89,173
2019,4,18,11,89,94,183
2019,4,18,12,82,115,197
2019,4,18,13,89,119,208
2019,4,18,14,89,107,196
2019,4,18,15,81,105,186
2019,4,18,16,97,75,172
2019,4,18,17,88,103,191
2019,4,18,18,67,87,154
2019,4,18,19,60,65,125
2019,4,18,20,39,47,86
2019,4,18,21,20,45,65
2019,4,18,22,17,30,47
2019,4,18,23,13,18,31
2019,4,19,0,13,25,38
2019,4,19,1,5,19,24
2019,4,19,2,5,21,26
2019,4,19,3,6,7,13
2019,4,19,4,9,8,17
2019,4,19,5,21,15,36
2019,4,19,6,18,19,37
2019,4,19,7,31,29,60
2019,4,19,8,55,37,92
2019,4,19,9,67,63,130
2019,4,19,10,78,73,151
2019,4,19,11,80,97,177
2019,4,19,12,109,107,216
2019,4,19,13,89,125,214
2019,4,19,14,108,115,223
2019,4,19,15,80,127,207
2019,4,19,16,95,106,201
2019,4,19,17,72,102,174
2019,4,19,18,75,87,162
2019,4,19,19,54,75,129
2019,4,19,20,54,72,126
2019,4,19,21,26,37,63
2019,4,19,22,22,30,52
2019,4,19,23,19,33,52
2019,4,20,0,12,29,41
2019,4,20,1,5,36,41
2019,4,20,2,11,13,24
2019,4,20,3,9,11,20
2019,4,20,4,13,11,24
2019,4,20,5,14,16,30
2019,4,20,6,27,17,44
2019,4,20,7,44,43,87
2019,4,20,8,96,72,168
2019,4,20,9,95,105,200
2019,4,20,10,77,95,172
2019,4,20,11,80,97,177
2019,4,20,12,79,107,186
2019,4,20,13,96,106,202
2019,4,20,14,68,98,166
2019,4,20,15,96,85,181
2019,4,20,16,84,92,176
2019,4,20,17,89,84,173
2019,4,20,18,71,91,162
2019,4,20,19,50,67,117
2019,4,20,20,34,57,91
2019,4,20,21,37,41,78
2019,4,20,22,24,56,80
2019,4,20,23,26,28,54
2019,4,21,0,19,24,43
2019,4,21,1,20,34,54
2019,4,21,2,7,17,24
2019,4,21,3,9,9,18
2019,4,21,4,12,10,22
2019,4,21,5,12,12,24
2019,4,21,6,23,14,37
2019,4,21,7,54,29,83
2019,4,21,8,57,69,126
2019,4,21,9,61,56,117
2019,4,21,10,70,88,158
2019,4,21,11,108,114,222
2019,4,21,12,108,118,226
2019,4,21,13,86,108,194
2019,4,21,14,93,125,218
2019,4,21,15,97,107,204
2019,4,21,16,105,99,204
2019,4,21,17,96,118,214
2019,4,21,18,101,102,203
2019,4,21,19,63,87,150
2019,4,21,20,46,79,125
2019,4,21,21,39,44,83
2019,4,21,22,21,43,64
2019,4,21,23,11,22,33
2019,4,22,0,7,19,26
2019,4,22,1,13,25,38
2019,4,22,2,4,11,15
2019,4,22,3,8,4,12
2019,4,22,4,11,9,20
2019,4,22,5,13,12,25
2019,4,22,6,22,19,41
2019,4,22,7,49,33,82
2019,4,22,8,75,51,126
2019,4,22,9,84,84,168
2019,4,22,10,126,113,239
2019,4,22,11,129,119,248
2019,4,22,12,136,139,275
2019,4,22,13,124,151,275
2019,4,22,14,134,136,270
2019,4,22,15,133,152,285
2019,4,22,16,140,155,295
2019,4,22,17,128,195,323
2019,4,22,18,106,125,231
2019,4,22,19,90,91,181
2019,4,22,20,127,83,210
2019,4,22,21,30,44,74
2019,4,22,22,18,17,35
2019,4,22,23,7,11,18
2019,4,23,0,6,20,26
2019,4,23,1,4,8,12
2019,4,23,2,7,4,11
2019,4,23,3,28,17,45
2019,4,23,4,100,42,142
2019,4,23,5,227,136,363
2019,4,23,6,397,179,576
2019,4,23,7,263,181,444
2019,4,23,8,201,158,359
2019,4,23,9,214,173,387
2019,4,23,10,195,177,372
2019,4,23,11,199,194,393
2019,4,23,12,241,256,497
2019,4,23,13,259,329,588
2019,4,23,14,277,430,707
2019,4,23,15,172,167,339
2019,4,23,16,197,174,371
2019,4,23,17,141,131,272
2019,4,23,18,105,143,248
2019,4,23,19,93,135,228
2019,4,23,20,59,217,276
2019,4,23,21,39,135,174
2019,4,23,22,31,17,48
2019,4,23,23,7,9,16
2019,4,24,0,5,5,10
2019,4,24,1,10,1,11
2019,4,24,2,7,5,12
2019,4,24,3,23,11,34
2019,4,24,4,103,48,151
2019,4,24,5,214,144,358
2019,4,24,6,382,156,538
2019,4,24,7,267,155,422
2019,4,24,8,233,173,406
2019,4,24,9,229,172,401
2019,4,24,10,218,208,426
2019,4,24,11,226,204,430
2019,4,24,12,199,244,443
2019,4,24,13,249,321,570
2019,4,24,14,215,331,546
2019,4,24,15,180,209,389
2019,4,24,16,170,156,326
2019,4,24,17,127,171,298
2019,4,24,18,129,120,249
2019,4,24,19,91,140,231
2019,4,24,20,61,76,137
2019,4,24,21,31,54,85
2019,4,24,22,22,25,47
2019,4,24,23,13,14,27
2019,4,25,0,4,12,16
2019,4,25,1,10,9,19
2019,4,25,2,8,13,21
2019,4,25,3,15,13,28
2019,4,25,4,119,52,171
2019,4,25,5,222,145,367
2019,4,25,6,377,224,601
2019,4,25,7,284,150,434
2019,4,25,8,204,165,369
2019,4,25,9,215,186,401
2019,4,25,10,184,194,378
2019,4,25,11,207,170,377
2019,4,25,12,206,260,466
2019,4,25,13,295,329,624
2019,4,25,14,212,308,520
2019,4,25,15,184,196,380
2019,4,25,16,173,163,336
2019,4,25,17,156,147,303
2019,4,25,18,133,130,263
2019,4,25,19,99,120,219
2019,4,25,20,60,86,146
2019,4,25,21,37,60,97
2019,4,25,22,21,37,58
2019,4,25,23,18,10,28
2019,4,26,0,14,10,24
2019,4,26,1,7,15,22
2019,4,26,2,18,11,29
2019,4,26,3,31,12,43
2019,4,26,4,103,44,147
2019,4,26,5,255,127,382
2019,4,26,6,358,178,536
2019,4,26,7,250,160,410
2019,4,26,8,238,157,395
2019,4,26,9,248,194,442
2019,4,26,10,227,199,426
2019,4,26,11,247,229,476
2019,4,26,12,265,364,629
2019,4,26,13,287,453,740
2019,4,26,14,245,279,524
2019,4,26,15,177,194,371
2019,4,26,16,165,162,327
2019,4,26,17,137,138,275
2019,4,26,18,115,101,216
2019,4,26,19,88,124,212
2019,4,26,20,48,80,128
2019,4,26,21,34,68,102
2019,4,26,22,31,29,60
2019,4,26,23,18,26,44
2019,4,27,0,19,20,39
2019,4,27,1,19,27,46
2019,4,27,2,13,9,22
2019,4,27,3,7,13,20
2019,4,27,4,32,15,47
2019,4,27,5,37,30,67
2019,4,27,6,62,37,99
2019,4,27,7,91,50,141
2019,4,27,8,97,55,152
2019,4,27,9,154,81,235
2019,4,27,10,122,88,210
2019,4,27,11,169,119,288
2019,4,27,12,172,119,291
2019,4,27,13,131,135,266
2019,4,27,14,144,134,278
2019,4,27,15,122,127,249
2019,4,27,16,127,150,277
2019,4,27,17,132,122,254
2019,4,27,18,75,76,151
2019,4,27,19,70,75,145
2019,4,27,20,59,59,118
2019,4,27,21,70,58,128
2019,4,27,22,49,47,96
2019,4,27,23,35,35,70
2019,4,28,0,25,25,50
2019,4,28,1,27,37,64
2019,4,28,2,9,24,33
2019,4,28,3,11,11,22
2019,4,28,4,13,8,21
2019,4,28,5,18,13,31
2019,4,28,6,35,14,49
2019,4,28,7,59,42,101
2019,4,28,8,100,59,159
2019,4,28,9,103,83,186
2019,4,28,10,186,136,322
2019,4,28,11,191,155,346
2019,4,28,12,206,180,386
2019,4,28,13,146,153,299
2019,4,28,14,207,213,420
2019,4,28,15,177,197,374
2019,4,28,16,145,188,333
2019,4,28,17,138,174,312
2019,4,28,18,112,151,263
2019,4,28,19,86,111,197
2019,4,28,20,63,84,147
2019,4,28,21,33,50,83
2019,4,28,22,14,25,39
2019,4,28,23,8,8,16
2019,4,29,0,7,13,20
2019,4,29,1,7,7,14
2019,4,29,2,9,6,15
2019,4,29,3,16,13,29
2019,4,29,4,110,51,161
2019,4,29,5,235,141,376
2019,4,29,6,401,208,609
2019,4,29,7,270,162,432
2019,4,29,8,229,151,380
2019,4,29,9,213,182,395
2019,4,29,10,210,227,437
2019,4,29,11,227,189,416
2019,4,29,12,212,248,460
2019,4,29,13,244,356,600
2019,4,29,14,246,364,610
2019,4,29,15,247,183,430
2019,4,29,16,166,177,343
2019,4,29,17,128,163,291
2019,4,29,18,118,144,262
2019,4,29,19,110,111,221
2019,4,29,20,68,89,157
2019,4,29,21,32,40,72
2019,4,29,22,23,37,60
2019,4,29,23,18,12,30
2019,4,30,0,12,6,18
2019,4,30,1,8,6,14
2019,4,30,2,7,7,14
2019,4,30,3,25,7,32
2019,4,30,4,114,51,165
2019,4,30,5,247,159,406
2019,4,30,6,385,206,591
2019,4,30,7,259,164,423
2019,4,30,8,232,170,402
2019,4,30,9,236,176,412
2019,4,30,10,244,200,444
2019,4,30,11,225,249,474
2019,4,30,12,229,276,505
2019,4,30,13,260,317,577
2019,4,30,14,249,320,569
2019,4,30,15,232,204,436
2019,4,30,16,185,169,354
2019,4,30,17,138,165,303
2019,4,30,18,120,142,262
2019,4,30,19,94,136,230
2019,4,30,20,77,62,139
2019,4,30,21,64,62,126
2019,4,30,22,40,35,75
2019,4,30,23,23,36,59
2019,5,1,0,27,31,58
2019,5,1,1,16,32,48
2019,5,1,2,14,16,30
2019,5,1,3,7,12,19
2019,5,1,4,20,8,28
2019,5,1,5,16,12,28
2019,5,1,6,30,16,46
2019,5,1,7,55,37,92
2019,5,1,8,87,64,151
2019,5,1,9,100,85,185
2019,5,1,10,134,120,254
2019,5,1,11,147,145,292
2019,5,1,12,144,136,280
2019,5,1,13,147,178,325
2019,5,1,14,157,154,311
2019,5,1,15,141,192,333
2019,5,1,16,130,145,275
2019,5,1,17,125,142,267
2019,5,1,18,115,125,240
2019,5,1,19,61,80,141
2019,5,1,20,39,63,102
2019,5,1,21,44,51,95
2019,5,1,22,16,20,36
2019,5,1,23,14,9,23
2019,5,2,0,5,8,13
2019,5,2,1,4,5,9
2019,5,2,2,10,7,17
2019,5,2,3,14,10,24
2019,5,2,4,93,46,139
2019,5,2,5,262,132,394
2019,5,2,6,405,226,631
2019,5,2,7,302,164,466
2019,5,2,8,205,145,350
2019,5,2,9,209,205,414
2019,5,2,10,214,216,430
2019,5,2,11,233,219,452
2019,5,2,12,205,251,456
2019,5,2,13,218,325,543
2019,5,2,14,226,334,560
2019,5,2,15,175,196,371
2019,5,2,16,156,168,324
2019,5,2,17,143,159,302
2019,5,2,18,119,137,256
2019,5,2,19,91,107,198
2019,5,2,20,64,74,138
2019,5,2,21,35,54,89
2019,5,2,22,17,17,34
2019,5,2,23,13,16,29
2019,5,3,0,9,17,26
2019,5,3,1,6,7,13
2019,5,3,2,8,6,14
2019,5,3,3,17,7,24
2019,5,3,4,101,51,152
2019,5,3,5,239,137,376
2019,5,3,6,379,197,576
2019,5,3,7,226,166,392
2019,5,3,8,208,145,353
2019,5,3,9,198,178,376
2019,5,3,10,223,219,442
2019,5,3,11,227,213,440
2019,5,3,12,242,251,493
2019,5,3,13,266,326,592
2019,5,3,14,199,259,458
2019,5,3,15,176,201,377
2019,5,3,16,161,152,313
2019,5,3,17,104,137,241
2019,5,3,18,93,135,228
2019,5,3,19,90,105,195
2019,5,3,20,63,62,125
2019,5,3,21,55,41,96
2019,5,3,22,29,35,64
2019,5,3,23,25,22,47
2019,5,4,0,18,19,37
2019,5,4,1,11,29,40
2019,5,4,2,7,12,19
2019,5,4,3,10,3,13
2019,5,4,4,24,10,34
2019,5,4,5,21,25,46
2019,5,4,6,39,36,75
2019,5,4,7,72,47,119
2019,5,4,8,102,72,174
2019,5,4,9,167,105,272
2019,5,4,10,166,141,307
2019,5,4,11,155,143,298
2019,5,4,12,188,185,373
2019,5,4,13,133,162,295
2019,5,4,14,136,188,324
2019,5,4,15,141,184,325
2019,5,4,16,116,122,238
2019,5,4,17,109,115,224
2019,5,4,18,85,137,222
2019,5,4,19,71,86,157
2019,5,4,20,51,60,111
2019,5,4,21,56,50,106
2019,5,4,22,41,54,95
2019,5,4,23,19,29,48
2019,5,5,0,27,21,48
2019,5,5,1,13,29,42
2019,5,5,2,13,23,36
2019,5,5,3,11,11,22
2019,5,5,4,15,5,20
2019,5,5,5,15,17,32
2019,5,5,6,33,21,54
2019,5,5,7,63,44,107
2019,5,5,8,95,79,174
2019,5,5,9,154,95,249
2019,5,5,10,163,168,331
2019,5,5,11,168,202,370
2019,5,5,12,245,202,447
2019,5,5,13,160,193,353
2019,5,5,14,177,232,409
2019,5,5,15,177,255,432
2019,5,5,16,148,151,299
2019,5,5,17,145,161,306
2019,5,5,18,164,195,359
2019,5,5,19,84,110,194
2019,5,5,20,55,63,118
2019,5,5,21,34,45,79
2019,5,5,22,19,30,49
2019,5,5,23,4,10,14
2019,5,6,0,6,6,12
2019,5,6,1,5,10,15
2019,5,6,2,8,4,12
2019,5,6,3,19,12,31
2019,5,6,4,120,53,173
2019,5,6,5,232,191,423
2019,5,6,6,414,203,617
2019,5,6,7,285,172,457
2019,5,6,8,105,69,174
2019,5,6,11,218,239,457
2019,5,6,12,227,235,462
2019,5,6,13,238,325,563
2019,5,6,14,191,295,486
2019,5,6,15,194,191,385
2019,5,6,16,166,178,344
2019,5,6,17,142,131,273
2019,5,6,18,105,137,242
2019,5,6,19,97,125,222
2019,5,6,20,45,104,149
2019,5,6,21,29,147,176
2019,5,6,22,18,32,50
2019,5,6,23,6,7,13
2019,5,7,0,8,10,18
2019,5,7,1,5,9,14
2019,5,7,2,8,6,14
2019,5,7,3,24,9,33
2019,5,7,4,116,52,168
2019,5,7,5,214,151,365
2019,5,7,6,385,192,577
2019,5,7,7,260,156,416
2019,5,7,8,208,167,375
2019,5,7,9,215,184,399
2019,5,7,10,226,188,414
2019,5,7,11,211,205,416
2019,5,7,12,233,238,471
2019,5,7,13,230,301,531
2019,5,7,14,218,315,533
2019,5,7,15,201,164,365
2019,5,7,16,182,167,349
2019,5,7,17,139,167,306
2019,5,7,18,103,138,241
2019,5,7,19,73,131,204
2019,5,7,20,37,74,111
2019,5,7,21,31,54,85
2019,5,7,22,12,20,32
2019,5,7,23,13,17,30
2019,5,8,0,8,12,20
2019,5,8,1,2,5,7
2019,5,8,2,9,8,17
2019,5,8,3,17,10,27
2019,5,8,4,106,52,158
2019,5,8,5,245,138,383
2019,5,8,6,390,165,555
2019,5,8,7,236,160,396
2019,5,8,8,230,182,412
2019,5,8,9,192,142,334
2019,5,8,10,188,207,395
2019,5,8,11,251,195,446
2019,5,8,12,211,256,467
2019,5,8,13,217,284,501
2019,5,8,14,182,290,472
2019,5,8,15,174,189,363
2019,5,8,16,154,147,301
2019,5,8,17,126,168,294
2019,5,8,18,98,134,232
2019,5,8,19,91,130,221
2019,5,8,20,67,91,158
2019,5,8,21,49,49,98
2019,5,8,22,19,20,39
2019,5,8,23,15,22,37
2019,5,9,0,11,14,25
2019,5,9,1,14,11,25
2019,5,9,2,21,9,30
2019,5,9,3,20,8,28
2019,5,9,4,116,53,169
2019,5,9,5,240,130,370
2019,5,9,6,393,210,603
2019,5,9,7,249,154,403
2019,5,9,8,232,158,390
2019,5,9,9,207,166,373
2019,5,9,10,239,183,422
2019,5,9,11,216,185,401
2019,5,9,12,219,229,448
2019,5,9,13,224,301,525
2019,5,9,14,265,307,572
2019,5,9,15,175,211,386
2019,5,9,16,172,145,317
2019,5,9,17,130,144,274
2019,5,9,18,119,118,237
2019,5,9,19,88,125,213
2019,5,9,20,65,89,154
2019,5,9,21,47,40,87
2019,5,9,22,22,25,47
2019,5,9,23,10,23,33
2019,5,10,0,10,14,24
2019,5,10,1,8,16,24
2019,5,10,2,14,10,24
2019,5,10,3,15,5,20
2019,5,10,4,103,57,160
2019,5,10,5,206,114,320
2019,5,10,6,399,180,579
2019,5,10,7,253,133,386
2019,5,10,8,205,183,388
2019,5,10,9,245,202,447
2019,5,10,10,213,242,455
2019,5,10,11,222,205,427
2019,5,10,12,241,263,504
2019,5,10,13,267,410,677
2019,5,10,14,239,321,560
2019,5,10,15,175,215,390
2019,5,10,16,162,181,343
2019,5,10,17,107,145,252
2019,5,10,18,86,103,189
2019,5,10,19,87,117,204
2019,5,10,20,44,68,112
2019,5,10,21,48,54,102
2019,5,10,22,21,43,64
2019,5,10,23,37,45,82
2019,5,11,0,28,25,53
2019,5,11,1,10,17,27
2019,5,11,2,10,15,25
2019,5,11,3,20,9,29
2019,5,11,4,23,11,34
2019,5,11,5,24,21,45
2019,5,11,6,45,39,84
2019,5,11,7,63,37,100
2019,5,11,8,98,78,176
2019,5,11,9,143,97,240
2019,5,11,10,144,135,279
2019,5,11,11,148,151,299
2019,5,11,12,148,164,312
2019,5,11,13,124,157,281
2019,5,11,14,139,150,289
2019,5,11,15,139,143,282
2019,5,11,16,132,265,397
2019,5,11,17,115,154,269
2019,5,11,18,73,95,168
2019,5,11,19,58,91,149
2019,5,11,20,58,54,112
2019,5,11,21,38,59,97
2019,5,11,22,30,45,75
2019,5,11,23,28,25,53
2019,5,12,0,17,14,31
2019,5,12,1,25,34,59
2019,5,12,2,16,31,47
2019,5,12,3,13,12,25
2019,5,12,4,18,10,28
2019,5,12,5,16,15,31
2019,5,12,6,39,16,55
2019,5,12,7,49,42,91
2019,5,12,8,107,63,170
2019,5,12,9,113,98,211
2019,5,12,10,162,145,307
2019,5,12,11,142,164,306
2019,5,12,12,151,174,325
2019,5,12,13,161,185,346
2019,5,12,14,126,159,285
2019,5,12,15,163,193,356
2019,5,12,16,163,143,306
2019,5,12,17,155,144,299
2019,5,12,18,99,146,245
2019,5,12,19,84,123,207
2019,5,12,20,59,61,120
2019,5,12,21,46,44,90
2019,5,12,22,24,29,53
2019,5,12,23,9,7,16
2019,5,13,0,10,8,18
2019,5,13,1,5,9,14
2019,5,13,2,9,3,12
2019,5,13,3,24,6,30
2019,5,13,4,102,48,150
2019,5,13,5,205,132,337
2019,5,13,6,374,184,558
2019,5,13,7,264,155,419
2019,5,13,8,213,147,360
2019,5,13,9,203,155,358
2019,5,13,10,208,212,420
2019,5,13,11,189,190,379
2019,5,13,12,204,249,453
2019,5,13,13,244,288,532
2019,5,13,14,176,292,468
2019,5,13,15,169,183,352
2019,5,13,16,150,172,322
2019,5,13,17,133,134,267
2019,5,13,18,115,137,252
2019,5,13,19,99,143,242
2019,5,13,20,63,69,132
2019,5,13,21,32,31,63
2019,5,13,22,17,28,45
2019,5,13,23,9,12,21
2019,5,14,0,5,12,17
2019,5,14,1,7,14,21
2019,5,14,2,5,4,9
2019,5,14,3,17,12,29
2019,5,14,4,109,56,165
2019,5,14,5,256,139,395
2019,5,14,6,387,195,582
2019,5,14,7,263,172,435
2019,5,14,8,220,198,418
2019,5,14,9,228,175,403
2019,5,14,10,217,198,415
2019,5,14,11,243,221,464
2019,5,14,12,228,248,476
2019,5,14,13,237,302,539
2019,5,14,14,228,308,536
2019,5,14,15,205,226,431
2019,5,14,16,158,177,335
2019,5,14,17,145,144,289
2019,5,14,18,107,139,246
2019,5,14,19,78,123,201
2019,5,14,20,52,99,151
2019,5,14,21,48,48,96
2019,5,14,22,26,28,54
2019,5,14,23,8,16,24
2019,5,15,0,4,14,18
2019,5,15,1,9,6,15
2019,5,15,2,14,7,21
2019,5,15,3,23,7,30
2019,5,15,4,109,48,157
2019,5,15,5,250,142,392
2019,5,15,6,399,201,600
2019,5,15,7,253,152,405
2019,5,15,8,209,155,364
2019,5,15,9,195,190,385
2019,5,15,10,239,209,448
2019,5,15,11,224,233,457
2019,5,15,12,235,227,462
2019,5,15,13,240,334,574
2019,5,15,14,225,333,558
2019,5,15,15,202,227,429
2019,5,15,16,189,168,357
2019,5,15,17,147,179,326
2019,5,15,18,127,133,260
2019,5,15,19,106,158,264
2019,5,15,20,79,245,324
2019,5,15,21,41,143,184
2019,5,15,22,25,61,86
2019,5,15,23,20,48,68
2019,5,16,0,17,50,67
2019,5,16,1,9,32,41
2019,5,16,2,6,34,40
2019,5,16,3,19,34,53
2019,5,16,4,112,47,159
2019,5,16,5,245,145,390
2019,5,16,6,408,199,607
2019,5,16,7,269,159,428
2019,5,16,8,241,174,415
2019,5,16,9,243,202,445
2019,5,16,10,255,236,491
2019,5,16,11,237,223,460
2019,5,16,12,262,292,554
2019,5,16,13,267,344,611
2019,5,16,14,245,422,667
2019,5,16,15,209,351,560
2019,5,16,16,160,208,368
2019,5,16,17,156,179,335
2019,5,16,18,188,141,329
2019,5,16,19,109,141,250
2019,5,16,20,87,100,187
2019,5,16,21,70,69,139
2019,5,16,22,35,41,76
2019,5,16,23,27,24,51
2019,5,17,0,26,20,46
2019,5,17,1,18,19,37
2019,5,17,2,6,13,19
2019,5,17,3,21,15,36
2019,5,17,4,32,28,60
2019,5,17,5,94,56,150
2019,5,17,6,152,140,292
2019,5,17,7,285,186,471
2019,5,17,8,575,148,723
2019,5,17,9,260,170,430
2019,5,17,10,118,256,374
2019,5,17,11,127,394,521
2019,5,17,12,116,286,402
2019,5,17,13,117,214,331
2019,5,17,14,80,157,237
2019,5,17,15,105,133,238
2019,5,17,16,131,123,254
2019,5,17,17,111,102,213
2019,5,17,18,101,108,209
2019,5,17,19,115,105,220
2019,5,17,20,126,87,213
2019,5,17,21,66,104,170
2019,5,17,22,38,57,95
2019,5,17,23,26,41,67
2019,5,18,0,36,30,66
2019,5,18,1,22,27,49
2019,5,18,2,20,21,41
2019,5,18,3,14,9,23
2019,5,18,4,15,10,25
2019,5,18,5,23,23,46
2019,5,18,6,27,18,45
2019,5,18,7,53,42,95
2019,5,18,8,67,55,122
2019,5,18,9,93,109,202
2019,5,18,10,133,105,238
2019,5,18,11,152,130,282
2019,5,18,12,140,173,313
2019,5,18,13,118,147,265
2019,5,18,14,126,178,304
2019,5,18,15,122,136,258
2019,5,18,16,99,123,222
2019,5,18,17,90,111,201
2019,5,18,18,79,87,166
2019,5,18,19,81,90,171
2019,5,18,20,47,59,106
2019,5,18,21,32,56,88
2019,5,18,22,35,41,76
2019,5,18,23,32,40,72
2019,5,19,0,20,19,39
2019,5,19,1,7,15,22
2019,5,19,2,7,9,16
2019,5,19,3,12,6,18
2019,5,19,4,11,4,15
2019,5,19,5,21,13,34
2019,5,19,6,40,19,59
2019,5,19,7,55,49,104
2019,5,19,8,112,69,181
2019,5,19,9,129,90,219
2019,5,19,10,124,118,242
2019,5,19,11,129,156,285
2019,5,19,12,171,158,329
2019,5,19,13,129,137,266
2019,5,19,14,116,177,293
2019,5,19,15,149,150,299
2019,5,19,16,162,175,337
2019,5,19,17,149,153,302
2019,5,19,18,110,155,265
2019,5,19,19,81,117,198
2019,5,19,20,63,94,157
2019,5,19,21,43,72,115
2019,5,19,22,24,52,76
2019,5,19,23,14,9,23
2019,5,20,0,8,12,20
2019,5,20,1,7,8,15
2019,5,20,2,6,7,13
2019,5,20,3,22,7,29
2019,5,20,4,105,48,153
2019,5,20,5,220,149,369
2019,5,20,6,358,187,545
2019,5,20,7,236,165,401
2019,5,20,8,212,177,389
2019,5,20,9,200,161,361
2019,5,20,10,191,186,377
2019,5,20,11,209,190,399
2019,5,20,12,227,257,484
2019,5,20,13,240,303,543
2019,5,20,14,171,279,450
2019,5,20,15,173,157,330
2019,5,20,16,159,159,318
2019,5,20,17,120,136,256
2019,5,20,18,107,123,230
2019,5,20,19,68,105,173
2019,5,20,20,67,96,163
2019,5,20,21,36,50,86
2019,5,20,22,17,19,36
2019,5,20,23,12,15,27
2019,5,21,0,7,7,14
2019,5,21,1,6,24,30
2019,5,21,2,8,37,45
2019,5,21,3,16,34,50
2019,5,21,4,111,50,161
2019,5,21,5,213,137,350
2019,5,21,6,358,194,552
2019,5,21,7,255,141,396
2019,5,21,8,182,194,376
2019,5,21,9,208,180,388
2019,5,21,10,216,200,416
2019,5,21,11,240,187,427
2019,5,21,12,206,235,441
2019,5,21,13,261,327,588
2019,5,21,14,189,303,492
2019,5,21,15,175,164,339
2019,5,21,16,134,172,306
2019,5,21,17,136,151,287
2019,5,21,18,131,122,253
2019,5,21,19,95,102,197
2019,5,21,20,72,87,159
2019,5,21,21,48,58,106
2019,5,21,22,15,27,42
2019,5,21,23,12,20,32
2019,5,22,0,10,6,16
2019,5,22,1,12,7,19
2019,5,22,2,10,5,15
2019,5,22,3,19,4,23
2019,5,22,4,111,53,164
2019,5,22,5,249,127,376
2019,5,22,6,405,204,609
2019,5,22,7,239,157,396
2019,5,22,8,223,164,387
2019,5,22,9,238,158,396
2019,5,22,10,199,150,349
2019,5,22,11,241,156,397
2019,5,22,12,234,278,512
2019,5,22,13,243,318,561
2019,5,22,14,218,291,509
2019,5,22,15,174,202,376
2019,5,22,16,182,169,351
2019,5,22,17,125,146,271
2019,5,22,18,108,135,243
2019,5,22,19,87,109,196
2019,5,22,20,48,344,392
2019,5,22,21,44,203,247
2019,5,22,22,17,79,96
2019,5,22,23,13,47,60
2019,5,23,0,7,38,45
2019,5,23,1,2,30,32
2019,5,23,2,7,36,43
2019,5,23,3,19,28,47
2019,5,23,4,112,52,164
2019,5,23,5,222,150,372
2019,5,23,6,399,196,595
2019,5,23,7,238,149,387
2019,5,23,8,212,152,364
2019,5,23,9,207,152,359
2019,5,23,10,207,192,399
2019,5,23,11,213,227,440
2019,5,23,12,225,238,463
2019,5,23,13,240,320,560
2019,5,23,14,230,299,529
2019,5,23,15,196,207,403
2019,5,23,16,166,154,320
2019,5,23,17,154,132,286
2019,5,23,18,136,119,255
2019,5,23,19,89,120,209
2019,5,23,20,62,100,162
2019,5,23,21,41,42,83
2019,5,23,22,25,33,58
2019,5,23,23,13,14,27
2019,5,24,0,11,14,25
2019,5,24,1,6,6,12
2019,5,24,2,8,10,18
2019,5,24,3,16,10,26
2019,5,24,4,116,57,173
2019,5,24,5,260,161,421
2019,5,24,6,372,178,550
2019,5,24,7,232,153,385
2019,5,24,8,220,180,400
2019,5,24,9,207,182,389
2019,5,24,10,222,225,447
2019,5,24,11,243,232,475
2019,5,24,12,234,280,514
2019,5,24,13,229,308,537
2019,5,24,14,204,255,459
2019,5,24,15,153,215,368
2019,5,24,16,158,186,344
2019,5,24,17,128,118,246
2019,5,24,18,115,114,229
2019,5,24,19,83,109,192
2019,5,24,20,72,80,152
2019,5,24,21,35,60,95
2019,5,24,22,31,36,67
2019,5,24,23,19,29,48
2019,5,25,0,19,23,42
2019,5,25,1,15,22,37
2019,5,25,2,14,15,29
2019,5,25,3,14,7,21
2019,5,25,4,19,13,32
2019,5,25,5,27,16,43
2019,5,25,6,36,34,70
2019,5,25,7,62,51,113
2019,5,25,8,116,74,190
2019,5,25,9,120,102,222
2019,5,25,10,171,133,304
2019,5,25,11,144,151,295
2019,5,25,12,152,144,296
2019,5,25,13,145,195,340
2019,5,25,14,134,167,301
2019,5,25,15,129,145,274
2019,5,25,16,121,127,248
2019,5,25,17,87,105,192
2019,5,25,18,87,65,152
2019,5,25,19,66,90,156
2019,5,25,20,47,68,115
2019,5,25,21,45,58,103
2019,5,25,22,35,48,83
2019,5,25,23,32,31,63
2019,5,26,0,26,33,59
2019,5,26,1,22,27,49
2019,5,26,2,15,16,31
2019,5,26,3,14,10,24
2019,5,26,4,16,7,23
2019,5,26,5,15,14,29
2019,5,26,6,47,26,73
2019,5,26,7,63,47,110
2019,5,26,8,107,67,174
2019,5,26,9,120,81,201
2019,5,26,10,146,127,273
2019,5,26,11,137,189,326
2019,5,26,12,146,166,312
2019,5,26,13,146,189,335
2019,5,26,14,150,197,347
2019,5,26,15,160,173,333
2019,5,26,16,183,208,391
2019,5,26,17,159,231,390
2019,5,26,18,91,131,222
2019,5,26,19,95,102,197
2019,5,26,20,165,78,243
2019,5,26,21,46,41,87
2019,5,26,22,18,34,52
2019,5,26,23,12,15,27
2019,5,27,0,4,11,15
2019,5,27,1,9,6,15
2019,5,27,2,3,7,10
2019,5,27,3,25,9,34
2019,5,27,4,126,54,180
2019,5,27,5,238,155,393
2019,5,27,6,376,182,558
2019,5,27,7,266,168,434
2019,5,27,8,214,151,365
2019,5,27,9,187,162,349
2019,5,27,10,196,207,403
2019,5,27,11,250,218,468
2019,5,27,12,243,265,508
2019,5,27,13,229,306,535
2019,5,27,14,196,248,444
2019,5,27,15,169,200,369
2019,5,27,16,171,165,336
2019,5,27,17,152,152,304
2019,5,27,18,125,123,248
2019,5,27,19,92,160,252
2019,5,27,20,63,363,426
2019,5,27,21,36,223,259
2019,5,27,22,20,82,102
2019,5,27,23,9,34,43
2019,5,28,0,4,20,24
2019,5,28,1,10,21,31
2019,5,28,2,10,20,30
2019,5,28,3,17,28,45
2019,5,28,4,104,51,155
2019,5,28,5,253,134,387
2019,5,28,6,417,182,599
2019,5,28,7,247,141,388
2019,5,28,8,206,181,387
2019,5,28,9,233,175,408
2019,5,28,10,194,220,414
2019,5,28,11,212,205,417
2019,5,28,12,234,276,510
2019,5,28,13,236,318,554
2019,5,28,14,220,315,535
2019,5,28,15,166,206,372
2019,5,28,16,182,147,329
2019,5,28,17,138,142,280
2019,5,28,18,140,136,276
2019,5,28,19,101,145,246
2019,5,28,20,78,102,180
2019,5,28,21,50,50,100
2019,5,28,22,23,21,44
2019,5,28,23,11,12,23
2019,5,29,0,13,8,21
2019,5,29,1,8,12,20
2019,5,29,2,14,13,27
2019,5,29,3,20,6,26
2019,5,29,4,109,52,161
2019,5,29,5,229,127,356
2019,5,29,6,420,209,629
2019,5,29,7,278,162,440
2019,5,29,8,248,186,434
2019,5,29,9,230,190,420
2019,5,29,10,206,192,398
2019,5,29,11,222,253,475
2019,5,29,12,265,251,516
2019,5,29,13,263,319,582
2019,5,29,14,238,363,601
2019,5,29,15,163,214,377
2019,5,29,16,144,154,298
2019,5,29,17,146,142,288
2019,5,29,18,116,118,234
2019,5,29,19,103,104,207
2019,5,29,20,64,74,138
2019,5,29,21,45,131,176
2019,5,29,22,34,55,89
2019,5,29,23,32,27,59
2019,5,30,0,22,19,41
2019,5,30,1,18,26,44
2019,5,30,2,10,16,26
2019,5,30,3,10,7,17
2019,5,30,4,19,10,29
2019,5,30,5,32,20,52
2019,5,30,6,43,28,71
2019,5,30,7,59,50,109
2019,5,30,8,107,63,170
2019,5,30,9,130,87,217
2019,5,30,10,160,141,301
2019,5,30,11,154,139,293
2019,5,30,12,163,166,329
2019,5,30,13,141,161,302
2019,5,30,14,146,220,366
2019,5,30,15,135,173,308
2019,5,30,16,153,170,323
2019,5,30,17,123,147,270
2019,5,30,18,109,132,241
2019,5,30,19,89,119,208
2019,5,30,20,68,89,157
2019,5,30,21,43,64,107
2019,5,30,22,21,26,47
2019,5,30,23,18,28,46
2019,5,31,0,14,18,32
2019,5,31,1,7,13,20
2019,5,31,2,14,9,23
2019,5,31,3,15,7,22
2019,5,31,4,75,35,110
2019,5,31,5,162,101,263
2019,5,31,6,195,113,308
2019,5,31,7,189,101,290
2019,5,31,8,196,137,333
2019,5,31,9,246,165,411
2019,5,31,10,246,177,423
2019,5,31,11,190,224,414
2019,5,31,12,204,224,428
2019,5,31,13,215,235,450
2019,5,31,14,196,232,428
2019,5,31,15,152,168,320
2019,5,31,16,131,138,269
2019,5,31,17,114,131,245
2019,5,31,18,89,94,183
2019,5,31,19,90,118,208
2019,5,31,20,70,80,150
2019,5,31,21,51,60,111
2019,5,31,22,31,36,67
2019,5,31,23,27,47,74
2019,6,1,0,20,17,37
2019,6,1,1,14,18,32
2019,6,1,2,15,17,32
2019,6,1,3,12,12,24
2019,6,1,4,24,10,34
2019,6,1,5,19,73,92
2019,6,1,6,46,34,80
2019,6,1,7,66,56,122
2019,6,1,8,110,66,176
2019,6,1,9,114,88,202
2019,6,1,10,157,119,276
2019,6,1,11,151,141,292
2019,6,1,12,153,139,292
2019,6,1,13,149,191,340
2019,6,1,14,119,144,263
2019,6,1,15,113,142,255
2019,6,1,16,137,152,289
2019,6,1,17,97,113,210
2019,6,1,18,109,99,208
2019,6,1,19,51,69,120
2019,6,1,20,37,55,92
2019,6,1,21,57,64,121
2019,6,1,22,42,44,86
2019,6,1,23,20,27,47
2019,6,2,0,19,33,52
2019,6,2,1,14,26,40
2019,6,2,2,14,9,23
2019,6,2,3,18,15,33
2019,6,2,4,17,8,25
2019,6,2,5,28,15,43
2019,6,2,6,30,19,49
2019,6,2,7,45,32,77
2019,6,2,8,70,56,126
2019,6,2,9,145,83,228
2019,6,2,10,145,147,292
2019,6,2,11,167,180,347
2019,6,2,12,188,164,352
2019,6,2,13,154,192,346
2019,6,2,14,136,183,319
2019,6,2,15,148,160,308
2019,6,2,16,130,142,272
2019,6,2,17,152,139,291
2019,6,2,18,99,154,253
2019,6,2,19,92,110,202
2019,6,2,20,63,79,142
2019,6,2,21,38,42,80
2019,6,2,22,26,24,50
2019,6,2,23,7,16,23
2019,6,3,0,12,7,19
2019,6,3,1,7,13,20
2019,6,3,2,10,9,19
2019,6,3,3,21,7,28
2019,6,3,4,121,54,175
2019,6,3,5,238,132,370
2019,6,3,6,419,198,617
2019,6,3,7,267,169,436
2019,6,3,8,192,150,342
2019,6,3,9,211,204,415
2019,6,3,10,187,188,375
2019,6,3,11,212,227,439
2019,6,3,12,227,224,451
2019,6,3,13,265,306,571
2019,6,3,14,221,296,517
2019,6,3,15,168,199,367
2019,6,3,16,176,162,338
2019,6,3,17,123,125,248
2019,6,3,18,108,147,255
2019,6,3,19,107,121,228
2019,6,3,20,60,82,142
2019,6,3,21,28,42,70
2019,6,3,22,26,25,51
2019,6,3,23,11,18,29
2019,6,4,0,12,9,21
2019,6,4,1,5,12,17
2019,6,4,2,11,8,19
2019,6,4,3,18,8,26
2019,6,4,4,113,62,175
2019,6,4,5,228,140,368
2019,6,4,6,391,190,581
2019,6,4,7,247,141,388
2019,6,4,8,204,151,355
2019,6,4,9,242,192,434
2019,6,4,10,225,217,442
2019,6,4,11,231,220,451
2019,6,4,12,246,262,508
2019,6,4,13,284,312,596
2019,6,4,14,218,259,477
2019,6,4,15,200,180,380
2019,6,4,16,171,149,320
2019,6,4,17,148,128,276
2019,6,4,18,105,136,241
2019,6,4,19,71,114,185
2019,6,4,20,68,86,154
2019,6,4,21,60,152,212
2019,6,4,22,28,25,53
2019,6,4,23,9,16,25
2019,6,5,0,13,34,47
2019,6,5,1,14,29,43
2019,6,5,2,11,21,32
2019,6,5,3,19,14,33
2019,6,5,4,99,50,149
2019,6,5,5,223,139,362
2019,6,5,6,403,194,597
2019,6,5,7,261,157,418
2019,6,5,8,231,165,396
2019,6,5,9,223,187,410
2019,6,5,10,210,193,403
2019,6,5,11,226,206,432
2019,6,5,12,234,263,497
2019,6,5,13,245,333,578
2019,6,5,14,217,290,507
2019,6,5,15,329,219,548
2019,6,5,16,220,175,395
2019,6,5,17,146,234,380
2019,6,5,18,133,223,356
2019,6,5,19,79,121,200
2019,6,5,20,56,102,158
2019,6,5,21,28,50,78
2019,6,5,22,23,71,94
2019,6,5,23,12,38,50
2019,6,6,0,12,36,48
2019,6,6,1,8,24,32
2019,6,6,2,12,28,40
2019,6,6,3,22,17,39
2019,6,6,4,105,58,163
2019,6,6,5,210,145,355
2019,6,6,6,361,187,548
2019,6,6,7,213,140,353
2019,6,6,8,243,146,389
2019,6,6,9,242,177,419
2019,6,6,10,208,201,409
2019,6,6,11,235,238,473
2019,6,6,12,232,268,500
2019,6,6,13,286,325,611
2019,6,6,14,230,289,519
2019,6,6,15,201,171,372
2019,6,6,16,172,192,364
2019,6,6,17,125,144,269
2019,6,6,18,99,104,203
2019,6,6,19,98,102,200
2019,6,6,20,88,89,177
2019,6,6,21,50,52,102
2019,6,6,22,25,29,54
2019,6,6,23,20,20,40
2019,6,7,0,19,26,45
2019,6,7,1,14,14,28
2019,6,7,2,8,5,13
2019,6,7,3,21,11,32
2019,6,7,4,106,56,162
2019,6,7,5,241,141,382
2019,6,7,6,394,191,585
2019,6,7,7,244,175,419
2019,6,7,8,218,183,401
2019,6,7,9,216,191,407
2019,6,7,10,219,214,433
2019,6,7,11,235,233,468
2019,6,7,12,265,292,557
2019,6,7,13,317,403,720
2019,6,7,14,236,297,533
2019,6,7,15,170,164,334
2019,6,7,16,152,151,303
2019,6,7,17,119,134,253
2019,6,7,18,112,129,241
2019,6,7,19,81,74,155
2019,6,7,20,60,77,137
2019,6,7,21,34,63,97
2019,6,7,22,31,42,73
2019,6,7,23,36,28,64
2019,6,8,0,27,27,54
2019,6,8,1,14,22,36
2019,6,8,2,10,14,24
2019,6,8,3,14,11,25
2019,6,8,4,25,14,39
2019,6,8,5,19,23,42
2019,6,8,6,31,37,68
2019,6,8,7,54,43,97
2019,6,8,8,97,66,163
2019,6,8,9,115,93,208
2019,6,8,10,172,144,316
2019,6,8,11,157,130,287
2019,6,8,12,169,174,343
2019,6,8,13,141,163,304
2019,6,8,14,128,184,312
2019,6,8,15,161,174,335
2019,6,8,16,118,149,267
2019,6,8,17,99,107,206
2019,6,8,18,100,99,199
2019,6,8,19,64,65,129
2019,6,8,20,50,58,108
2019,6,8,21,39,76,115
2019,6,8,22,39,40,79
2019,6,8,23,33,30,63
2019,6,9,0,11,34,45
2019,6,9,1,19,29,48
2019,6,9,2,15,17,32
2019,6,9,3,17,9,26
2019,6,9,4,20,14,34
2019,6,9,5,17,10,27
2019,6,9,6,34,13,47
2019,6,9,7,58,25,83
2019,6,9,8,87,39,126
2019,6,9,9,103,89,192
2019,6,9,10,166,118,284
2019,6,9,11,143,134,277
2019,6,9,12,165,167,332
2019,6,9,13,115,178,293
2019,6,9,14,117,178,295
2019,6,9,15,138,155,293
2019,6,9,16,144,135,279
2019,6,9,17,104,137,241
2019,6,9,18,99,147,246
2019,6,9,19,74,89,163
2019,6,9,20,48,69,117
2019,6,9,21,44,64,108
2019,6,9,22,23,37,60
2019,6,9,23,10,20,30
2019,6,10,0,12,11,23
2019,6,10,1,7,18,25
2019,6,10,2,5,10,15
2019,6,10,3,8,5,13
2019,6,10,4,19,13,32
2019,6,10,5,24,15,39
2019,6,10,6,30,23,53
2019,6,10,7,55,39,94
2019,6,10,8,99,66,165
2019,6,10,9,106,75,181
2019,6,10,10,146,130,276
2019,6,10,11,165,163,328
2019,6,10,12,152,176,328
2019,6,10,13,170,163,333
2019,6,10,14,183,173,356
2019,6,10,15,166,172,338
2019,6,10,16,139,151,290
2019,6,10,17,134,160,294
2019,6,10,18,107,125,232
2019,6,10,19,102,110,212
2019,6,10,20,67,86,153
2019,6,10,21,40,71,111
2019,6,10,22,29,37,66
2019,6,10,23,16,22,38
2019,6,11,0,13,12,25
2019,6,11,1,8,6,14
2019,6,11,2,9,9,18
2019,6,11,3,22,8,30
2019,6,11,4,103,60,163
2019,6,11,5,233,149,382
2019,6,11,6,406,184,590
2019,6,11,7,274,173,447
2019,6,11,8,229,184,413
2019,6,11,9,211,162,373
2019,6,11,10,233,216,449
2019,6,11,11,236,207,443
2019,6,11,12,190,246,436
2019,6,11,13,250,333,583
2019,6,11,14,233,294,527
2019,6,11,15,175,191,366
2019,6,11,16,158,150,308
2019,6,11,17,135,153,288
2019,6,11,18,105,110,215
2019,6,11,19,94,135,229
2019,6,11,20,68,78,146
2019,6,11,21,33,48,81
2019,6,11,22,30,29,59
2019,6,11,23,20,21,41
2019,6,12,0,12,15,27
2019,6,12,1,8,9,17
2019,6,12,2,9,4,13
2019,6,12,3,15,6,21
2019,6,12,4,102,54,156
2019,6,12,5,218,126,344
2019,6,12,6,384,187,571
2019,6,12,7,246,158,404
2019,6,12,8,187,167,354
2019,6,12,9,216,163,379
2019,6,12,10,229,206,435
2019,6,12,11,185,204,389
2019,6,12,12,236,241,477
2019,6,12,13,266,340,606
2019,6,12,14,205,275,480
2019,6,12,15,196,176,372
2019,6,12,16,159,154,313
2019,6,12,17,127,146,273
2019,6,12,18,111,145,256
2019,6,12,19,101,112,213
2019,6,12,20,79,155,234
2019,6,12,21,58,87,145
2019,6,12,22,33,35,68
2019,6,12,23,15,25,40
2019,6,13,0,16,12,28
2019,6,13,1,17,11,28
2019,6,13,2,21,3,24
2019,6,13,3,12,16,28
2019,6,13,4,116,53,169
2019,6,13,5,215,133,348
2019,6,13,6,372,238,610
2019,6,13,7,320,190,510
2019,6,13,8,225,179,404
2019,6,13,9,213,171,384
2019,6,13,10,214,205,419
2019,6,13,11,208,220,428
2019,6,13,12,268,283,551
2019,6,13,13,280,313,593
2019,6,13,14,258,265,523
2019,6,13,15,164,193,357
2019,6,13,16,282,192,474
2019,6,13,17,118,153,271
2019,6,13,18,119,126,245
2019,6,13,19,103,124,227
2019,6,13,20,81,89,170
2019,6,13,21,56,69,125
2019,6,13,22,43,65,108
2019,6,13,23,22,67,89
2019,6,14,0,18,74,92
2019,6,14,1,13,58,71
2019,6,14,2,16,40,56
2019,6,14,3,22,34,56
2019,6,14,4,104,57,161
2019,6,14,5,225,114,339
2019,6,14,6,379,186,565
2019,6,14,7,263,157,420
2019,6,14,8,242,153,395
2019,6,14,9,221,183,404
2019,6,14,10,240,223,463
2019,6,14,11,253,251,504
2019,6,14,12,234,268,502
2019,6,14,13,267,307,574
2019,6,14,14,202,245,447
2019,6,14,15,165,178,343
2019,6,14,16,138,151,289
2019,6,14,17,107,128,235
2019,6,14,18,108,116,224
2019,6,14,19,73,91,164
2019,6,14,20,64,81,145
2019,6,14,21,54,71,125
2019,6,14,22,40,53,93
2019,6,14,23,22,35,57
2019,6,15,0,26,22,48
2019,6,15,1,14,24,38
2019,6,15,2,7,16,23
2019,6,15,3,10,4,14
2019,6,15,4,31,17,48
2019,6,15,5,27,24,51
2019,6,15,6,34,44,78
2019,6,15,7,69,48,117
2019,6,15,8,100,89,189
2019,6,15,9,126,112,238
2019,6,15,10,129,116,245
2019,6,15,11,147,131,278
2019,6,15,12,173,157,330
2019,6,15,13,123,164,287
2019,6,15,14,116,146,262
2019,6,15,15,134,153,287
2019,6,15,16,112,149,261
2019,6,15,17,99,115,214
2019,6,15,18,96,105,201
2019,6,15,19,71,84,155
2019,6,15,20,55,70,125
2019,6,15,21,34,48,82
2019,6,15,22,41,46,87
2019,6,15,23,30,45,75
2019,6,16,0,31,34,65
2019,6,16,1,26,38,64
2019,6,16,2,19,16,35
2019,6,16,3,13,22,35
2019,6,16,4,15,13,28
2019,6,16,5,14,12,26
2019,6,16,6,47,19,66
2019,6,16,7,47,46,93
2019,6,16,8,64,44,108
2019,6,16,9,107,91,198
2019,6,16,10,133,133,266
2019,6,16,11,186,150,336
2019,6,16,12,207,171,378
2019,6,16,13,164,193,357
2019,6,16,14,172,208,380
2019,6,16,15,168,188,356
2019,6,16,16,193,171,364
2019,6,16,17,174,167,341
2019,6,16,18,122,147,269
2019,6,16,19,82,141,223
2019,6,16,20,57,79,136
2019,6,16,21,41,41,82
2019,6,16,22,19,29,48
2019,6,16,23,16,19,35
2019,6,17,0,9,12,21
2019,6,17,1,2,8,10
2019,6,17,2,7,8,15
2019,6,17,3,21,7,28
2019,6,17,4,111,53,164
2019,6,17,5,249,144,393
2019,6,17,6,375,195,570
2019,6,17,7,247,158,405
2019,6,17,8,226,165,391
2019,6,17,9,241,191,432
2019,6,17,10,227,201,428
2019,6,17,11,208,218,426
2019,6,17,12,232,257,489
2019,6,17,13,243,329,572
2019,6,17,14,214,276,490
2019,6,17,15,175,188,363
2019,6,17,16,140,173,313
2019,6,17,17,116,129,245
2019,6,17,18,114,127,241
2019,6,17,19,99,106,205
2019,6,17,20,52,70,122
2019,6,17,21,36,45,81
2019,6,17,22,15,24,39
2019,6,17,23,13,12,25
2019,6,18,0,13,7,20
2019,6,18,1,3,9,12
2019,6,18,2,7,5,12
2019,6,18,3,17,9,26
2019,6,18,4,109,58,167
2019,6,18,5,254,127,381
2019,6,18,6,367,173,540
2019,6,18,7,279,158,437
2019,6,18,8,207,179,386
2019,6,18,9,218,153,371
2019,6,18,10,202,192,394
2019,6,18,11,209,211,420
2019,6,18,12,241,250,491
2019,6,18,13,265,304,569
2019,6,18,14,221,279,500
2019,6,18,15,149,169,318
2019,6,18,16,189,173,362
2019,6,18,17,157,157,314
2019,6,18,18,120,143,263
2019,6,18,19,91,112,203
2019,6,18,20,78,100,178
2019,6,18,21,42,54,96
2019,6,18,22,21,26,47
2019,6,18,23,17,17,34
2019,6,19,0,9,16,25
2019,6,19,1,10,9,19
2019,6,19,2,12,12,24
2019,6,19,3,17,10,27
2019,6,19,4,111,48,159
2019,6,19,5,227,123,350
2019,6,19,6,355,171,526
2019,6,19,7,249,153,402
2019,6,19,8,180,162,342
2019,6,19,9,229,168,397
2019,6,19,10,213,186,399
2019,6,19,11,226,233,459
2019,6,19,12,241,253,494
2019,6,19,13,224,350,574
2019,6,19,14,224,257,481
2019,6,19,15,193,205,398
2019,6,19,16,153,145,298
2019,6,19,17,152,144,296
2019,6,19,18,132,133,265
2019,6,19,19,93,122,215
2019,6,19,20,61,82,143
2019,6,19,21,36,43,79
2019,6,19,22,24,31,55
2019,6,19,23,19,11,30
2019,6,20,0,10,13,23
2019,6,20,1,6,7,13
2019,6,20,2,7,8,15
2019,6,20,3,11,7,18
2019,6,20,4,115,48,163
2019,6,20,5,226,119,345
2019,6,20,6,351,185,536
2019,6,20,7,259,161,420
2019,6,20,8,227,171,398
2019,6,20,9,216,169,385
2019,6,20,10,203,186,389
2019,6,20,11,230,214,444
2019,6,20,12,255,244,499
2019,6,20,13,277,310,587
2019,6,20,14,194,270,464
2019,6,20,15,182,195,377
2019,6,20,16,200,180,380
2019,6,20,17,136,127,263
2019,6,20,18,107,140,247
2019,6,20,19,79,121,200
2019,6,20,20,69,78,147
2019,6,20,21,35,42,77
2019,6,20,22,26,26,52
2019,6,20,23,15,12,27
2019,6,21,0,16,15,31
2019,6,21,1,14,18,32
2019,6,21,2,12,11,23
2019,6,21,3,20,9,29
2019,6,21,4,109,50,159
2019,6,21,5,220,104,324
2019,6,21,6,365,164,529
2019,6,21,7,241,162,403
2019,6,21,8,215,185,400
2019,6,21,9,279,185,464
2019,6,21,10,225,233,458
2019,6,21,11,261,222,483
2019,6,21,12,234,312,546
2019,6,21,13,279,302,581
2019,6,21,14,211,274,485
2019,6,21,15,143,181,324
2019,6,21,16,157,147,304
2019,6,21,17,124,125,249
2019,6,21,18,98,116,214
2019,6,21,19,81,101,182
2019,6,21,20,64,99,163
2019,6,21,21,58,79,137
2019,6,21,22,39,43,82
2019,6,21,23,25,27,52
2019,6,22,0,17,22,39
2019,6,22,1,16,18,34
2019,6,22,2,17,15,32
2019,6,22,3,10,11,21
2019,6,22,4,27,12,39
2019,6,22,5,28,35,63
2019,6,22,6,53,41,94
2019,6,22,7,69,61,130
2019,6,22,8,106,87,193
2019,6,22,9,141,113,254
2019,6,22,10,160,148,308
2019,6,22,11,173,139,312
2019,6,22,12,140,192,332
2019,6,22,13,142,187,329
2019,6,22,14,120,158,278
2019,6,22,15,128,171,299
2019,6,22,16,135,130,265
2019,6,22,17,86,98,184
2019,6,22,18,74,88,162
2019,6,22,19,58,73,131
2019,6,22,20,41,49,90
2019,6,22,21,47,59,106
2019,6,22,22,41,51,92
2019,6,22,23,28,35,63
2019,6,23,0,26,28,54
2019,6,23,1,29,25,54
2019,6,23,2,10,18,28
2019,6,23,3,12,9,21
2019,6,23,4,18,13,31
2019,6,23,5,18,5,23
2019,6,23,6,42,19,61
2019,6,23,7,37,37,74
2019,6,23,8,69,55,124
2019,6,23,9,103,91,194
2019,6,23,10,135,113,248
2019,6,23,11,148,157,305
2019,6,23,12,145,171,316
2019,6,23,13,142,176,318
2019,6,23,14,131,182,313
2019,6,23,15,151,156,307
2019,6,23,16,128,128,256
2019,6,23,17,120,158,278
2019,6,23,18,99,119,218
2019,6,23,19,85,126,211
2019,6,23,20,115,110,225
2019,6,23,21,60,68,128
2019,6,23,22,23,40,63
2019,6,23,23,16,15,31
2019,6,24,0,6,7,13
2019,6,24,1,14,10,24
2019,6,24,2,9,9,18
2019,6,24,3,17,13,30
2019,6,24,4,95,51,146
2019,6,24,5,228,111,339
2019,6,24,6,306,159,465
2019,6,24,7,262,169,431
2019,6,24,8,221,149,370
2019,6,24,9,231,174,405
2019,6,24,10,209,176,385
2019,6,24,11,218,212,430
2019,6,24,12,226,260,486
2019,6,24,13,243,337,580
2019,6,24,14,175,263,438
2019,6,24,15,160,164,324
2019,6,24,16,142,139,281
2019,6,24,17,112,120,232
2019,6,24,18,108,91,199
2019,6,24,19,82,88,170
2019,6,24,20,59,54,113
2019,6,24,21,40,42,82
2019,6,24,22,24,27,51
2019,6,24,23,13,14,27
2019,6,25,0,13,16,29
2019,6,25,1,11,3,14
2019,6,25,2,5,6,11
2019,6,25,3,14,12,26
2019,6,25,4,101,44,145
2019,6,25,5,218,126,344
2019,6,25,6,327,160,487
2019,6,25,7,283,152,435
2019,6,25,8,202,136,338
2019,6,25,9,212,177,389
2019,6,25,10,206,188,394
2019,6,25,11,212,199,411
2019,6,25,12,206,257,463
2019,6,25,13,237,310,547
2019,6,25,14,179,281,460
2019,6,25,15,173,191,364
2019,6,25,16,165,135,300
2019,6,25,17,118,133,251
2019,6,25,18,89,100,189
2019,6,25,19,79,115,194
2019,6,25,20,75,84,159
2019,6,25,21,42,45,87
2019,6,25,22,28,29,57
2019,6,25,23,14,13,27
2019,6,26,0,5,8,13
2019,6,26,1,9,13,22
2019,6,26,2,4,8,12
2019,6,26,3,13,9,22
2019,6,26,4,89,46,135
2019,6,26,5,234,135,369
2019,6,26,6,335,159,494
2019,6,26,7,277,162,439
2019,6,26,8,212,152,364
2019,6,26,9,226,200,426
2019,6,26,10,225,225,450
2019,6,26,11,212,197,409
2019,6,26,12,234,235,469
2019,6,26,13,215,329,544
2019,6,26,14,178,269,447
2019,6,26,15,163,191,354
2019,6,26,16,142,176,318
2019,6,26,17,119,119,238
2019,6,26,18,118,136,254
2019,6,26,19,82,94,176
2019,6,26,20,71,63,134
2019,6,26,21,31,46,77
2019,6,26,22,31,24,55
2019,6,26,23,12,13,25
2019,6,27,0,10,9,19
2019,6,27,1,9,11,20
2019,6,27,2,10,7,17
2019,6,27,3,16,20,36
2019,6,27,4,90,45,135
2019,6,27,5,233,102,335
2019,6,27,6,305,137,442
2019,6,27,7,257,137,394
2019,6,27,8,189,178,367
2019,6,27,9,201,159,360
2019,6,27,10,239,181,420
2019,6,27,11,219,196,415
2019,6,27,12,233,244,477
2019,6,27,13,256,333,589
2019,6,27,14,175,271,446
2019,6,27,15,154,168,322
2019,6,27,16,147,146,293
2019,6,27,17,119,139,258
2019,6,27,18,106,100,206
2019,6,27,19,72,86,158
2019,6,27,20,53,61,114
2019,6,27,21,26,68,94
2019,6,27,22,33,35,68
2019,6,27,23,24,32,56
2019,6,28,0,17,25,42
2019,6,28,1,13,21,34
2019,6,28,2,9,15,24
2019,6,28,3,23,17,40
2019,6,28,4,95,39,134
2019,6,28,5,219,102,321
2019,6,28,6,311,125,436
2019,6,28,7,261,168,429
2019,6,28,8,209,155,364
2019,6,28,9,233,194,427
2019,6,28,10,216,178,394
2019,6,28,11,224,213,437
2019,6,28,12,273,277,550
2019,6,28,13,220,289,509
2019,6,28,14,152,233,385
2019,6,28,15,133,170,303
2019,6,28,16,113,129,242
2019,6,28,17,105,88,193
2019,6,28,18,81,112,193
2019,6,28,19,85,86,171
2019,6,28,20,62,71,133
2019,6,28,21,58,56,114
2019,6,28,22,37,35,72
2019,6,28,23,12,27,39
2019,6,29,0,15,26,41
2019,6,29,1,18,13,31
2019,6,29,2,9,20,29
2019,6,29,3,9,13,22
2019,6,29,4,22,13,35
2019,6,29,5,28,22,50
2019,6,29,6,37,32,69
2019,6,29,7,60,43,103
2019,6,29,8,85,70,155
2019,6,29,9,123,107,230
2019,6,29,10,114,108,222
2019,6,29,11,122,128,250
2019,6,29,12,119,149,268
2019,6,29,13,129,136,265
2019,6,29,14,111,120,231
2019,6,29,15,93,122,215
2019,6,29,16,119,115,234
2019,6,29,17,80,119,199
2019,6,29,18,81,83,164
2019,6,29,19,43,54,97
2019,6,29,20,42,60,102
2019,6,29,21,43,50,93
2019,6,29,22,34,32,66
2019,6,29,23,29,19,48
2019,6,30,0,21,29,50
2019,6,30,1,18,27,45
2019,6,30,2,14,20,34
2019,6,30,3,14,11,25
2019,6,30,4,21,6,27
2019,6,30,5,12,10,22
2019,6,30,6,27,14,41
2019,6,30,7,27,27,54
2019,6,30,8,79,41,120
2019,6,30,9,97,55,152
2019,6,30,10,127,110,237
2019,6,30,11,126,111,237
2019,6,30,12,158,180,338
2019,6,30,13,138,158,296
2019,6,30,14,117,182,299
2019,6,30,15,134,135,269
2019,6,30,16,128,145,273
2019,6,30,17,150,152,302
2019,6,30,18,96,132,228
2019,6,30,19,86,106,192
2019,6,30,20,60,67,127
2019,6,30,21,34,45,79
2019,6,30,22,28,25,53
2019,6,30,23,15,13,28
2019,7,1,0,15,18,33
2019,7,1,1,10,9,19
2019,7,1,2,6,10,16
2019,7,1,3,16,10,26
2019,7,1,4,85,49,134
2019,7,1,5,206,110,316
2019,7,1,6,283,140,423
2019,7,1,7,224,129,353
2019,7,1,8,221,147,368
2019,7,1,9,201,162,363
2019,7,1,10,209,185,394
2019,7,1,11,223,204,427
2019,7,1,12,223,236,459
2019,7,1,13,224,311,535
2019,7,1,14,161,289,450
2019,7,1,15,165,164,329
2019,7,1,16,135,137,272
2019,7,1,17,115,110,225
2019,7,1,18,115,114,229
2019,7,1,19,68,85,153
2019,7,1,20,68,60,128
2019,7,1,21,47,41,88
2019,7,1,22,34,34,68
2019,7,1,23,15,12,27
2019,7,2,0,11,7,18
2019,7,2,1,14,12,26
2019,7,2,2,11,6,17
2019,7,2,3,20,12,32
2019,7,2,4,83,34,117
2019,7,2,5,178,97,275
2019,7,2,6,263,113,376
2019,7,2,7,229,174,403
2019,7,2,8,163,141,304
2019,7,2,9,200,162,362
2019,7,2,10,191,175,366
2019,7,2,11,201,186,387
2019,7,2,12,196,225,421
2019,7,2,13,229,305,534
2019,7,2,14,169,247,416
2019,7,2,15,147,151,298
2019,7,2,16,116,133,249
2019,7,2,17,123,124,247
2019,7,2,18,92,91,183
2019,7,2,19,75,95,170
2019,7,2,20,61,63,124
2019,7,2,21,44,33,77
2019,7,2,22,14,54,68
2019,7,2,23,21,22,43
2019,7,3,0,13,10,23
2019,7,3,1,5,11,16
2019,7,3,2,7,7,14
2019,7,3,3,10,10,20
2019,7,3,4,83,45,128
2019,7,3,5,199,93,292
2019,7,3,6,269,136,405
2019,7,3,7,226,144,370
2019,7,3,8,199,160,359
2019,7,3,9,179,154,333
2019,7,3,10,193,158,351
2019,7,3,11,185,193,378
2019,7,3,12,229,244,473
2019,7,3,13,196,305,501
2019,7,3,14,172,247,419
2019,7,3,15,133,159,292
2019,7,3,16,143,118,261
2019,7,3,17,98,109,207
2019,7,3,18,95,124,219
2019,7,3,19,77,77,154
2019,7,3,20,67,66,133
2019,7,3,21,34,28,62
2019,7,3,22,30,24,54
2019,7,3,23,12,11,23
2019,7,4,0,13,11,24
2019,7,4,1,16,15,31
2019,7,4,2,7,9,16
2019,7,4,3,16,14,30
2019,7,4,4,65,48,113
2019,7,4,5,189,101,290
2019,7,4,6,302,137,439
2019,7,4,7,198,130,328
2019,7,4,8,193,146,339
2019,7,4,9,195,144,339
2019,7,4,10,221,198,419
2019,7,4,11,204,174,378
2019,7,4,12,216,242,458
2019,7,4,13,238,279,517
2019,7,4,14,167,248,415
2019,7,4,15,132,149,281
2019,7,4,16,124,143,267
2019,7,4,17,116,131,247
2019,7,4,18,92,115,207
2019,7,4,19,78,93,171
2019,7,4,20,64,95,159
2019,7,4,21,40,56,96
2019,7,4,22,13,122,135
2019,7,4,23,16,62,78
2019,7,5,0,10,38,48
2019,7,5,1,4,43,47
2019,7,5,2,8,9,17
2019,7,5,3,13,12,25
2019,7,5,4,95,44,139
2019,7,5,5,172,87,259
2019,7,5,6,248,124,372
2019,7,5,7,212,133,345
2019,7,5,8,190,167,357
2019,7,5,9,189,161,350
2019,7,5,10,180,173,353
2019,7,5,11,200,184,384
2019,7,5,12,198,237,435
2019,7,5,13,221,240,461
2019,7,5,14,150,204,354
2019,7,5,15,131,161,292
2019,7,5,16,92,128,220
2019,7,5,17,92,87,179
2019,7,5,18,80,112,192
2019,7,5,19,123,86,209
2019,7,5,20,60,65,125
2019,7,5,21,31,40,71
2019,7,5,22,25,40,65
2019,7,5,23,17,31,48
2019,7,6,0,12,29,41
2019,7,6,1,10,14,24
2019,7,6,2,7,9,16
2019,7,6,3,6,6,12
2019,7,6,4,18,9,27
2019,7,6,5,26,25,51
2019,7,6,6,28,28,56
2019,7,6,7,44,29,73
2019,7,6,8,60,63,123
2019,7,6,9,98,59,157
2019,7,6,10,105,88,193
2019,7,6,11,130,116,246
2019,7,6,12,128,125,253
2019,7,6,13,96,144,240
2019,7,6,14,110,128,238
2019,7,6,15,78,115,193
2019,7,6,16,99,105,204
2019,7,6,17,70,75,145
2019,7,6,18,75,78,153
2019,7,6,19,58,66,124
2019,7,6,20,47,60,107
2019,7,6,21,52,47,99
2019,7,6,22,33,43,76
2019,7,6,23,23,26,49
2019,7,7,0,16,16,32
2019,7,7,1,18,24,42
2019,7,7,2,10,13,23
2019,7,7,3,5,13,18
2019,7,7,4,13,8,21
2019,7,7,5,22,22,44
2019,7,7,6,29,15,44
2019,7,7,7,40,29,69
2019,7,7,8,67,38,105
2019,7,7,9,77,55,132
2019,7,7,10,92,114,206
2019,7,7,11,104,101,205
2019,7,7,12,131,127,258
2019,7,7,13,128,131,259
2019,7,7,14,106,123,229
2019,7,7,15,109,129,238
2019,7,7,16,104,96,200
2019,7,7,17,106,120,226
2019,7,7,18,91,120,211
2019,7,7,19,84,81,165
2019,7,7,20,61,69,130
2019,7,7,21,43,55,98
2019,7,7,22,21,16,37
2019,7,7,23,9,12,21
2019,7,8,0,17,13,30
2019,7,8,1,8,6,14
2019,7,8,2,5,8,13
2019,7,8,3,19,15,34
2019,7,8,4,70,45,115
2019,7,8,5,127,95,222
2019,7,8,6,188,102,290
2019,7,8,7,159,110,269
2019,7,8,8,153,131,284
2019,7,8,9,182,144,326
2019,7,8,10,191,156,347
2019,7,8,11,172,167,339
2019,7,8,12,177,182,359
2019,7,8,13,185,224,409
2019,7,8,14,120,174,294
2019,7,8,15,129,141,270
2019,7,8,16,107,108,215
2019,7,8,17,108,112,220
2019,7,8,18,73,98,171
2019,7,8,19,73,75,148
2019,7,8,20,78,64,142
2019,7,8,21,42,38,80
2019,7,8,22,27,34,61
2019,7,8,23,11,11,22
2019,7,9,0,16,8,24
2019,7,9,1,16,9,25
2019,7,9,2,13,3,16
2019,7,9,3,18,11,29
2019,7,9,4,71,34,105
2019,7,9,5,145,81,226
2019,7,9,6,187,100,287
2019,7,9,7,153,111,264
2019,7,9,8,131,123,254
2019,7,9,9,169,110,279
2019,7,9,10,150,158,308
2019,7,9,11,149,147,296
2019,7,9,12,192,154,346
2019,7,9,13,164,207,371
2019,7,9,14,151,203,354
2019,7,9,15,106,121,227
2019,7,9,16,89,113,202
2019,7,9,17,95,109,204
2019,7,9,18,90,93,183
2019,7,9,19,75,90,165
2019,7,9,20,69,73,142
2019,7,9,21,43,55,98
2019,7,9,22,27,26,53
2019,7,9,23,11,15,26
2019,7,10,0,10,24,34
2019,7,10,1,13,31,44
2019,7,10,2,4,31,35
2019,7,10,3,14,26,40
2019,7,10,4,67,37,104
2019,7,10,5,126,65,191
2019,7,10,6,190,103,293
2019,7,10,7,162,96,258
2019,7,10,8,154,119,273
2019,7,10,9,154,111,265
2019,7,10,10,169,137,306
2019,7,10,11,173,170,343
2019,7,10,12,183,156,339
2019,7,10,13,176,201,377
2019,7,10,14,131,202,333
2019,7,10,15,127,126,253
2019,7,10,16,113,119,232
2019,7,10,17,95,103,198
2019,7,10,18,97,107,204
2019,7,10,19,75,99,174
2019,7,10,20,77,89,166
2019,7,10,21,48,45,93
2019,7,10,22,36,43,79
2019,7,10,23,12,16,28
2019,7,11,0,14,15,29
2019,7,11,1,6,12,18
2019,7,11,2,8,8,16
2019,7,11,3,15,13,28
2019,7,11,4,66,37,103
2019,7,11,5,121,86,207
2019,7,11,6,170,106,276
2019,7,11,7,148,100,248
2019,7,11,8,142,106,248
2019,7,11,9,160,119,279
2019,7,11,10,162,121,283
2019,7,11,11,152,153,305
2019,7,11,12,167,182,349
2019,7,11,13,178,198,376
2019,7,11,14,160,156,316
2019,7,11,15,106,161,267
2019,7,11,16,118,132,250
2019,7,11,17,110,116,226
2019,7,11,18,93,83,176
2019,7,11,19,109,91,200
2019,7,11,20,69,82,151
2019,7,11,21,41,60,101
2019,7,11,22,19,27,46
2019,7,11,23,15,17,32
2019,7,12,0,16,17,33
2019,7,12,1,15,18,33
2019,7,12,2,8,7,15
2019,7,12,3,15,16,31
2019,7,12,4,64,31,95
2019,7,12,5,137,91,228
2019,7,12,6,163,71,234
2019,7,12,7,125,120,245
2019,7,12,8,148,110,258
2019,7,12,9,169,128,297
2019,7,12,10,167,134,301
2019,7,12,11,173,159,332
2019,7,12,12,186,197,383
2019,7,12,13,161,184,345
2019,7,12,14,123,174,297
2019,7,12,15,104,127,231
2019,7,12,16,94,110,204
2019,7,12,17,95,89,184
2019,7,12,18,86,67,153
2019,7,12,19,79,74,153
2019,7,12,20,57,63,120
2019,7,12,21,42,49,91
2019,7,12,22,22,32,54
2019,7,12,23,13,16,29
2019,7,13,0,10,12,22
2019,7,13,1,13,27,40
2019,7,13,2,6,9,15
2019,7,13,3,6,11,17
2019,7,13,4,16,7,23
2019,7,13,5,28,17,45
2019,7,13,6,24,33,57
2019,7,13,7,42,43,85
2019,7,13,8,56,56,112
2019,7,13,9,97,76,173
2019,7,13,10,88,79,167
2019,7,13,11,84,88,172
2019,7,13,12,96,111,207
2019,7,13,13,86,104,190
2019,7,13,14,106,108,214
2019,7,13,15,92,92,184
2019,7,13,16,83,81,164
2019,7,13,17,73,91,164
2019,7,13,18,74,86,160
2019,7,13,19,48,67,115
2019,7,13,20,45,54,99
2019,7,13,21,36,43,79
2019,7,13,22,21,44,65
2019,7,13,23,21,26,47
2019,7,14,0,14,18,32
2019,7,14,1,17,19,36
2019,7,14,2,9,17,26
2019,7,14,3,8,7,15
2019,7,14,4,8,6,14
2019,7,14,5,18,8,26
2019,7,14,6,21,8,29
2019,7,14,7,22,24,46
2019,7,14,8,63,43,106
2019,7,14,9,63,66,129
2019,7,14,10,90,82,172
2019,7,14,11,82,84,166
2019,7,14,12,118,101,219
2019,7,14,13,110,129,239
2019,7,14,14,123,138,261
2019,7,14,15,87,110,197
2019,7,14,16,94,121,215
2019,7,14,17,102,104,206
2019,7,14,18,83,108,191
2019,7,14,19,63,85,148
2019,7,14,20,54,59,113
2019,7,14,21,24,42,66
2019,7,14,22,23,25,48
2019,7,14,23,9,18,27
2019,7,15,0,10,6,16
2019,7,15,1,5,9,14
2019,7,15,2,7,4,11
2019,7,15,3,17,8,25
2019,7,15,4,62,34,96
2019,7,15,5,103,67,170
2019,7,15,6,120,70,190
2019,7,15,7,122,98,220
2019,7,15,8,132,116,248
2019,7,15,9,141,132,273
2019,7,15,10,157,140,297
2019,7,15,11,152,151,303
2019,7,15,12,146,166,312
2019,7,15,13,132,174,306
2019,7,15,14,108,149,257
2019,7,15,15,98,135,233
2019,7,15,16,111,115,226
2019,7,15,17,80,102,182
2019,7,15,18,84,80,164
2019,7,15,19,62,83,145
2019,7,15,20,49,68,117
2019,7,15,21,31,34,65
2019,7,15,22,22,25,47
2019,7,15,23,11,17,28
2019,7,16,0,7,14,21
2019,7,16,1,11,10,21
2019,7,16,2,5,4,9
2019,7,16,3,13,10,23
2019,7,16,4,59,34,93
2019,7,16,5,111,78,189
2019,7,16,6,119,99,218
2019,7,16,7,125,90,215
2019,7,16,8,134,118,252
2019,7,16,9,149,108,257
2019,7,16,10,157,146,303
2019,7,16,11,167,143,310
2019,7,16,12,151,171,322
2019,7,16,13,182,184,366
2019,7,16,14,103,138,241
2019,7,16,15,98,124,222
2019,7,16,16,112,107,219
2019,7,16,17,95,82,177
2019,7,16,18,76,100,176
2019,7,16,19,60,93,153
2019,7,16,20,44,44,88
2019,7,16,21,26,42,68
2019,7,16,22,18,17,35
2019,7,16,23,14,13,27
2019,7,17,0,8,8,16
2019,7,17,1,8,12,20
2019,7,17,2,3,9,12
2019,7,17,3,14,9,23
2019,7,17,4,51,28,79
2019,7,17,5,105,84,189
2019,7,17,6,138,83,221
2019,7,17,7,133,88,221
2019,7,17,8,134,104,238
2019,7,17,9,132,120,252
2019,7,17,10,148,132,280
2019,7,17,11,140,129,269
2019,7,17,12,164,157,321
2019,7,17,13,163,183,346
2019,7,17,14,130,142,272
2019,7,17,15,131,131,262
2019,7,17,16,100,120,220
2019,7,17,17,90,94,184
2019,7,17,18,81,74,155
2019,7,17,19,67,72,139
2019,7,17,20,38,74,112
2019,7,17,21,37,35,72
2019,7,17,22,13,22,35
2019,7,17,23,13,12,25
2019,7,18,0,13,14,27
2019,7,18,1,10,11,21
2019,7,18,2,4,9,13
2019,7,18,3,15,8,23
2019,7,18,4,48,34,82
2019,7,18,5,107,77,184
2019,7,18,6,124,76,200
2019,7,18,7,137,99,236
2019,7,18,8,139,115,254
2019,7,18,9,155,118,273
2019,7,18,10,149,131,280
2019,7,18,11,172,123,295
2019,7,18,12,165,181,346
2019,7,18,13,164,171,335
2019,7,18,14,112,170,282
2019,7,18,15,121,116,237
2019,7,18,16,113,107,220
2019,7,18,17,102,89,191
2019,7,18,18,72,83,155
2019,7,18,19,47,73,120
2019,7,18,20,34,43,77
2019,7,18,21,33,52,85
2019,7,18,22,18,21,39
2019,7,18,23,9,11,20
2019,7,19,0,15,13,28
2019,7,19,1,7,13,20
2019,7,19,2,8,9,17
2019,7,19,3,9,6,15
2019,7,19,4,52,31,83
2019,7,19,5,108,75,183
2019,7,19,6,132,81,213
2019,7,19,7,145,81,226
2019,7,19,8,119,107,226
2019,7,19,9,156,116,272
2019,7,19,10,155,143,298
2019,7,19,11,169,153,322
2019,7,19,12,166,168,334
2019,7,19,13,144,209,353
2019,7,19,14,145,144,289
2019,7,19,15,107,121,228
2019,7,19,16,87,99,186
2019,7,19,17,94,81,175
2019,7,19,18,86,88,174
2019,7,19,19,62,73,135
2019,7,19,20,56,52,108
2019,7,19,21,28,43,71
2019,7,19,22,30,37,67
2019,7,19,23,7,30,37
2019,7,20,0,12,14,26
2019,7,20,1,11,13,24
2019,7,20,2,7,11,18
2019,7,20,3,12,9,21
2019,7,20,4,10,13,23
2019,7,20,5,23,22,45
2019,7,20,6,26,22,48
2019,7,20,7,56,33,89
2019,7,20,8,67,58,125
2019,7,20,9,73,77,150
2019,7,20,10,111,76,187
2019,7,20,11,119,99,218
2019,7,20,12,123,122,245
2019,7,20,13,100,126,226
2019,7,20,14,105,122,227
2019,7,20,15,103,113,216
2019,7,20,16,99,105,204
2019,7,20,17,85,72,157
2019,7,20,18,81,91,172
2019,7,20,19,60,60,120
2019,7,20,20,44,55,99
2019,7,20,21,38,40,78
2019,7,20,22,36,32,68
2019,7,20,23,22,28,50
2019,7,21,0,18,15,33
2019,7,21,1,21,30,51
2019,7,21,2,17,23,40
2019,7,21,3,6,10,16
2019,7,21,4,14,8,22
2019,7,21,5,16,11,27
2019,7,21,6,23,7,30
2019,7,21,7,27,28,55
2019,7,21,8,74,39,113
2019,7,21,9,95,57,152
2019,7,21,10,131,99,230
2019,7,21,11,131,93,224
2019,7,21,12,110,123,233
2019,7,21,13,135,126,261
2019,7,21,14,121,127,248
2019,7,21,15,105,162,267
2019,7,21,16,135,130,265
2019,7,21,17,99,104,203
2019,7,21,18,136,113,249
2019,7,21,19,80,106,186
2019,7,21,20,48,55,103
2019,7,21,21,40,58,98
2019,7,21,22,15,30,45
2019,7,21,23,17,14,31
2019,7,22,0,7,9,16
2019,7,22,1,10,12,22
2019,7,22,2,7,8,15
2019,7,22,3,16,12,28
2019,7,22,4,61,32,93
2019,7,22,5,94,64,158
2019,7,22,6,147,71,218
2019,7,22,7,122,89,211
2019,7,22,8,134,102,236
2019,7,22,9,153,131,284
2019,7,22,10,195,154,349
2019,7,22,11,167,133,300
2019,7,22,12,180,164,344
2019,7,22,13,174,179,353
2019,7,22,14,132,169,301
2019,7,22,15,133,128,261
2019,7,22,16,106,125,231
2019,7,22,17,89,106,195
2019,7,22,18,71,91,162
2019,7,22,19,60,57,117
2019,7,22,20,44,173,217
2019,7,22,21,25,185,210
2019,7,22,22,27,33,60
2019,7,22,23,15,16,31
2019,7,23,0,7,5,12
2019,7,23,1,6,14,20
2019,7,23,2,12,4,16
2019,7,23,3,18,9,27
2019,7,23,4,56,25,81
2019,7,23,5,110,77,187
2019,7,23,6,124,87,211
2019,7,23,7,140,86,226
2019,7,23,8,128,97,225
2019,7,23,9,152,139,291
2019,7,23,10,179,125,304
2019,7,23,11,159,135,294
2019,7,23,12,179,169,348
2019,7,23,13,183,180,363
2019,7,23,14,129,166,295
2019,7,23,15,131,124,255
2019,7,23,16,101,107,208
2019,7,23,17,85,100,185
2019,7,23,18,83,124,207
2019,7,23,19,62,89,151
2019,7,23,20,56,57,113
2019,7,23,21,25,88,113
2019,7,23,22,13,24,37
2019,7,23,23,9,16,25
2019,7,24,0,9,7,16
2019,7,24,1,6,14,20
2019,7,24,2,6,9,15
2019,7,24,3,17,11,28
2019,7,24,4,45,24,69
2019,7,24,5,101,71,172
2019,7,24,6,146,85,231
2019,7,24,7,146,97,243
2019,7,24,8,151,104,255
2019,7,24,9,138,125,263
2019,7,24,10,149,113,262
2019,7,24,11,142,123,265
2019,7,24,12,157,163,320
2019,7,24,13,141,158,299
2019,7,24,14,133,155,288
2019,7,24,15,98,120,218
2019,7,24,16,94,96,190
2019,7,24,17,111,107,218
2019,7,24,18,66,68,134
2019,7,24,19,57,72,129
2019,7,24,20,66,52,118
2019,7,24,21,46,42,88
2019,7,24,22,25,27,52
2019,7,24,23,18,19,37
2019,7,25,0,13,15,28
2019,7,25,1,20,22,42
2019,7,25,2,10,6,16
2019,7,25,3,20,9,29
2019,7,25,4,46,31,77
2019,7,25,5,93,67,160
2019,7,25,6,121,83,204
2019,7,25,7,123,99,222
2019,7,25,8,139,105,244
2019,7,25,9,133,126,259
2019,7,25,10,141,135,276
2019,7,25,11,124,126,250
2019,7,25,12,183,146,329
2019,7,25,13,154,197,351
2019,7,25,14,105,152,257
2019,7,25,15,127,116,243
2019,7,25,16,108,112,220
2019,7,25,17,91,100,191
2019,7,25,18,85,101,186
2019,7,25,19,77,92,169
2019,7,25,20,54,57,111
2019,7,25,21,35,70,105
2019,7,25,22,22,26,48
2019,7,25,23,12,24,36
2019,7,26,0,8,22,30
2019,7,26,1,5,21,26
2019,7,26,2,11,14,25
2019,7,26,3,17,9,26
2019,7,26,4,64,30,94
2019,7,26,5,86,69,155
2019,7,26,6,106,78,184
2019,7,26,7,142,91,233
2019,7,26,8,123,114,237
2019,7,26,9,154,131,285
2019,7,26,10,142,133,275
2019,7,26,11,132,153,285
2019,7,26,12,140,178,318
2019,7,26,13,144,146,290
2019,7,26,14,125,136,261
2019,7,26,15,102,124,226
2019,7,26,16,99,113,212
2019,7,26,17,101,94,195
2019,7,26,18,74,83,157
2019,7,26,19,59,86,145
2019,7,26,20,63,70,133
2019,7,26,21,50,53,103
2019,7,26,22,31,27,58
2019,7,26,23,16,18,34
2019,7,27,0,13,19,32
2019,7,27,1,10,18,28
2019,7,27,2,8,10,18
2019,7,27,3,4,3,7
2019,7,27,4,14,4,18
2019,7,27,5,25,24,49
2019,7,27,6,28,36,64
2019,7,27,7,59,40,99
2019,7,27,8,73,66,139
2019,7,27,9,98,96,194
2019,7,27,10,108,94,202
2019,7,27,11,112,103,215
2019,7,27,12,92,100,192
2019,7,27,13,91,98,189
2019,7,27,14,87,100,187
2019,7,27,15,88,120,208
2019,7,27,16,93,80,173
2019,7,27,17,75,94,169
2019,7,27,18,79,81,160
2019,7,27,19,60,73,133
2019,7,27,20,51,64,115
2019,7,27,21,25,51,76
2019,7,27,22,33,39,72
2019,7,27,23,25,29,54
2019,7,28,0,16,26,42
2019,7,28,1,26,30,56
2019,7,28,2,11,24,35
2019,7,28,3,10,12,22
2019,7,28,4,15,12,27
2019,7,28,5,19,17,36
2019,7,28,6,25,12,37
2019,7,28,7,53,30,83
2019,7,28,8,68,36,104
2019,7,28,9,77,65,142
2019,7,28,10,101,89,190
2019,7,28,11,110,108,218
2019,7,28,12,121,97,218
2019,7,28,13,107,111,218
2019,7,28,14,101,117,218
2019,7,28,15,121,134,255
2019,7,28,16,109,127,236
2019,7,28,17,119,104,223
2019,7,28,18,99,151,250
2019,7,28,19,86,104,190
2019,7,28,20,53,72,125
2019,7,28,21,41,57,98
2019,7,28,22,17,18,35
2019,7,28,23,16,14,30
2019,7,29,0,5,6,11
2019,7,29,1,12,8,20
2019,7,29,2,5,4,9
2019,7,29,3,13,9,22
2019,7,29,4,61,35,96
2019,7,29,5,117,75,192
2019,7,29,6,190,78,268
2019,7,29,7,166,101,267
2019,7,29,8,156,122,278
2019,7,29,9,166,132,298
2019,7,29,10,181,141,322
2019,7,29,11,153,168,321
2019,7,29,12,166,180,346
2019,7,29,13,186,212,398
2019,7,29,14,133,176,309
2019,7,29,15,132,136,268
2019,7,29,16,125,110,235
2019,7,29,17,103,118,221
2019,7,29,18,108,100,208
2019,7,29,19,75,98,173
2019,7,29,20,72,215,287
2019,7,29,21,46,160,206
2019,7,29,22,23,83,106
2019,7,29,23,9,32,41
2019,7,30,0,9,20,29
2019,7,30,1,12,23,35
2019,7,30,2,5,20,25
2019,7,30,3,13,25,38
2019,7,30,4,66,36,102
2019,7,30,5,134,87,221
2019,7,30,6,172,101,273
2019,7,30,7,146,100,246
2019,7,30,8,147,122,269
2019,7,30,9,153,129,282
2019,7,30,10,163,161,324
2019,7,30,11,192,166,358
2019,7,30,12,168,209,377
2019,7,30,13,189,221,410
2019,7,30,14,161,194,355
2019,7,30,15,135,161,296
2019,7,30,16,128,115,243
2019,7,30,17,130,122,252
2019,7,30,18,102,106,208
2019,7,30,19,90,89,179
2019,7,30,20,58,65,123
2019,7,30,21,42,41,83
2019,7,30,22,19,28,47
2019,7,30,23,15,19,34
2019,7,31,0,9,5,14
2019,7,31,1,9,9,18
2019,7,31,2,9,7,16
2019,7,31,3,14,8,22
2019,7,31,4,73,31,104
2019,7,31,5,163,96,259
2019,7,31,6,206,113,319
2019,7,31,7,172,117,289
2019,7,31,8,204,117,321
2019,7,31,9,161,130,291
2019,7,31,10,213,178,391
2019,7,31,11,181,183,364
2019,7,31,12,221,212,433
2019,7,31,13,212,261,473
2019,7,31,14,190,227,417
2019,7,31,15,145,166,311
2019,7,31,16,133,151,284
2019,7,31,17,133,127,260
2019,7,31,18,97,101,198
2019,7,31,19,72,104,176
2019,7,31,20,49,55,104
2019,7,31,21,33,47,80
2019,7,31,22,12,33,45
2019,7,31,23,14,13,27
2019,8,1,0,16,13,29
2019,8,1,1,8,12,20
2019,8,1,2,6,5,11
2019,8,1,3,13,8,21
2019,8,1,4,59,38,97
2019,8,1,5,129,74,203
2019,8,1,6,185,101,286
2019,8,1,7,171,108,279
2019,8,1,8,194,142,336
2019,8,1,9,210,161,371
2019,8,1,10,199,173,372
2019,8,1,11,206,182,388
2019,8,1,12,177,193,370
2019,8,1,13,202,232,434
2019,8,1,14,190,230,420
2019,8,1,15,136,161,297
2019,8,1,16,138,133,271
2019,8,1,17,124,137,261
2019,8,1,18,96,104,200
2019,8,1,19,68,109,177
2019,8,1,20,64,222,286
2019,8,1,21,31,192,223
2019,8,1,22,22,75,97
2019,8,1,23,16,50,66
2019,8,2,0,13,38,51
2019,8,2,1,15,48,63
2019,8,2,2,19,32,51
2019,8,2,3,17,11,28
2019,8,2,4,63,35,98
2019,8,2,5,120,92,212
2019,8,2,6,186,101,287
2019,8,2,7,143,101,244
2019,8,2,8,160,130,290
2019,8,2,9,171,123,294
2019,8,2,10,169,133,302
2019,8,2,11,178,183,361
2019,8,2,12,184,205,389
2019,8,2,13,213,228,441
2019,8,2,14,166,206,372
2019,8,2,15,119,136,255
2019,8,2,16,117,126,243
2019,8,2,17,115,98,213
2019,8,2,18,95,88,183
2019,8,2,19,80,108,188
2019,8,2,20,59,75,134
2019,8,2,21,45,50,95
2019,8,2,22,30,41,71
2019,8,2,23,18,28,46
2019,8,3,0,5,14,19
2019,8,3,1,10,14,24
2019,8,3,2,5,18,23
2019,8,3,3,11,7,18
2019,8,3,4,23,17,40
2019,8,3,5,27,17,44
2019,8,3,6,29,26,55
2019,8,3,7,53,45,98
2019,8,3,8,71,54,125
2019,8,3,9,95,82,177
2019,8,3,10,112,109,221
2019,8,3,11,119,103,222
2019,8,3,12,113,119,232
2019,8,3,13,132,132,264
2019,8,3,14,107,118,225
2019,8,3,15,100,119,219
2019,8,3,16,96,104,200
2019,8,3,17,74,92,166
2019,8,3,18,75,73,148
2019,8,3,19,72,73,145
2019,8,3,20,52,69,121
2019,8,3,21,34,51,85
2019,8,3,22,27,42,69
2019,8,3,23,11,24,35
2019,8,4,0,13,15,28
2019,8,4,1,20,30,50
2019,8,4,2,19,15,34
2019,8,4,3,10,11,21
2019,8,4,4,23,15,38
2019,8,4,5,12,21,33
2019,8,4,6,34,15,49
2019,8,4,7,34,28,62
2019,8,4,8,75,48,123
2019,8,4,9,73,52,125
2019,8,4,10,120,109,229
2019,8,4,11,135,123,258
2019,8,4,12,137,123,260
2019,8,4,13,131,155,286
2019,8,4,14,102,142,244
2019,8,4,15,122,107,229
2019,8,4,16,131,125,256
2019,8,4,17,132,130,262
2019,8,4,18,115,136,251
2019,8,4,19,93,110,203
2019,8,4,20,53,74,127
2019,8,4,21,30,59,89
2019,8,4,22,19,36,55
2019,8,4,23,13,15,28
2019,8,5,0,10,8,18
2019,8,5,1,3,8,11
2019,8,5,2,7,5,12
2019,8,5,3,17,15,32
2019,8,5,4,76,43,119
2019,8,5,5,181,152,333
2019,8,5,6,271,139,410
2019,8,5,7,207,125,332
2019,8,5,8,184,129,313
2019,8,5,9,194,138,332
2019,8,5,10,199,170,369
2019,8,5,11,194,189,383
2019,8,5,12,204,215,419
2019,8,5,13,201,284,485
2019,8,5,14,163,237,400
2019,8,5,15,152,166,318
2019,8,5,16,138,140,278
2019,8,5,17,111,117,228
2019,8,5,18,125,103,228
2019,8,5,19,86,125,211
2019,8,5,20,56,70,126
2019,8,5,21,27,43,70
2019,8,5,22,17,23,40
2019,8,5,23,17,11,28
2019,8,6,0,6,9,15
2019,8,6,1,11,8,19
2019,8,6,2,8,9,17
2019,8,6,3,12,15,27
2019,8,6,4,79,43,122
2019,8,6,5,178,94,272
2019,8,6,6,287,128,415
2019,8,6,7,208,131,339
2019,8,6,8,166,120,286
2019,8,6,9,193,153,346
2019,8,6,10,201,177,378
2019,8,6,11,191,189,380
2019,8,6,12,204,213,417
2019,8,6,13,237,287,524
2019,8,6,14,184,267,451
2019,8,6,15,138,166,304
2019,8,6,16,158,125,283
2019,8,6,17,125,134,259
2019,8,6,18,96,125,221
2019,8,6,19,90,94,184
2019,8,6,20,58,72,130
2019,8,6,21,27,36,63
2019,8,6,22,18,24,42
2019,8,6,23,17,16,33
2019,8,7,0,4,11,15
2019,8,7,1,6,6,12
2019,8,7,2,4,10,14
2019,8,7,3,14,10,24
2019,8,7,4,75,46,121
2019,8,7,5,166,99,265
2019,8,7,6,295,132,427
2019,8,7,7,204,131,335
2019,8,7,8,191,135,326
2019,8,7,9,209,181,390
2019,8,7,10,201,186,387
2019,8,7,11,204,181,385
2019,8,7,12,220,225,445
2019,8,7,13,223,276,499
2019,8,7,14,215,233,448
2019,8,7,15,159,182,341
2019,8,7,16,130,122,252
2019,8,7,17,129,131,260
2019,8,7,18,88,121,209
2019,8,7,19,84,115,199
2019,8,7,20,74,102,176
2019,8,7,21,39,46,85
2019,8,7,22,21,34,55
2019,8,7,23,17,16,33
2019,8,8,0,6,12,18
2019,8,8,1,8,17,25
2019,8,8,2,11,10,21
2019,8,8,3,13,11,24
2019,8,8,4,74,41,115
2019,8,8,5,197,100,297
2019,8,8,6,257,143,400
2019,8,8,7,213,131,344
2019,8,8,8,190,134,324
2019,8,8,9,231,171,402
2019,8,8,10,219,173,392
2019,8,8,11,211,188,399
2019,8,8,12,218,215,433
2019,8,8,13,244,317,561
2019,8,8,14,200,273,473
2019,8,8,15,152,183,335
2019,8,8,16,167,153,320
2019,8,8,17,128,139,267
2019,8,8,18,113,109,222
2019,8,8,19,77,93,170
2019,8,8,20,59,267,326
2019,8,8,21,36,171,207
2019,8,8,22,22,37,59
2019,8,8,23,19,16,35
2019,8,9,0,25,16,41
2019,8,9,1,20,13,33
2019,8,9,2,18,6,24
2019,8,9,3,15,9,24
2019,8,9,4,69,38,107
2019,8,9,5,183,82,265
2019,8,9,6,293,132,425
2019,8,9,7,215,146,361
2019,8,9,8,224,164,388
2019,8,9,9,232,171,403
2019,8,9,10,207,183,390
2019,8,9,11,214,215,429
2019,8,9,12,243,257,500
2019,8,9,13,288,293,581
2019,8,9,14,188,250,438
2019,8,9,15,158,191,349
2019,8,9,16,144,139,283
2019,8,9,17,137,122,259
2019,8,9,18,103,100,203
2019,8,9,19,90,89,179
2019,8,9,20,71,95,166
2019,8,9,21,41,66,107
2019,8,9,22,28,39,67
2019,8,9,23,15,19,34
2019,8,10,0,8,21,29
2019,8,10,1,12,18,30
2019,8,10,2,8,10,18
2019,8,10,3,9,7,16
2019,8,10,4,20,13,33
2019,8,10,5,32,26,58
2019,8,10,6,42,25,67
2019,8,10,7,82,49,131
2019,8,10,8,120,91,211
2019,8,10,9,126,122,248
2019,8,10,10,162,134,296
2019,8,10,11,157,125,282
2019,8,10,12,195,154,349
2019,8,10,13,179,182,361
2019,8,10,14,139,184,323
2019,8,10,15,135,149,284
2019,8,10,16,140,162,302
2019,8,10,17,109,135,244
2019,8,10,18,105,106,211
2019,8,10,19,80,78,158
2019,8,10,20,75,86,161
2019,8,10,21,54,54,108
2019,8,10,22,43,58,101
2019,8,10,23,18,25,43
2019,8,11,0,27,20,47
2019,8,11,1,18,30,48
2019,8,11,2,12,18,30
2019,8,11,3,20,8,28
2019,8,11,4,11,8,19
2019,8,11,5,23,13,36
2019,8,11,6,32,12,44
2019,8,11,7,48,49,97
2019,8,11,8,115,54,169
2019,8,11,9,165,94,259
2019,8,11,10,145,130,275
2019,8,11,11,170,158,328
2019,8,11,12,168,165,333
2019,8,11,13,153,173,326
2019,8,11,14,142,199,341
2019,8,11,15,164,164,328
2019,8,11,16,134,137,271
2019,8,11,17,137,149,286
2019,8,11,18,123,137,260
2019,8,11,19,100,105,205
2019,8,11,20,67,89,156
2019,8,11,21,43,70,113
2019,8,11,22,31,57,88
2019,8,11,23,5,14,19
2019,8,12,0,12,10,22
2019,8,12,1,2,6,8
2019,8,12,2,4,5,9
2019,8,12,3,18,10,28
2019,8,12,4,107,48,155
2019,8,12,5,219,140,359
2019,8,12,6,400,173,573
2019,8,12,7,270,179,449
2019,8,12,8,219,147,366
2019,8,12,9,212,162,374
2019,8,12,10,186,194,380
2019,8,12,11,212,200,412
2019,8,12,12,234,259,493
2019,8,12,13,253,348,601
2019,8,12,14,250,311,561
2019,8,12,15,166,183,349
2019,8,12,16,155,155,310
2019,8,12,17,129,126,255
2019,8,12,18,110,123,233
2019,8,12,19,71,92,163
2019,8,12,20,59,64,123
2019,8,12,21,39,49,88
2019,8,12,22,30,34,64
2019,8,12,23,17,24,41
2019,8,13,0,11,11,22
2019,8,13,1,5,13,18
2019,8,13,2,4,6,10
2019,8,13,3,17,10,27
2019,8,13,4,99,48,147
2019,8,13,5,228,132,360
2019,8,13,6,330,139,469
2019,8,13,7,271,169,440
2019,8,13,8,241,183,424
2019,8,13,9,220,200,420
2019,8,13,10,200,195,395
2019,8,13,11,243,209,452
2019,8,13,12,209,231,440
2019,8,13,13,255,349,604
2019,8,13,14,224,300,524
2019,8,13,15,171,206,377
2019,8,13,16,179,141,320
2019,8,13,17,157,142,299
2019,8,13,18,107,120,227
2019,8,13,19,100,120,220
2019,8,13,20,53,103,156
2019,8,13,21,36,50,86
2019,8,13,22,17,41,58
2019,8,13,23,19,20,39
2019,8,14,0,15,18,33
2019,8,14,1,9,13,22
2019,8,14,2,12,10,22
2019,8,14,3,19,13,32
2019,8,14,4,90,44,134
2019,8,14,5,219,111,330
2019,8,14,6,383,175,558
2019,8,14,7,247,176,423
2019,8,14,8,212,146,358
2019,8,14,9,217,176,393
2019,8,14,10,212,208,420
2019,8,14,11,236,210,446
2019,8,14,12,255,266,521
2019,8,14,13,240,334,574
2019,8,14,14,228,299,527
2019,8,14,15,147,231,378
2019,8,14,16,164,168,332
2019,8,14,17,132,149,281
2019,8,14,18,122,124,246
2019,8,14,19,91,124,215
2019,8,14,20,66,352,418
2019,8,14,21,41,240,281
2019,8,14,22,28,161,189
2019,8,14,23,20,100,120
2019,8,15,0,15,49,64
2019,8,15,1,20,29,49
2019,8,15,2,10,15,25
2019,8,15,3,13,7,20
2019,8,15,4,106,50,156
2019,8,15,5,223,103,326
2019,8,15,6,348,181,529
2019,8,15,7,245,142,387
2019,8,15,8,231,163,394
2019,8,15,9,258,201,459
2019,8,15,10,233,224,457
2019,8,15,11,218,211,429
2019,8,15,12,234,257,491
2019,8,15,13,269,333,602
2019,8,15,14,233,279,512
2019,8,15,15,163,201,364
2019,8,15,16,184,181,365
2019,8,15,17,142,141,283
2019,8,15,18,120,141,261
2019,8,15,19,92,115,207
2019,8,15,20,73,89,162
2019,8,15,21,41,70,111
2019,8,15,22,35,44,79
2019,8,15,23,27,26,53
2019,8,16,0,21,17,38
2019,8,16,1,7,13,20
2019,8,16,2,6,9,15
2019,8,16,3,16,10,26
2019,8,16,4,80,44,124
2019,8,16,5,232,119,351
2019,8,16,6,347,175,522
2019,8,16,7,229,153,382
2019,8,16,8,217,166,383
2019,8,16,9,233,183,416
2019,8,16,10,229,222,451
2019,8,16,11,239,236,475
2019,8,16,12,221,256,477
2019,8,16,13,253,312,565
2019,8,16,14,216,251,467
2019,8,16,15,152,184,336
2019,8,16,16,148,139,287
2019,8,16,17,131,124,255
2019,8,16,18,120,93,213
2019,8,16,19,84,103,187
2019,8,16,20,58,76,134
2019,8,16,21,38,54,92
2019,8,16,22,38,59,97
2019,8,16,23,23,34,57
2019,8,17,0,25,34,59
2019,8,17,1,22,30,52
2019,8,17,2,5,15,20
2019,8,17,3,17,9,26
2019,8,17,4,23,13,36
2019,8,17,5,30,27,57
2019,8,17,6,33,33,66
2019,8,17,7,60,50,110
2019,8,17,8,99,77,176
2019,8,17,9,145,108,253
2019,8,17,10,147,125,272
2019,8,17,11,181,151,332
2019,8,17,12,151,153,304
2019,8,17,13,165,191,356
2019,8,17,14,137,155,292
2019,8,17,15,124,141,265
2019,8,17,16,167,163,330
2019,8,17,17,108,125,233
2019,8,17,18,102,101,203
2019,8,17,19,98,92,190
2019,8,17,20,70,75,145
2019,8,17,21,51,67,118
2019,8,17,22,44,57,101
2019,8,17,23,27,34,61
2019,8,18,0,34,38,72
2019,8,18,1,42,37,79
2019,8,18,2,17,22,39
2019,8,18,3,19,13,32
2019,8,18,4,17,8,25
2019,8,18,5,22,20,42
2019,8,18,6,37,11,48
2019,8,18,7,49,48,97
2019,8,18,8,97,59,156
2019,8,18,9,125,83,208
2019,8,18,10,149,137,286
2019,8,18,11,164,193,357
2019,8,18,12,173,195,368
2019,8,18,13,147,184,331
2019,8,18,14,156,232,388
2019,8,18,15,160,169,329
2019,8,18,16,146,151,297
2019,8,18,17,118,127,245
2019,8,18,18,149,138,287
2019,8,18,19,86,133,219
2019,8,18,20,62,77,139
2019,8,18,21,34,42,76
2019,8,18,22,22,25,47
2019,8,18,23,10,11,21
2019,8,19,0,8,11,19
2019,8,19,1,7,8,15
2019,8,19,2,6,11,17
2019,8,19,3,19,7,26
2019,8,19,4,107,41,148
2019,8,19,5,248,161,409
2019,8,19,6,446,202,648
2019,8,19,7,266,165,431
2019,8,19,8,238,152,390
2019,8,19,9,210,182,392
2019,8,19,10,236,192,428
2019,8,19,11,211,210,421
2019,8,19,12,236,270,506
2019,8,19,13,258,362,620
2019,8,19,14,235,344,579
2019,8,19,15,179,178,357
2019,8,19,16,166,144,310
2019,8,19,17,134,121,255
2019,8,19,18,114,135,249
2019,8,19,19,86,116,202
2019,8,19,20,59,67,126
2019,8,19,21,45,44,89
2019,8,19,22,16,18,34
2019,8,19,23,10,13,23
2019,8,20,0,7,7,14
2019,8,20,1,4,9,13
2019,8,20,2,13,8,21
2019,8,20,3,18,10,28
2019,8,20,4,114,41,155
2019,8,20,5,257,138,395
2019,8,20,6,372,177,549
2019,8,20,7,266,162,428
2019,8,20,8,228,172,400
2019,8,20,9,227,180,407
2019,8,20,10,225,183,408
2019,8,20,11,238,210,448
2019,8,20,12,262,267,529
2019,8,20,13,272,325,597
2019,8,20,14,231,310,541
2019,8,20,15,159,200,359
2019,8,20,16,187,150,337
2019,8,20,17,134,146,280
2019,8,20,18,106,125,231
2019,8,20,19,99,148,247
2019,8,20,20,65,61,126
2019,8,20,21,28,43,71
2019,8,20,22,16,22,38
2019,8,20,23,6,8,14
2019,8,21,0,9,5,14
2019,8,21,1,6,10,16
2019,8,21,2,7,11,18
2019,8,21,3,20,7,27
2019,8,21,4,103,47,150
2019,8,21,5,243,158,401
2019,8,21,6,393,209,602
2019,8,21,7,247,155,402
2019,8,21,8,272,149,421
2019,8,21,9,229,173,402
2019,8,21,10,217,184,401
2019,8,21,11,196,202,398
2019,8,21,12,240,271,511
2019,8,21,13,269,342,611
2019,8,21,14,266,276,542
2019,8,21,15,202,194,396
2019,8,21,16,257,139,396
2019,8,21,17,191,180,371
2019,8,21,18,137,243,380
2019,8,21,19,108,121,229
2019,8,21,20,71,92,163
2019,8,21,21,34,61,95
2019,8,21,22,22,31,53
2019,8,21,23,9,9,18
2019,8,22,0,8,12,20
2019,8,22,1,5,13,18
2019,8,22,2,7,6,13
2019,8,22,3,16,10,26
2019,8,22,4,119,52,171
2019,8,22,5,248,130,378
2019,8,22,6,389,208,597
2019,8,22,7,253,165,418
2019,8,22,8,249,140,389
2019,8,22,9,240,176,416
2019,8,22,10,231,195,426
2019,8,22,11,244,222,466
2019,8,22,12,254,276,530
2019,8,22,13,258,319,577
2019,8,22,14,262,289,551
2019,8,22,15,175,197,372
2019,8,22,16,214,158,372
2019,8,22,17,145,168,313
2019,8,22,18,116,215,331
2019,8,22,19,96,126,222
2019,8,22,20,71,76,147
2019,8,22,21,41,52,93
2019,8,22,22,20,26,46
2019,8,22,23,28,23,51
2019,8,23,0,14,64,78
2019,8,23,1,14,46,60
2019,8,23,2,10,41,51
2019,8,23,3,18,4,22
2019,8,23,4,103,43,146
2019,8,23,5,230,127,357
2019,8,23,6,376,208,584
2019,8,23,7,250,139,389
2019,8,23,8,201,166,367
2019,8,23,9,260,171,431
2019,8,23,10,201,190,391
2019,8,23,11,211,205,416
2019,8,23,12,277,254,531
2019,8,23,13,282,354,636
2019,8,23,14,223,278,501
2019,8,23,15,161,199,360
2019,8,23,16,153,166,319
2019,8,23,17,119,116,235
2019,8,23,18,112,100,212
2019,8,23,19,80,92,172
2019,8,23,20,82,79,161
2019,8,23,21,40,57,97
2019,8,23,22,31,36,67
2019,8,23,23,17,29,46
2019,8,24,0,21,27,48
2019,8,24,1,17,37,54
2019,8,24,2,9,10,19
2019,8,24,3,13,8,21
2019,8,24,4,24,12,36
2019,8,24,5,23,28,51
2019,8,24,6,47,36,83
2019,8,24,7,54,53,107
2019,8,24,8,101,72,173
2019,8,24,9,137,103,240
2019,8,24,10,148,130,278
2019,8,24,11,154,152,306
2019,8,24,12,126,147,273
2019,8,24,13,156,174,330
2019,8,24,14,131,161,292
2019,8,24,15,113,132,245
2019,8,24,16,117,119,236
2019,8,24,17,97,105,202
2019,8,24,18,75,83,158
2019,8,24,19,63,76,139
2019,8,24,20,42,68,110
2019,8,24,21,57,67,124
2019,8,24,22,41,50,91
2019,8,24,23,31,34,65
2019,8,25,0,19,30,49
2019,8,25,1,25,29,54
2019,8,25,2,15,28,43
2019,8,25,3,15,8,23
2019,8,25,4,17,14,31
2019,8,25,5,19,20,39
2019,8,25,6,25,19,44
2019,8,25,7,81,44,125
2019,8,25,8,241,63,304
2019,8,25,9,218,110,328
2019,8,25,10,171,191,362
2019,8,25,11,153,257,410
2019,8,25,12,151,254,405
2019,8,25,13,158,199,357
2019,8,25,14,155,198,353
2019,8,25,15,158,201,359
2019,8,25,16,180,191,371
2019,8,25,17,149,157,306
2019,8,25,18,178,158,336
2019,8,25,19,92,129,221
2019,8,25,20,75,91,166
2019,8,25,21,27,40,67
2019,8,25,22,24,31,55
2019,8,25,23,18,17,35
2019,8,26,0,11,5,16
2019,8,26,1,2,9,11
2019,8,26,2,8,6,14
2019,8,26,3,25,10,35
2019,8,26,4,123,54,177
2019,8,26,5,254,142,396
2019,8,26,6,364,212,576
2019,8,26,7,265,167,432
2019,8,26,8,201,157,358
2019,8,26,9,222,171,393
2019,8,26,10,238,201,439
2019,8,26,11,211,219,430
2019,8,26,12,272,257,529
2019,8,26,13,258,338,596
2019,8,26,14,241,366,607
2019,8,26,15,179,255,434
2019,8,26,16,142,163,305
2019,8,26,17,131,142,273
2019,8,26,18,134,142,276
2019,8,26,19,114,137,251
2019,8,26,20,48,101,149
2019,8,26,21,34,58,92
2019,8,26,22,15,15,30
2019,8,26,23,9,9,18
2019,8,27,0,13,6,19
2019,8,27,1,9,8,17
2019,8,27,2,6,7,13
2019,8,27,3,27,11,38
2019,8,27,4,103,61,164
2019,8,27,5,255,120,375
2019,8,27,6,392,194,586
2019,8,27,7,250,160,410
2019,8,27,8,249,154,403
2019,8,27,9,245,209,454
2019,8,27,10,227,200,427
2019,8,27,11,236,222,458
2019,8,27,12,248,253,501
2019,8,27,13,255,349,604
2019,8,27,14,194,271,465
2019,8,27,15,171,185,356
2019,8,27,16,197,148,345
2019,8,27,17,153,184,337
2019,8,27,18,125,141,266
2019,8,27,19,95,132,227
2019,8,27,20,88,102,190
2019,8,27,21,53,58,111
2019,8,27,22,23,28,51
2019,8,27,23,8,5,13
2019,8,28,0,14,10,24
2019,8,28,1,4,8,12
2019,8,28,2,8,4,12
2019,8,28,3,17,11,28
2019,8,28,4,104,50,154
2019,8,28,5,238,137,375
2019,8,28,6,417,210,627
2019,8,28,7,290,158,448
2019,8,28,8,205,192,397
2019,8,28,9,245,174,419
2019,8,28,10,236,236,472
2019,8,28,11,235,213,448
2019,8,28,12,235,274,509
2019,8,28,13,271,322,593
2019,8,28,14,244,289,533
2019,8,28,15,206,208,414
2019,8,28,16,171,153,324
2019,8,28,17,140,156,296
2019,8,28,18,118,101,219
2019,8,28,19,93,118,211
2019,8,28,20,72,138,210
2019,8,28,21,23,94,117
2019,8,28,22,17,33,50
2019,8,28,23,10,16,26
2019,8,29,0,12,11,23
2019,8,29,1,4,7,11
2019,8,29,2,8,10,18
2019,8,29,3,22,7,29
2019,8,29,4,131,53,184
2019,8,29,5,258,139,397
2019,8,29,6,407,186,593
2019,8,29,7,278,167,445
2019,8,29,8,218,182,400
2019,8,29,9,196,183,379
2019,8,29,10,235,190,425
2019,8,29,11,229,196,425
2019,8,29,12,248,259,507
2019,8,29,13,271,328,599
2019,8,29,14,234,315,549
2019,8,29,15,166,208,374
2019,8,29,16,194,171,365
2019,8,29,17,159,140,299
2019,8,29,18,137,150,287
2019,8,29,19,92,102,194
2019,8,29,20,90,101,191
2019,8,29,21,40,66,106
2019,8,29,22,28,31,59
2019,8,29,23,8,20,28
2019,8,30,0,10,16,26
2019,8,30,1,18,16,34
2019,8,30,2,13,11,24
2019,8,30,3,24,16,40
2019,8,30,4,102,52,154
2019,8,30,5,249,133,382
2019,8,30,6,436,194,630
2019,8,30,7,258,169,427
2019,8,30,8,207,177,384
2019,8,30,9,229,167,396
2019,8,30,10,226,209,435
2019,8,30,11,238,212,450
2019,8,30,12,269,276,545
2019,8,30,13,311,365,676
2019,8,30,14,197,291,488
2019,8,30,15,154,177,331
2019,8,30,16,130,116,246
2019,8,30,17,117,126,243
2019,8,30,18,120,112,232
2019,8,30,19,92,92,184
2019,8,30,20,64,78,142
2019,8,30,21,48,75,123
2019,8,30,22,34,48,82
2019,8,30,23,24,22,46
2019,8,31,0,31,34,65
2019,8,31,1,16,31,47
2019,8,31,2,10,11,21
2019,8,31,3,8,6,14
2019,8,31,4,19,18,37
2019,8,31,5,25,25,50
2019,8,31,6,40,33,73
2019,8,31,7,82,44,126
2019,8,31,8,131,87,218
2019,8,31,9,162,100,262
2019,8,31,10,211,137,348
2019,8,31,11,177,156,333
2019,8,31,12,166,198,364
2019,8,31,13,160,207,367
2019,8,31,14,146,201,347
2019,8,31,15,145,144,289
2019,8,31,16,161,157,318
2019,8,31,17,93,113,206
2019,8,31,18,87,94,181
2019,8,31,19,76,92,168
2019,8,31,20,62,65,127
2019,8,31,21,61,85,146
2019,8,31,22,48,57,105
2019,8,31,23,27,33,60
2019,9,1,0,34,38,72
2019,9,1,1,26,41,67
2019,9,1,2,16,26,42
2019,9,1,3,14,12,26
2019,9,1,4,15,12,27
2019,9,1,5,17,10,27
2019,9,1,6,21,23,44
2019,9,1,7,44,37,81
2019,9,1,8,99,71,170
2019,9,1,9,134,77,211
2019,9,1,10,159,158,317
2019,9,1,11,149,156,305
2019,9,1,12,186,168,354
2019,9,1,13,158,227,385
2019,9,1,14,157,204,361
2019,9,1,15,146,136,282
2019,9,1,16,122,129,251
2019,9,1,17,142,147,289
2019,9,1,18,123,151,274
2019,9,1,19,84,113,197
2019,9,1,20,58,61,119
2019,9,1,21,26,30,56
2019,9,1,22,14,20,34
2019,9,1,23,9,10,19
2019,9,2,0,4,3,7
2019,9,2,1,5,9,14
2019,9,2,2,6,8,14
2019,9,2,3,26,8,34
2019,9,2,4,122,42,164
2019,9,2,5,245,147,392
2019,9,2,6,383,198,581
2019,9,2,7,258,194,452
2019,9,2,8,229,154,383
2019,9,2,9,208,191,399
2019,9,2,10,225,178,403
2019,9,2,11,203,200,403
2019,9,2,12,254,242,496
2019,9,2,13,285,346,631
2019,9,2,14,242,294,536
2019,9,2,15,194,203,397
2019,9,2,16,193,149,342
2019,9,2,17,157,121,278
2019,9,2,18,113,132,245
2019,9,2,19,68,121,189
2019,9,2,20,64,96,160
2019,9,2,21,22,44,66
2019,9,2,22,14,16,30
2019,9,2,23,7,8,15
2019,9,3,0,3,10,13
2019,9,3,1,7,9,16
2019,9,3,2,7,5,12
2019,9,3,3,20,6,26
2019,9,3,4,118,55,173
2019,9,3,5,254,156,410
2019,9,3,6,381,217,598
2019,9,3,7,243,155,398
2019,9,3,8,232,170,402
2019,9,3,9,179,147,326
2019,9,3,10,197,173,370
2019,9,3,11,223,206,429
2019,9,3,12,219,228,447
2019,9,3,13,252,327,579
2019,9,3,14,238,300,538
2019,9,3,15,198,209,407
2019,9,3,16,182,146,328
2019,9,3,17,143,148,291
2019,9,3,18,148,134,282
2019,9,3,19,75,114,189
2019,9,3,20,44,77,121
2019,9,3,21,26,38,64
2019,9,3,22,16,20,36
2019,9,3,23,10,10,20
2019,9,4,0,5,11,16
2019,9,4,1,6,5,11
2019,9,4,2,9,5,14
2019,9,4,3,25,10,35
2019,9,4,4,120,39,159
2019,9,4,5,272,164,436
2019,9,4,6,387,199,586
2019,9,4,7,233,144,377
2019,9,4,8,206,161,367
2019,9,4,9,241,153,394
2019,9,4,10,279,214,493
2019,9,4,11,218,201,419
2019,9,4,12,237,239,476
2019,9,4,13,245,333,578
2019,9,4,14,264,286,550
2019,9,4,15,184,210,394
2019,9,4,16,206,149,355
2019,9,4,17,141,161,302
2019,9,4,18,111,139,250
2019,9,4,19,100,115,215
2019,9,4,20,44,56,100
2019,9,4,21,25,37,62
2019,9,4,22,15,22,37
2019,9,4,23,11,14,25
2019,9,5,0,10,15,25
2019,9,5,1,18,9,27
2019,9,5,2,11,9,20
2019,9,5,3,16,8,24
2019,9,5,4,121,49,170
2019,9,5,5,234,124,358
2019,9,5,6,413,208,621
2019,9,5,7,228,147,375
2019,9,5,8,238,168,406
2019,9,5,9,206,157,363
2019,9,5,10,224,182,406
2019,9,5,11,197,210,407
2019,9,5,12,243,250,493
2019,9,5,13,258,316,574
2019,9,5,14,226,302,528
2019,9,5,15,205,183,388
2019,9,5,16,192,167,359
2019,9,5,17,149,146,295
2019,9,5,18,109,126,235
2019,9,5,19,98,111,209
2019,9,5,20,60,74,134
2019,9,5,21,36,42,78
2019,9,5,22,15,16,31
2019,9,5,23,9,37,46
2019,9,6,0,9,39,48
2019,9,6,1,5,33,38
2019,9,6,2,10,7,17
2019,9,6,3,20,7,27
2019,9,6,4,126,50,176
2019,9,6,5,249,121,370
2019,9,6,6,419,176,595
2019,9,6,7,300,207,507
2019,9,6,8,333,433,766
2019,9,6,9,228,328,556
2019,9,6,10,235,216,451
2019,9,6,11,251,213,464
2019,9,6,12,255,272,527
2019,9,6,13,271,334,605
2019,9,6,14,203,260,463
2019,9,6,15,143,166,309
2019,9,6,16,159,162,321
2019,9,6,17,136,134,270
2019,9,6,18,103,108,211
2019,9,6,19,75,99,174
2019,9,6,20,54,70,124
2019,9,6,21,42,187,229
2019,9,6,22,25,45,70
2019,9,6,23,17,26,43
2019,9,7,0,25,30,55
2019,9,7,1,23,19,42
2019,9,7,2,9,18,27
2019,9,7,3,10,6,16
2019,9,7,4,15,15,30
2019,9,7,5,20,19,39
2019,9,7,6,34,28,62
2019,9,7,7,72,50,122
2019,9,7,8,96,70,166
2019,9,7,9,129,87,216
2019,9,7,10,122,135,257
2019,9,7,11,161,152,313
2019,9,7,12,152,154,306
2019,9,7,13,154,176,330
2019,9,7,14,122,145,267
2019,9,7,15,132,167,299
2019,9,7,16,117,133,250
2019,9,7,17,114,114,228
2019,9,7,18,90,86,176
2019,9,7,19,58,82,140
2019,9,7,20,55,61,116
2019,9,7,21,50,58,108
2019,9,7,22,36,48,84
2019,9,7,23,25,42,67
2019,9,8,0,26,28,54
2019,9,8,1,29,26,55
2019,9,8,2,12,22,34
2019,9,8,3,7,12,19
2019,9,8,4,19,10,29
2019,9,8,5,22,12,34
2019,9,8,6,33,17,50
2019,9,8,7,42,35,77
2019,9,8,8,94,52,146
2019,9,8,9,94,93,187
2019,9,8,10,131,140,271
2019,9,8,11,141,136,277
2019,9,8,12,172,178,350
2019,9,8,13,161,171,332
2019,9,8,14,128,171,299
2019,9,8,15,156,176,332
2019,9,8,16,156,133,289
2019,9,8,17,158,148,306
2019,9,8,18,130,153,283
2019,9,8,19,79,103,182
2019,9,8,20,50,73,123
2019,9,8,21,44,64,108
2019,9,8,22,20,20,40
2019,9,8,23,14,14,28
2019,9,9,0,7,5,12
2019,9,9,1,8,7,15
2019,9,9,2,6,7,13
2019,9,9,3,18,11,29
2019,9,9,4,112,60,172
2019,9,9,5,262,126,388
2019,9,9,6,318,176,494
2019,9,9,7,230,156,386
2019,9,9,8,226,188,414
2019,9,9,9,207,172,379
2019,9,9,10,233,168,401
2019,9,9,11,198,205,403
2019,9,9,12,210,241,451
2019,9,9,13,296,292,588
2019,9,9,14,226,286,512
2019,9,9,15,186,184,370
2019,9,9,16,161,139,300
2019,9,9,17,159,150,309
2019,9,9,18,100,102,202
2019,9,9,19,86,102,188
2019,9,9,20,50,69,119
2019,9,9,21,30,34,64
2019,9,9,22,11,18,29
2019,9,9,23,8,7,15
2019,9,10,0,6,8,14
2019,9,10,1,4,6,10
2019,9,10,2,5,7,12
2019,9,10,3,18,7,25
2019,9,10,4,118,49,167
2019,9,10,5,279,124,403
2019,9,10,6,406,203,609
2019,9,10,7,256,179,435
2019,9,10,8,212,154,366
2019,9,10,9,216,160,376
2019,9,10,10,198,195,393
2019,9,10,11,216,203,419
2019,9,10,12,210,248,458
2019,9,10,13,263,349,612
2019,9,10,14,219,308,527
2019,9,10,15,193,194,387
2019,9,10,16,175,153,328
2019,9,10,17,148,145,293
2019,9,10,18,111,141,252
2019,9,10,19,88,124,212
2019,9,10,20,61,77,138
2019,9,10,21,27,28,55
2019,9,10,22,17,14,31
2019,9,10,23,10,10,20
2019,9,11,0,9,6,15
2019,9,11,1,5,6,11
2019,9,11,2,19,9,28
2019,9,11,3,20,9,29
2019,9,11,4,96,54,150
2019,9,11,5,253,133,386
2019,9,11,6,385,203,588
2019,9,11,7,288,167,455
2019,9,11,8,237,171,408
2019,9,11,9,197,173,370
2019,9,11,10,218,200,418
2019,9,11,11,202,185,387
2019,9,11,12,251,251,502
2019,9,11,13,245,310,555
2019,9,11,14,213,300,513
2019,9,11,15,171,181,352
2019,9,11,16,177,176,353
2019,9,11,17,132,166,298
2019,9,11,18,119,126,245
2019,9,11,19,86,106,192
2019,9,11,20,44,70,114
2019,9,11,21,6,39,45
2019,9,11,22,8,24,32
2019,9,11,23,1,17,18
2019,9,12,0,2,13,15
2019,9,12,1,3,15,18
2019,9,12,2,5,17,22
2019,9,12,3,13,14,27
2019,9,12,4,115,63,178
2019,9,12,5,231,124,355
2019,9,12,6,385,204,589
2019,9,12,7,259,170,429
2019,9,12,8,228,173,401
2019,9,12,9,232,196,428
2019,9,12,10,228,199,427
2019,9,12,11,219,203,422
2019,9,12,12,236,237,473
2019,9,12,13,272,324,596
2019,9,12,14,247,318,565
2019,9,12,15,175,188,363
2019,9,12,16,156,188,344
2019,9,12,17,120,144,264
2019,9,12,18,103,138,241
2019,9,12,19,92,112,204
2019,9,12,20,66,75,141
2019,9,12,21,28,42,70
2019,9,12,22,15,28,43
2019,9,12,23,12,17,29
2019,9,13,0,10,17,27
2019,9,13,1,4,6,10
2019,9,13,2,5,6,11
2019,9,13,3,20,12,32
2019,9,13,4,94,48,142
2019,9,13,5,260,141,401
2019,9,13,6,376,187,563
2019,9,13,7,240,150,390
2019,9,13,8,221,210,431
2019,9,13,9,234,164,398
2019,9,13,10,200,215,415
2019,9,13,11,239,197,436
2019,9,13,12,238,270,508
2019,9,13,13,281,302,583
2019,9,13,14,198,246,444
2019,9,13,15,164,179,343
2019,9,13,16,169,154,323
2019,9,13,17,124,130,254
2019,9,13,18,89,110,199
2019,9,13,19,74,78,152
2019,9,13,20,59,67,126
2019,9,13,21,41,60,101
2019,9,13,22,31,48,79
2019,9,13,23,17,29,46
2019,9,14,0,18,27,45
2019,9,14,1,13,21,34
2019,9,14,2,9,15,24
2019,9,14,3,7,11,18
2019,9,14,4,21,14,35
2019,9,14,5,23,22,45
2019,9,14,6,41,34,75
2019,9,14,7,72,48,120
2019,9,14,8,110,70,180
2019,9,14,9,134,87,221
2019,9,14,10,155,149,304
2019,9,14,11,162,144,306
2019,9,14,12,163,191,354
2019,9,14,13,170,186,356
2019,9,14,14,163,145,308
2019,9,14,15,138,121,259
2019,9,14,16,131,150,281
2019,9,14,17,107,110,217
2019,9,14,18,98,100,198
2019,9,14,19,76,65,141
2019,9,14,20,56,60,116
2019,9,14,21,42,63,105
2019,9,14,22,37,42,79
2019,9,14,23,26,28,54
2019,9,15,0,19,25,44
2019,9,15,1,22,34,56
2019,9,15,2,19,22,41
2019,9,15,3,9,15,24
2019,9,15,4,17,9,26
2019,9,15,5,16,22,38
2019,9,15,6,38,21,59
2019,9,15,7,58,25,83
2019,9,15,8,115,76,191
2019,9,15,9,140,75,215
2019,9,15,10,168,150,318
2019,9,15,11,153,177,330
2019,9,15,12,159,197,356
2019,9,15,13,137,196,333
2019,9,15,14,135,191,326
2019,9,15,15,153,172,325
2019,9,15,16,168,137,305
2019,9,15,17,167,153,320
2019,9,15,18,120,138,258
2019,9,15,19,77,146,223
2019,9,15,20,61,76,137
2019,9,15,21,29,37,66
2019,9,15,22,20,21,41
2019,9,15,23,13,12,25
2019,9,16,0,4,5,9
2019,9,16,1,5,7,12
2019,9,16,2,7,5,12
2019,9,16,3,26,11,37
2019,9,16,4,123,60,183
2019,9,16,5,243,151,394
2019,9,16,6,382,227,609
2019,9,16,7,256,123,379
2019,9,16,8,224,163,387
2019,9,16,9,206,154,360
2019,9,16,10,169,188,357
2019,9,16,11,217,183,400
2019,9,16,12,239,258,497
2019,9,16,13,219,289,508
2019,9,16,14,248,261,509
2019,9,16,15,226,194,420
2019,9,16,16,165,155,320
2019,9,16,17,139,145,284
2019,9,16,18,121,102,223
2019,9,16,19,82,108,190
2019,9,16,20,57,79,136
2019,9,16,21,25,48,73
2019,9,16,22,20,22,42
2019,9,16,23,7,7,14
2019,9,17,0,4,5,9
2019,9,17,1,5,26,31
2019,9,17,2,9,6,15
2019,9,17,3,20,13,33
2019,9,17,4,113,54,167
2019,9,17,5,239,141,380
2019,9,17,6,386,206,592
2019,9,17,7,246,168,414
2019,9,17,8,227,146,373
2019,9,17,9,226,161,387
2019,9,17,10,224,203,427
2019,9,17,11,227,193,420
2019,9,17,12,233,265,498
2019,9,17,13,265,302,567
2019,9,17,14,255,304,559
2019,9,17,15,197,188,385
2019,9,17,16,175,177,352
2019,9,17,17,147,155,302
2019,9,17,18,118,129,247
2019,9,17,19,76,116,192
2019,9,17,20,35,65,100
2019,9,17,21,29,46,75
2019,9,17,22,13,29,42
2019,9,17,23,6,13,19
2019,9,18,0,6,7,13
2019,9,18,1,8,7,15
2019,9,18,2,6,6,12
2019,9,18,3,20,10,30
2019,9,18,4,107,49,156
2019,9,18,5,260,154,414
2019,9,18,6,436,196,632
2019,9,18,7,268,147,415
2019,9,18,8,190,166,356
2019,9,18,9,205,144,349
2019,9,18,10,209,188,397
2019,9,18,11,216,188,404
2019,9,18,12,208,252,460
2019,9,18,13,266,326,592
2019,9,18,14,241,270,511
2019,9,18,15,185,209,394
2019,9,18,16,152,151,303
2019,9,18,17,143,150,293
2019,9,18,18,110,117,227
2019,9,18,19,106,110,216
2019,9,18,20,52,60,112
2019,9,18,21,19,36,55
2019,9,18,22,14,23,37
2019,9,18,23,11,18,29
2019,9,19,0,8,14,22
2019,9,19,1,5,4,9
2019,9,19,2,9,6,15
2019,9,19,3,15,14,29
2019,9,19,4,104,42,146
2019,9,19,5,270,124,394
2019,9,19,6,387,205,592
2019,9,19,7,237,137,374
2019,9,19,8,233,176,409
2019,9,19,9,235,183,418
2019,9,19,10,201,184,385
2019,9,19,11,219,208,427
2019,9,19,12,254,228,482
2019,9,19,13,304,332,636
2019,9,19,14,241,302,543
2019,9,19,15,200,193,393
2019,9,19,16,188,155,343
2019,9,19,17,135,119,254
2019,9,19,18,115,143,258
2019,9,19,19,83,109,192
2019,9,19,20,58,95,153
2019,9,19,21,30,62,92
2019,9,19,22,8,26,34
2019,9,19,23,11,16,27
2019,9,20,0,17,9,26
2019,9,20,1,13,11,24
2019,9,20,2,9,11,20
2019,9,20,3,23,11,34
2019,9,20,4,94,47,141
2019,9,20,5,281,155,436
2019,9,20,6,402,223,625
2019,9,20,7,255,134,389
2019,9,20,8,209,173,382
2019,9,20,9,213,162,375
2019,9,20,10,237,202,439
2019,9,20,11,229,212,441
2019,9,20,12,262,257,519
2019,9,20,13,264,306,570
2019,9,20,14,179,251,430
2019,9,20,15,174,167,341
2019,9,20,16,137,187,324
2019,9,20,17,103,125,228
2019,9,20,18,135,119,254
2019,9,20,19,100,100,200
2019,9,20,20,58,66,124
2019,9,20,21,34,43,77
2019,9,20,22,28,41,69
2019,9,20,23,17,37,54
2019,9,21,0,19,22,41
2019,9,21,1,17,26,43
2019,9,21,2,10,17,27
2019,9,21,3,10,10,20
2019,9,21,4,16,14,30
2019,9,21,5,31,15,46
2019,9,21,6,42,28,70
2019,9,21,7,75,46,121
2019,9,21,8,107,73,180
2019,9,21,9,124,83,207
2019,9,21,10,162,130,292
2019,9,21,11,143,121,264
2019,9,21,12,144,160,304
2019,9,21,13,153,148,301
2019,9,21,14,100,163,263
2019,9,21,15,123,180,303
2019,9,21,16,145,133,278
2019,9,21,17,108,115,223
2019,9,21,18,112,92,204
2019,9,21,19,60,85,145
2019,9,21,20,42,57,99
2019,9,21,21,40,44,84
2019,9,21,22,33,49,82
2019,9,21,23,24,39,63
2019,9,22,0,27,34,61
2019,9,22,1,27,29,56
2019,9,22,2,10,23,33
2019,9,22,3,7,7,14
2019,9,22,4,15,12,27
2019,9,22,5,5,13,18
2019,9,22,6,37,15,52
2019,9,22,7,42,35,77
2019,9,22,8,99,60,159
2019,9,22,9,118,69,187
2019,9,22,10,138,158,296
2019,9,22,11,136,157,293
2019,9,22,12,161,162,323
2019,9,22,13,164,167,331
2019,9,22,14,142,194,336
2019,9,22,15,145,147,292
2019,9,22,16,165,148,313
2019,9,22,17,140,156,296
2019,9,22,18,126,149,275
2019,9,22,19,104,116,220
2019,9,22,20,50,75,125
2019,9,22,21,16,30,46
2019,9,22,22,21,17,38
2019,9,22,23,9,10,19
2019,9,23,0,9,5,14
2019,9,23,1,3,9,12
2019,9,23,2,11,3,14
2019,9,23,3,15,7,22
2019,9,23,4,101,55,156
2019,9,23,5,240,121,361
2019,9,23,6,379,196,575
2019,9,23,7,245,154,399
2019,9,23,8,202,131,333
2019,9,23,9,206,166,372
2019,9,23,10,184,185,369
2019,9,23,11,213,179,392
2019,9,23,12,227,233,460
2019,9,23,13,232,327,559
2019,9,23,14,183,299,482
2019,9,23,15,164,169,333
2019,9,23,16,167,161,328
2019,9,23,17,155,141,296
2019,9,23,18,124,123,247
2019,9,23,19,84,92,176
2019,9,23,20,39,175,214
2019,9,23,21,33,123,156
2019,9,23,22,12,60,72
2019,9,23,23,11,32,43
2019,9,24,0,8,16,24
2019,9,24,1,2,17,19
2019,9,24,2,3,23,26
2019,9,24,3,21,6,27
2019,9,24,4,104,51,155
2019,9,24,5,250,123,373
2019,9,24,6,376,189,565
2019,9,24,7,245,179,424
2019,9,24,8,217,165,382
2019,9,24,9,214,153,367
2019,9,24,10,230,179,409
2019,9,24,11,206,213,419
2019,9,24,12,216,260,476
2019,9,24,13,254,288,542
2019,9,24,14,202,287,489
2019,9,24,15,182,190,372
2019,9,24,16,178,201,379
2019,9,24,17,131,132,263
2019,9,24,18,98,137,235
2019,9,24,19,82,98,180
2019,9,24,20,43,78,121
2019,9,24,21,26,26,52
2019,9,24,22,16,16,32
2019,9,24,23,15,11,26
2019,9,25,0,6,7,13
2019,9,25,1,7,7,14
2019,9,25,2,5,8,13
2019,9,25,3,19,13,32
2019,9,25,4,104,42,146
2019,9,25,5,243,141,384
2019,9,25,6,389,186,575
2019,9,25,7,221,138,359
2019,9,25,8,242,138,380
2019,9,25,9,197,158,355
2019,9,25,10,214,215,429
2019,9,25,11,234,188,422
2019,9,25,12,218,235,453
2019,9,25,13,235,302,537
2019,9,25,14,209,255,464
2019,9,25,15,182,203,385
2019,9,25,16,168,153,321
2019,9,25,17,132,132,264
2019,9,25,18,114,116,230
2019,9,25,19,89,96,185
2019,9,25,20,67,76,143
2019,9,25,21,28,39,67
2019,9,25,22,23,24,47
2019,9,25,23,14,15,29
2019,9,26,0,6,5,11
2019,9,26,1,9,13,22
2019,9,26,2,4,4,8
2019,9,26,3,16,11,27
2019,9,26,4,108,58,166
2019,9,26,5,271,138,409
2019,9,26,6,377,187,564
2019,9,26,7,253,145,398
2019,9,26,8,223,158,381
2019,9,26,9,214,174,388
2019,9,26,10,228,194,422
2019,9,26,11,191,181,372
2019,9,26,12,229,274,503
2019,9,26,13,245,295,540
2019,9,26,14,202,271,473
2019,9,26,15,188,180,368
2019,9,26,16,176,156,332
2019,9,26,17,144,148,292
2019,9,26,18,97,139,236
2019,9,26,19,72,105,177
2019,9,26,20,81,72,153
2019,9,26,21,44,35,79
2019,9,26,22,35,25,60
2019,9,26,23,15,12,27
2019,9,27,0,22,19,41
2019,9,27,1,13,17,30
2019,9,27,2,10,6,16
2019,9,27,3,20,13,33
2019,9,27,4,114,46,160
2019,9,27,5,275,150,425
2019,9,27,6,384,175,559
2019,9,27,7,212,150,362
2019,9,27,8,208,160,368
2019,9,27,9,219,184,403
2019,9,27,10,243,211,454
2019,9,27,11,202,219,421
2019,9,27,12,247,292,539
2019,9,27,13,287,338,625
2019,9,27,14,233,301,534
2019,9,27,15,204,186,390
2019,9,27,16,140,156,296
2019,9,27,17,116,151,267
2019,9,27,18,86,93,179
2019,9,27,19,81,100,181
2019,9,27,20,44,76,120
2019,9,27,21,42,61,103
2019,9,27,22,27,39,66
2019,9,27,23,27,32,59
2019,9,28,0,22,25,47
2019,9,28,1,11,22,33
2019,9,28,2,4,13,17
2019,9,28,3,10,9,19
2019,9,28,4,21,9,30
2019,9,28,5,20,22,42
2019,9,28,6,32,24,56
2019,9,28,7,76,60,136
2019,9,28,8,88,67,155
2019,9,28,9,134,102,236
2019,9,28,10,162,127,289
2019,9,28,11,154,147,301
2019,9,28,12,150,152,302
2019,9,28,13,144,164,308
2019,9,28,14,153,164,317
2019,9,28,15,122,149,271
2019,9,28,16,111,147,258
2019,9,28,17,116,163,279
2019,9,28,18,77,96,173
2019,9,28,19,60,56,116
2019,9,28,20,48,46,94
2019,9,28,21,36,61,97
2019,9,28,22,32,53,85
2019,9,28,23,29,46,75
2019,9,29,0,33,30,63
2019,9,29,1,25,22,47
2019,9,29,2,16,18,34
2019,9,29,3,12,7,19
2019,9,29,4,17,12,29
2019,9,29,5,10,12,22
2019,9,29,6,59,14,73
2019,9,29,7,67,33,100
2019,9,29,8,99,67,166
2019,9,29,9,90,109,199
2019,9,29,10,154,138,292
2019,9,29,11,164,165,329
2019,9,29,12,184,200,384
2019,9,29,13,151,189,340
2019,9,29,14,127,205,332
2019,9,29,15,174,175,349
2019,9,29,16,157,152,309
2019,9,29,17,144,151,295
2019,9,29,18,110,117,227
2019,9,29,19,82,101,183
2019,9,29,20,65,77,142
2019,9,29,21,27,44,71
2019,9,29,22,18,18,36
2019,9,29,23,13,7,20
2019,9,30,0,6,8,14
2019,9,30,1,7,9,16
2019,9,30,2,12,7,19
2019,9,30,3,18,10,28
2019,9,30,4,96,53,149
2019,9,30,5,239,138,377
2019,9,30,6,405,199,604
2019,9,30,7,233,145,378
2019,9,30,8,216,161,377
2019,9,30,9,215,149,364
2019,9,30,10,199,193,392
2019,9,30,11,215,180,395
2019,9,30,12,228,229,457
2019,9,30,13,242,302,544
2019,9,30,14,224,302,526
2019,9,30,15,180,197,377
2019,9,30,16,155,153,308
2019,9,30,17,128,142,270
2019,9,30,18,125,107,232
2019,9,30,19,81,98,179
2019,9,30,20,42,292,334
2019,9,30,21,34,180,214
2019,9,30,22,10,55,65
2019,9,30,23,6,36,42
2019,10,1,0,2,30,32
2019,10,1,1,5,35,40
2019,10,1,2,8,24,32
2019,10,1,3,23,10,33
2019,10,1,4,116,51,167
2019,10,1,5,227,161,388
2019,10,1,6,419,205,624
2019,10,1,7,255,152,407
2019,10,1,8,247,172,419
2019,10,1,9,228,155,383
2019,10,1,10,217,214,431
2019,10,1,11,223,208,431
2019,10,1,12,247,234,481
2019,10,1,13,259,313,572
2019,10,1,14,246,313,559
2019,10,1,15,183,184,367
2019,10,1,16,198,171,369
2019,10,1,17,123,155,278
2019,10,1,18,105,144,249
2019,10,1,19,83,119,202
2019,10,1,20,60,70,130
2019,10,1,21,39,37,76
2019,10,1,22,16,24,40
2019,10,1,23,11,11,22
2019,10,2,0,10,8,18
2019,10,2,1,4,12,16
2019,10,2,2,10,3,13
2019,10,2,3,20,18,38
2019,10,2,4,104,61,165
2019,10,2,5,247,155,402
2019,10,2,6,409,189,598
2019,10,2,7,257,168,425
2019,10,2,8,223,138,361
2019,10,2,9,227,195,422
2019,10,2,10,196,178,374
2019,10,2,11,217,212,429
2019,10,2,12,249,236,485
2019,10,2,13,235,320,555
2019,10,2,14,211,264,475
2019,10,2,15,185,168,353
2019,10,2,16,174,138,312
2019,10,2,17,118,150,268
2019,10,2,18,107,113,220
2019,10,2,19,80,121,201
2019,10,2,20,65,58,123
2019,10,2,21,31,41,72
2019,10,2,22,17,27,44
2019,10,2,23,16,11,27
2019,10,3,0,8,14,22
2019,10,3,1,7,10,17
2019,10,3,2,8,6,14
2019,10,3,3,15,13,28
2019,10,3,4,120,60,180
2019,10,3,5,251,128,379
2019,10,3,6,383,204,587
2019,10,3,7,247,148,395
2019,10,3,8,446,187,633
2019,10,3,9,557,246,803
2019,10,3,10,203,197,400
2019,10,3,11,231,187,418
2019,10,3,12,222,254,476
2019,10,3,13,263,300,563
2019,10,3,14,233,284,517
2019,10,3,15,188,156,344
2019,10,3,16,197,186,383
2019,10,3,17,144,151,295
2019,10,3,18,97,126,223
2019,10,3,19,73,112,185
2019,10,3,20,51,379,430
2019,10,3,21,31,221,252
2019,10,3,22,16,69,85
2019,10,3,23,15,19,34
2019,10,4,0,11,10,21
2019,10,4,1,12,21,33
2019,10,4,2,12,11,23
2019,10,4,3,15,9,24
2019,10,4,4,115,51,166
2019,10,4,5,249,130,379
2019,10,4,6,367,184,551
2019,10,4,7,241,155,396
2019,10,4,8,201,165,366
2019,10,4,9,230,157,387
2019,10,4,10,224,210,434
2019,10,4,11,242,226,468
2019,10,4,12,274,277,551
2019,10,4,13,255,304,559
2019,10,4,14,210,265,475
2019,10,4,15,150,184,334
2019,10,4,16,153,138,291
2019,10,4,17,116,108,224
2019,10,4,18,101,104,205
2019,10,4,19,70,69,139
2019,10,4,20,54,68,122
2019,10,4,21,36,56,92
2019,10,4,22,31,33,64
2019,10,4,23,14,22,36
2019,10,5,0,16,22,38
2019,10,5,1,16,25,41
2019,10,5,2,6,12,18
2019,10,5,3,6,8,14
2019,10,5,4,16,10,26
2019,10,5,5,23,20,43
2019,10,5,6,42,24,66
2019,10,5,7,66,57,123
2019,10,5,8,92,59,151
2019,10,5,9,121,83,204
2019,10,5,10,120,125,245
2019,10,5,11,142,137,279
2019,10,5,12,153,166,319
2019,10,5,13,154,189,343
2019,10,5,14,134,141,275
2019,10,5,15,97,125,222
2019,10,5,16,118,101,219
2019,10,5,17,113,100,213
2019,10,5,18,72,80,152
2019,10,5,19,52,51,103
2019,10,5,20,54,53,107
2019,10,5,21,41,54,95
2019,10,5,22,31,40,71
2019,10,5,23,33,32,65
2019,10,6,0,26,28,54
2019,10,6,1,24,33,57
2019,10,6,2,16,22,38
2019,10,6,3,9,6,15
2019,10,6,4,22,11,33
2019,10,6,5,13,18,31
2019,10,6,6,28,16,44
2019,10,6,7,35,31,66
2019,10,6,8,93,50,143
2019,10,6,9,113,92,205
2019,10,6,10,135,113,248
2019,10,6,11,137,151,288
2019,10,6,12,177,168,345
2019,10,6,13,137,155,292
2019,10,6,14,136,182,318
2019,10,6,15,146,154,300
2019,10,6,16,140,125,265
2019,10,6,17,126,143,269
2019,10,6,18,90,93,183
2019,10,6,19,65,76,141
2019,10,6,20,91,70,161
2019,10,6,21,26,34,60
2019,10,6,22,17,21,38
2019,10,6,23,10,9,19
2019,10,7,0,4,2,6
2019,10,7,1,7,9,16
2019,10,7,2,4,4,8
2019,10,7,3,15,8,23
2019,10,7,4,112,49,161
2019,10,7,5,215,120,335
2019,10,7,6,310,146,456
2019,10,7,7,224,153,377
2019,10,7,8,208,162,370
2019,10,7,9,183,164,347
2019,10,7,10,201,206,407
2019,10,7,11,204,184,388
2019,10,7,12,200,227,427
2019,10,7,13,219,269,488
2019,10,7,14,166,262,428
2019,10,7,15,153,171,324
2019,10,7,16,124,137,261
2019,10,7,17,116,107,223
2019,10,7,18,103,100,203
2019,10,7,19,68,83,151
2019,10,7,20,44,57,101
2019,10,7,21,18,40,58
2019,10,7,22,11,15,26
2019,10,7,23,9,7,16
2019,10,8,0,2,4,6
2019,10,8,1,7,5,12
2019,10,8,2,5,6,11
2019,10,8,3,11,5,16
2019,10,8,4,112,39,151
2019,10,8,5,230,131,361
2019,10,8,6,324,160,484
2019,10,8,7,227,152,379
2019,10,8,8,245,138,383
2019,10,8,9,231,168,399
2019,10,8,10,209,181,390
2019,10,8,11,200,181,381
2019,10,8,12,208,222,430
2019,10,8,13,225,271,496
2019,10,8,14,172,264,436
2019,10,8,15,158,184,342
2019,10,8,16,146,129,275
2019,10,8,17,143,114,257
2019,10,8,18,96,106,202
2019,10,8,19,68,111,179
2019,10,8,20,53,81,134
2019,10,8,21,20,33,53
2019,10,8,22,17,16,33
2019,10,8,23,2,9,11
2019,10,9,0,5,6,11
2019,10,9,1,5,6,11
2019,10,9,2,3,5,8
2019,10,9,3,23,11,34
2019,10,9,4,105,43,148
2019,10,9,5,235,106,341
2019,10,9,6,310,160,470
2019,10,9,7,242,145,387
2019,10,9,8,223,151,374
2019,10,9,9,176,166,342
2019,10,9,10,217,193,410
2019,10,9,11,234,195,429
2019,10,9,12,213,203,416
2019,10,9,13,254,280,534
2019,10,9,14,202,279,481
2019,10,9,15,168,188,356
2019,10,9,16,159,144,303
2019,10,9,17,119,109,228
2019,10,9,18,80,102,182
2019,10,9,19,68,87,155
2019,10,9,20,46,59,105
2019,10,9,21,43,38,81
2019,10,9,22,19,8,27
2019,10,9,23,9,11,20
2019,10,10,0,8,10,18
2019,10,10,1,18,9,27
2019,10,10,2,8,4,12
2019,10,10,3,19,10,29
2019,10,10,4,107,37,144
2019,10,10,5,206,129,335
2019,10,10,6,280,135,415
2019,10,10,7,254,136,390
2019,10,10,8,214,155,369
2019,10,10,9,223,142,365
2019,10,10,10,209,162,371
2019,10,10,11,234,204,438
2019,10,10,12,199,240,439
2019,10,10,13,217,294,511
2019,10,10,14,223,257,480
2019,10,10,15,144,192,336
2019,10,10,16,145,129,274
2019,10,10,17,109,114,223
2019,10,10,18,96,100,196
2019,10,10,19,74,87,161
2019,10,10,20,45,277,322
2019,10,10,21,29,236,265
2019,10,10,22,13,77,90
2019,10,10,23,12,36,48
2019,10,11,0,11,34,45
2019,10,11,1,13,27,40
2019,10,11,2,3,36,39
2019,10,11,3,13,35,48
2019,10,11,4,110,39,149
2019,10,11,5,168,111,279
2019,10,11,6,251,116,367
2019,10,11,7,186,133,319
2019,10,11,8,177,135,312
2019,10,11,9,210,160,370
2019,10,11,10,211,168,379
2019,10,11,11,245,211,456
2019,10,11,12,209,220,429
2019,10,11,13,287,266,553
2019,10,11,14,181,265,446
2019,10,11,15,129,158,287
2019,10,11,16,132,168,300
2019,10,11,17,114,113,227
2019,10,11,18,66,76,142
2019,10,11,19,75,68,143
2019,10,11,20,56,65,121
2019,10,11,21,56,47,103
2019,10,11,22,34,40,74
2019,10,11,23,21,22,43
2019,10,12,0,20,25,45
2019,10,12,1,13,28,41
2019,10,12,2,9,23,32
2019,10,12,3,6,5,11
2019,10,12,4,27,15,42
2019,10,12,5,18,25,43
2019,10,12,6,37,27,64
2019,10,12,7,54,33,87
2019,10,12,8,86,54,140
2019,10,12,9,111,76,187
2019,10,12,10,140,131,271
2019,10,12,11,133,139,272
2019,10,12,12,143,141,284
2019,10,12,13,132,162,294
2019,10,12,14,109,163,272
2019,10,12,15,120,163,283
2019,10,12,16,142,114,256
2019,10,12,17,99,106,205
2019,10,12,18,63,87,150
2019,10,12,19,54,62,116
2019,10,12,20,42,58,100
2019,10,12,21,49,61,110
2019,10,12,22,36,43,79
2019,10,12,23,35,39,74
2019,10,13,0,39,34,73
2019,10,13,1,19,25,44
2019,10,13,2,13,19,32
2019,10,13,3,10,14,24
2019,10,13,4,20,13,33
2019,10,13,5,21,20,41
2019,10,13,6,33,11,44
2019,10,13,7,49,33,82
2019,10,13,8,87,56,143
2019,10,13,9,107,66,173
2019,10,13,10,158,125,283
2019,10,13,11,169,156,325
2019,10,13,12,173,224,397
2019,10,13,13,164,218,382
2019,10,13,14,139,189,328
2019,10,13,15,157,154,311
2019,10,13,16,160,157,317
2019,10,13,17,159,145,304
2019,10,13,18,90,136,226
2019,10,13,19,65,99,164
2019,10,13,20,51,62,113
2019,10,13,21,29,33,62
2019,10,13,22,13,22,35
2019,10,13,23,7,7,14
2019,10,14,0,6,9,15
2019,10,14,1,6,7,13
2019,10,14,2,8,9,17
2019,10,14,3,21,8,29
2019,10,14,4,130,53,183
2019,10,14,5,236,129,365
2019,10,14,6,401,173,574
2019,10,14,7,240,131,371
2019,10,14,8,202,142,344
2019,10,14,9,197,147,344
2019,10,14,10,189,154,343
2019,10,14,11,196,191,387
2019,10,14,12,206,225,431
2019,10,14,13,230,293,523
2019,10,14,14,223,276,499
2019,10,14,15,189,196,385
2019,10,14,16,189,131,320
2019,10,14,17,178,130,308
2019,10,14,18,129,159,288
2019,10,14,19,59,143,202
2019,10,14,20,36,113,149
2019,10,14,21,20,95,115
2019,10,14,22,6,30,36
2019,10,14,23,4,32,36
2019,10,15,0,7,8,15
2019,10,15,1,8,16,24
2019,10,15,2,6,23,29
2019,10,15,3,24,35,59
2019,10,15,4,113,100,213
2019,10,15,5,213,158,371
2019,10,15,6,402,175,577
2019,10,15,7,237,173,410
2019,10,15,8,219,149,368
2019,10,15,9,212,180,392
2019,10,15,10,205,175,380
2019,10,15,11,181,188,369
2019,10,15,12,202,240,442
2019,10,15,13,237,323,560
2019,10,15,14,213,286,499
2019,10,15,15,177,181,358
2019,10,15,16,185,140,325
2019,10,15,17,128,143,271
2019,10,15,18,99,114,213
2019,10,15,19,80,97,177
2019,10,15,20,52,145,197
2019,10,15,21,24,154,178
2019,10,15,22,13,49,62
2019,10,15,23,8,48,56
2019,10,16,0,14,21,35
2019,10,16,1,6,15,21
2019,10,16,2,8,18,26
2019,10,16,3,15,104,119
2019,10,16,4,133,196,329
2019,10,16,5,243,143,386
2019,10,16,6,411,154,565
2019,10,16,7,272,78,350
2019,10,16,8,198,137,335
2019,10,16,9,188,164,352
2019,10,16,10,221,202,423
2019,10,16,11,209,217,426
2019,10,16,12,219,247,466
2019,10,16,13,255,277,532
2019,10,16,14,223,307,530
2019,10,16,15,184,167,351
2019,10,16,16,188,151,339
2019,10,16,17,130,130,260
2019,10,16,18,103,101,204
2019,10,16,19,82,119,201
2019,10,16,20,49,172,221
2019,10,16,21,29,109,138
2019,10,16,22,15,25,40
2019,10,16,23,11,13,24
2019,10,17,0,10,21,31
2019,10,17,1,7,14,21
2019,10,17,2,7,10,17
2019,10,17,3,16,8,24
2019,10,17,4,106,49,155
2019,10,17,5,243,118,361
2019,10,17,6,378,197,575
2019,10,17,7,254,134,388
2019,10,17,8,237,165,402
2019,10,17,9,212,145,357
2019,10,17,10,200,187,387
2019,10,17,11,204,205,409
2019,10,17,12,199,255,454
2019,10,17,13,242,279,521
2019,10,17,14,215,294,509
2019,10,17,15,200,163,363
2019,10,17,16,195,150,345
2019,10,17,17,123,155,278
2019,10,17,18,96,110,206
2019,10,17,19,95,113,208
2019,10,17,20,64,70,134
2019,10,17,21,43,44,87
2019,10,17,22,16,24,40
2019,10,17,23,8,13,21
2019,10,18,0,16,11,27
2019,10,18,1,11,14,25
2019,10,18,2,5,11,16
2019,10,18,3,14,8,22
2019,10,18,4,116,52,168
2019,10,18,5,239,114,353
2019,10,18,6,412,181,593
2019,10,18,7,222,133,355
2019,10,18,8,217,149,366
2019,10,18,9,224,207,431
2019,10,18,10,229,212,441
2019,10,18,11,229,214,443
2019,10,18,12,265,288,553
2019,10,18,13,264,315,579
2019,10,18,14,184,283,467
2019,10,18,15,150,183,333
2019,10,18,16,148,149,297
2019,10,18,17,135,132,267
2019,10,18,18,106,102,208
2019,10,18,19,66,92,158
2019,10,18,20,58,73,131
2019,10,18,21,43,55,98
2019,10,18,22,24,40,64
2019,10,18,23,15,25,40
2019,10,19,0,12,24,36
2019,10,19,1,16,21,37
2019,10,19,2,9,14,23
2019,10,19,3,9,8,17
2019,10,19,4,21,6,27
2019,10,19,5,35,24,59
2019,10,19,6,38,28,66
2019,10,19,7,61,44,105
2019,10,19,8,111,73,184
2019,10,19,9,154,95,249
2019,10,19,10,148,100,248
2019,10,19,11,184,176,360
2019,10,19,12,176,169,345
2019,10,19,13,152,208,360
2019,10,19,14,147,159,306
2019,10,19,15,146,156,302
2019,10,19,16,131,134,265
2019,10,19,17,79,109,188
2019,10,19,18,79,79,158
2019,10,19,19,48,63,111
2019,10,19,20,45,69,114
2019,10,19,21,48,54,102
2019,10,19,22,42,59,101
2019,10,19,23,39,37,76
2019,10,20,0,23,27,50
2019,10,20,1,19,34,53
2019,10,20,2,15,25,40
2019,10,20,3,16,9,25
2019,10,20,4,17,8,25
2019,10,20,5,16,11,27
2019,10,20,6,38,21,59
2019,10,20,7,41,25,66
2019,10,20,8,112,49,161
2019,10,20,9,122,71,193
2019,10,20,10,163,127,290
2019,10,20,11,156,137,293
2019,10,20,12,192,171,363
2019,10,20,13,166,222,388
2019,10,20,14,141,201,342
2019,10,20,15,169,174,343
2019,10,20,16,143,156,299
2019,10,20,17,131,140,271
2019,10,20,18,99,124,223
2019,10,20,19,62,90,152
2019,10,20,20,60,76,136
2019,10,20,21,28,34,62
2019,10,20,22,15,15,30
2019,10,20,23,9,7,16
2019,10,21,0,9,8,17
2019,10,21,1,3,6,9
2019,10,21,2,8,10,18
2019,10,21,3,20,12,32
2019,10,21,4,112,45,157
2019,10,21,5,222,128,350
2019,10,21,6,436,178,614
2019,10,21,7,259,140,399
2019,10,21,8,225,161,386
2019,10,21,9,212,172,384
2019,10,21,10,193,204,397
2019,10,21,11,220,199,419
2019,10,21,12,220,228,448
2019,10,21,13,237,337,574
2019,10,21,14,199,249,448
2019,10,21,15,191,184,375
2019,10,21,16,160,148,308
2019,10,21,17,133,119,252
2019,10,21,18,92,112,204
2019,10,21,19,81,99,180
2019,10,21,20,54,57,111
2019,10,21,21,34,34,68
2019,10,21,22,11,14,25
2019,10,21,23,7,7,14
2019,10,22,0,4,6,10
2019,10,22,1,11,9,20
2019,10,22,2,3,5,8
2019,10,22,3,19,10,29
2019,10,22,4,120,41,161
2019,10,22,5,223,136,359
2019,10,22,6,379,201,580
2019,10,22,7,286,160,446
2019,10,22,8,215,169,384
2019,10,22,9,247,150,397
2019,10,22,10,232,201,433
2019,10,22,11,236,188,424
2019,10,22,12,229,237,466
2019,10,22,13,252,323,575
2019,10,22,14,255,304,559
2019,10,22,15,218,187,405
2019,10,22,16,183,166,349
2019,10,22,17,130,130,260
2019,10,22,18,88,125,213
2019,10,22,19,92,105,197
2019,10,22,20,63,69,132
2019,10,22,21,29,34,63
2019,10,22,22,18,11,29
2019,10,22,23,5,4,9
2019,10,23,0,6,7,13
2019,10,23,1,5,13,18
2019,10,23,2,7,6,13
2019,10,23,3,24,9,33
2019,10,23,4,116,43,159
2019,10,23,5,236,118,354
2019,10,23,6,406,198,604
2019,10,23,7,258,143,401
2019,10,23,8,212,164,376
2019,10,23,9,192,158,350
2019,10,23,10,212,175,387
2019,10,23,11,210,207,417
2019,10,23,12,223,244,467
2019,10,23,13,249,294,543
2019,10,23,14,231,274,505
2019,10,23,15,198,186,384
2019,10,23,16,171,173,344
2019,10,23,17,113,150,263
2019,10,23,18,113,112,225
2019,10,23,19,67,110,177
2019,10,23,20,55,71,126
2019,10,23,21,45,47,92
2019,10,23,22,21,18,39
2019,10,23,23,8,15,23
2019,10,24,0,7,3,10
2019,10,24,1,11,8,19
2019,10,24,2,6,10,16
2019,10,24,3,19,9,28
2019,10,24,4,116,48,164
2019,10,24,5,226,124,350
2019,10,24,6,392,191,583
2019,10,24,7,279,140,419
2019,10,24,8,195,172,367
2019,10,24,9,193,151,344
2019,10,24,10,225,176,401
2019,10,24,11,201,196,397
2019,10,24,12,390,369,759
2019,10,24,13,375,462,837
2019,10,24,14,302,350,652
2019,10,24,15,183,194,377
2019,10,24,16,160,133,293
2019,10,24,17,137,134,271
2019,10,24,18,94,104,198
2019,10,24,19,84,114,198
2019,10,24,20,69,72,141
2019,10,24,21,33,33,66
2019,10,24,22,13,21,34
2019,10,24,23,10,21,31
2019,10,25,0,10,13,23
2019,10,25,1,4,20,24
2019,10,25,2,7,10,17
2019,10,25,3,22,7,29
2019,10,25,4,112,45,157
2019,10,25,5,231,118,349
2019,10,25,6,328,186,514
2019,10,25,7,303,152,455
2019,10,25,8,225,155,380
2019,10,25,9,203,188,391
2019,10,25,10,228,207,435
2019,10,25,11,191,206,397
2019,10,25,12,221,236,457
2019,10,25,13,269,313,582
2019,10,25,14,183,251,434
2019,10,25,15,162,163,325
2019,10,25,16,149,159,308
2019,10,25,17,124,131,255
2019,10,25,18,84,81,165
2019,10,25,19,67,88,155
2019,10,25,20,52,66,118
2019,10,25,21,45,61,106
2019,10,25,22,26,43,69
2019,10,25,23,17,34,51
2019,10,26,0,19,27,46
2019,10,26,1,15,30,45
2019,10,26,2,10,17,27
2019,10,26,3,6,8,14
2019,10,26,4,21,16,37
2019,10,26,5,28,19,47
2019,10,26,6,52,26,78
2019,10,26,7,76,42,118
2019,10,26,8,146,65,211
2019,10,26,9,166,81,247
2019,10,26,10,162,145,307
2019,10,26,11,163,139,302
2019,10,26,12,181,183,364
2019,10,26,13,124,221,345
2019,10,26,14,148,174,322
2019,10,26,15,124,129,253
2019,10,26,16,149,130,279
2019,10,26,17,117,121,238
2019,10,26,18,79,88,167
2019,10,26,19,57,71,128
2019,10,26,20,35,56,91
2019,10,26,21,45,60,105
2019,10,26,22,41,47,88
2019,10,26,23,33,47,80
2019,10,27,0,29,25,54
2019,10,27,1,24,39,63
2019,10,27,2,18,28,46
2019,10,27,3,9,23,32
2019,10,27,4,8,7,15
2019,10,27,5,18,10,28
2019,10,27,6,23,11,34
2019,10,27,7,39,11,50
2019,10,27,8,49,36,85
2019,10,27,9,121,76,197
2019,10,27,10,137,107,244
2019,10,27,11,160,131,291
2019,10,27,12,186,196,382
2019,10,27,13,189,184,373
2019,10,27,14,161,213,374
2019,10,27,15,146,212,358
2019,10,27,16,147,139,286
2019,10,27,17,131,115,246
2019,10,27,18,123,141,264
2019,10,27,19,95,122,217
2019,10,27,20,67,83,150
2019,10,27,21,45,63,108
2019,10,27,22,22,41,63
2019,10,27,23,13,15,28
2019,10,28,0,13,7,20
2019,10,28,1,7,5,12
2019,10,28,2,10,10,20
2019,10,28,3,11,9,20
2019,10,28,4,24,8,32
2019,10,28,5,100,58,158
2019,10,28,6,233,135,368
2019,10,28,7,380,204,584
2019,10,28,8,255,134,389
2019,10,28,9,221,126,347
2019,10,28,10,194,147,341
2019,10,28,11,198,187,385
2019,10,28,12,205,188,393
2019,10,28,13,227,242,469
2019,10,28,14,224,334,558
2019,10,28,15,216,279,495
2019,10,28,16,208,178,386
2019,10,28,17,176,178,354
2019,10,28,18,115,125,240
2019,10,28,19,96,121,217
2019,10,28,20,110,102,212
2019,10,28,21,52,74,126
2019,10,28,22,29,52,81
2019,10,28,23,10,27,37
2019,10,29,0,8,9,17
2019,10,29,1,4,6,10
2019,10,29,2,7,7,14
2019,10,29,3,9,11,20
2019,10,29,4,25,7,32
2019,10,29,5,114,49,163
2019,10,29,6,235,144,379
2019,10,29,7,385,205,590
2019,10,29,8,270,154,424
2019,10,29,9,207,169,376
2019,10,29,10,206,148,354
2019,10,29,11,201,193,394
2019,10,29,12,194,201,395
2019,10,29,13,236,247,483
2019,10,29,14,250,299,549
2019,10,29,15,234,305,539
2019,10,29,16,177,177,354
2019,10,29,17,177,141,318
2019,10,29,18,135,127,262
2019,10,29,19,109,116,225
2019,10,29,20,89,105,194
2019,10,29,21,64,70,134
2019,10,29,22,29,35,64
2019,10,29,23,9,17,26
2019,10,30,0,6,14,20
2019,10,30,1,6,8,14
2019,10,30,2,7,7,14
2019,10,30,3,6,4,10
2019,10,30,4,19,8,27
2019,10,30,5,104,49,153
2019,10,30,6,221,137,358
2019,10,30,7,401,189,590
2019,10,30,8,257,161,418
2019,10,30,9,247,184,431
2019,10,30,10,219,172,391
2019,10,30,11,217,165,382
2019,10,30,12,228,224,452
2019,10,30,13,187,241,428
2019,10,30,14,249,296,545
2019,10,30,15,237,284,521
2019,10,30,16,189,184,373
2019,10,30,17,172,163,335
2019,10,30,18,118,154,272
2019,10,30,19,103,80,183
2019,10,30,20,63,91,154
2019,10,30,21,48,81,129
2019,10,30,22,25,44,69
2019,10,30,23,18,20,38
2019,10,31,0,7,9,16
2019,10,31,1,8,8,16
2019,10,31,2,3,10,13
2019,10,31,3,15,7,22
2019,10,31,4,21,6,27
2019,10,31,5,111,54,165
2019,10,31,6,226,131,357
2019,10,31,7,387,191,578
2019,10,31,8,239,136,375
2019,10,31,9,201,162,363
2019,10,31,10,197,179,376
2019,10,31,11,211,170,381
2019,10,31,12,218,223,441
2019,10,31,13,220,239,459
2019,10,31,14,292,322,614
2019,10,31,15,203,279,482
2019,10,31,16,191,181,372
2019,10,31,17,169,153,322
2019,10,31,18,125,145,270
2019,10,31,19,99,121,220
2019,10,31,20,81,99,180
2019,10,31,21,71,315,386
2019,10,31,22,30,196,226
2019,10,31,23,21,69,90
2019,11,1,0,18,18,36
2019,11,1,1,13,18,31
2019,11,1,2,20,10,30
2019,11,1,3,14,13,27
2019,11,1,4,26,7,33
2019,11,1,5,114,51,165
2019,11,1,6,239,123,362
2019,11,1,7,390,175,565
2019,11,1,8,250,152,402
2019,11,1,9,208,169,377
2019,11,1,10,208,149,357
2019,11,1,11,210,219,429
2019,11,1,12,223,207,430
2019,11,1,13,231,244,475
2019,11,1,14,279,310,589
2019,11,1,15,174,260,434
2019,11,1,16,135,149,284
2019,11,1,17,149,133,282
2019,11,1,18,116,119,235
2019,11,1,19,72,88,160
2019,11,1,20,59,72,131
2019,11,1,21,74,73,147
2019,11,1,22,39,56,95
2019,11,1,23,35,36,71
2019,11,2,0,22,17,39
2019,11,2,1,19,24,43
2019,11,2,2,15,20,35
2019,11,2,3,7,19,26
2019,11,2,4,13,9,22
2019,11,2,5,21,12,33
2019,11,2,6,23,20,43
2019,11,2,7,50,35,85
2019,11,2,8,74,46,120
2019,11,2,9,107,85,192
2019,11,2,10,144,96,240
2019,11,2,11,155,122,277
2019,11,2,12,154,168,322
2019,11,2,13,158,169,327
2019,11,2,14,167,204,371
2019,11,2,15,130,169,299
2019,11,2,16,136,133,269
2019,11,2,17,113,135,248
2019,11,2,18,93,101,194
2019,11,2,19,68,68,136
2019,11,2,20,55,66,121
2019,11,2,21,45,55,100
2019,11,2,22,51,53,104
2019,11,2,23,29,38,67
2019,11,3,0,35,35,70
2019,11,3,1,29,27,56
2019,11,3,2,24,21,45
2019,11,3,3,13,21,34
2019,11,3,4,9,10,19
2019,11,3,5,16,10,26
2019,11,3,6,11,18,29
2019,11,3,7,33,12,45
2019,11,3,8,56,46,102
2019,11,3,9,97,63,160
2019,11,3,10,109,91,200
2019,11,3,11,157,123,280
2019,11,3,12,169,153,322
2019,11,3,13,190,215,405
2019,11,3,14,177,234,411
2019,11,3,15,182,193,375
2019,11,3,16,261,153,414
2019,11,3,17,165,181,346
2019,11,3,18,135,233,368
2019,11,3,19,103,132,235
2019,11,3,20,69,82,151
2019,11,3,21,37,64,101
2019,11,3,22,27,32,59
2019,11,3,23,14,17,31
2019,11,4,0,8,10,18
2019,11,4,1,6,6,12
2019,11,4,2,8,12,20
2019,11,4,3,7,3,10
2019,11,4,4,24,11,35
2019,11,4,5,119,49,168
2019,11,4,6,227,126,353
2019,11,4,7,344,184,528
2019,11,4,8,243,122,365
2019,11,4,9,217,153,370
2019,11,4,10,194,155,349
2019,11,4,11,207,173,380
2019,11,4,12,203,200,403
2019,11,4,13,204,227,431
2019,11,4,14,251,296,547
2019,11,4,15,209,283,492
2019,11,4,16,191,186,377
2019,11,4,17,157,146,303
2019,11,4,18,101,150,251
2019,11,4,19,111,113,224
2019,11,4,20,74,98,172
2019,11,4,21,60,54,114
2019,11,4,22,31,25,56
2019,11,4,23,21,11,32
2019,11,5,0,11,15,26
2019,11,5,1,9,6,15
2019,11,5,2,18,3,21
2019,11,5,3,14,4,18
2019,11,5,4,28,12,40
2019,11,5,5,114,45,159
2019,11,5,6,239,120,359
2019,11,5,7,387,204,591
2019,11,5,8,260,168,428
2019,11,5,9,218,138,356
2019,11,5,10,194,155,349
2019,11,5,11,213,156,369
2019,11,5,12,187,204,391
2019,11,5,13,191,216,407
2019,11,5,14,267,317,584
2019,11,5,15,197,258,455
2019,11,5,16,156,161,317
2019,11,5,17,151,130,281
2019,11,5,18,128,121,249
2019,11,5,19,105,131,236
2019,11,5,20,61,86,147
2019,11,5,21,45,55,100
2019,11,5,22,22,18,40
2019,11,5,23,14,16,30
2019,11,6,0,4,9,13
2019,11,6,1,5,8,13
2019,11,6,2,5,6,11
2019,11,6,3,4,3,7
2019,11,6,4,20,14,34
2019,11,6,5,111,46,157
2019,11,6,6,224,121,345
2019,11,6,7,355,174,529
2019,11,6,8,251,117,368
2019,11,6,9,214,144,358
2019,11,6,10,224,155,379
2019,11,6,11,208,188,396
2019,11,6,12,196,189,385
2019,11,6,13,187,222,409
2019,11,6,14,238,281,519
2019,11,6,15,200,283,483
2019,11,6,16,191,199,390
2019,11,6,17,154,147,301
2019,11,6,18,116,125,241
2019,11,6,19,92,109,201
2019,11,6,20,81,100,181
2019,11,6,21,73,71,144
2019,11,6,22,37,42,79
2019,11,6,23,14,21,35
2019,11,7,0,10,10,20
2019,11,7,1,5,12,17
2019,11,7,2,5,8,13
2019,11,7,3,6,8,14
2019,11,7,4,15,9,24
2019,11,7,5,122,48,170
2019,11,7,6,244,118,362
2019,11,7,7,382,191,573
2019,11,7,8,234,127,361
2019,11,7,9,190,161,351
2019,11,7,10,204,169,373
2019,11,7,11,220,197,417
2019,11,7,12,212,212,424
2019,11,7,13,218,260,478
2019,11,7,14,265,290,555
2019,11,7,15,217,277,494
2019,11,7,16,185,168,353
2019,11,7,17,178,157,335
2019,11,7,18,126,115,241
2019,11,7,19,97,122,219
2019,11,7,20,81,103,184
2019,11,7,21,57,81,138
2019,11,7,22,4,39,43
2019,11,7,23,19,19,38
2019,11,8,0,12,14,26
2019,11,8,1,18,11,29
2019,11,8,2,12,10,22
2019,11,8,3,3,9,12
2019,11,8,4,17,7,24
2019,11,8,5,115,52,167
2019,11,8,6,232,121,353
2019,11,8,7,311,156,467
2019,11,8,8,213,134,347
2019,11,8,9,214,134,348
2019,11,8,10,233,165,398
2019,11,8,11,208,180,388
2019,11,8,12,209,199,408
2019,11,8,13,238,243,481
2019,11,8,14,244,285,529
2019,11,8,15,188,247,435
2019,11,8,16,154,163,317
2019,11,8,17,134,147,281
2019,11,8,18,108,111,219
2019,11,8,19,77,72,149
2019,11,8,20,98,81,179
2019,11,8,21,22,59,81
2019,11,8,22,2,51,53
2019,11,8,23,13,28,41
2019,11,9,0,22,26,48
2019,11,9,1,13,15,28
2019,11,9,2,17,13,30
2019,11,9,3,5,17,22
2019,11,9,4,7,10,17
2019,11,9,5,22,9,31
2019,11,9,6,48,27,75
2019,11,9,7,144,58,202
2019,11,9,8,58,39,97
2019,11,9,9,129,91,220
2019,11,9,10,131,85,216
2019,11,9,11,255,180,435
2019,11,9,12,170,190,360
2019,11,9,13,168,188,356
2019,11,9,14,169,224,393
2019,11,9,15,142,175,317
2019,11,9,16,147,220,367
2019,11,9,17,120,126,246
2019,11,9,18,123,115,238
2019,11,9,19,88,76,164
2019,11,9,20,55,73,128
2019,11,9,21,57,56,113
2019,11,9,22,40,61,101
2019,11,9,23,37,50,87
2019,11,10,0,25,34,59
2019,11,10,1,23,28,51
2019,11,10,2,19,32,51
2019,11,10,3,15,23,38
2019,11,10,4,10,15,25
2019,11,10,5,9,7,16
2019,11,10,6,23,11,34
2019,11,10,7,29,25,54
2019,11,10,8,60,31,91
2019,11,10,9,102,68,170
2019,11,10,10,110,89,199
2019,11,10,11,165,142,307
2019,11,10,12,154,141,295
2019,11,10,13,209,193,402
2019,11,10,14,158,168,326
2019,11,10,15,131,205,336
2019,11,10,16,147,134,281
2019,11,10,17,122,123,245
2019,11,10,18,123,118,241
2019,11,10,19,124,135,259
2019,11,10,20,74,92,166
2019,11,10,21,39,56,95
2019,11,10,22,29,28,57
2019,11,10,23,15,17,32
2019,11,11,0,17,9,26
2019,11,11,1,7,8,15
2019,11,11,2,5,7,12
2019,11,11,3,4,2,6
2019,11,11,4,22,11,33
2019,11,11,5,110,50,160
2019,11,11,6,218,115,333
2019,11,11,7,375,176,551
2019,11,11,8,245,144,389
2019,11,11,9,206,145,351
2019,11,11,10,211,146,357
2019,11,11,11,178,166,344
2019,11,11,12,233,214,447
2019,11,11,13,183,264,447
2019,11,11,14,229,300,529
2019,11,11,15,202,262,464
2019,11,11,16,187,140,327
2019,11,11,17,145,127,272
2019,11,11,18,112,116,228
2019,11,11,19,87,97,184
2019,11,11,20,86,86,172
2019,11,11,21,53,72,125
2019,11,11,22,20,35,55
2019,11,11,23,7,16,23
2019,11,12,0,4,9,13
2019,11,12,1,7,12,19
2019,11,12,2,5,5,10
2019,11,12,3,6,8,14
2019,11,12,4,20,9,29
2019,11,12,5,103,56,159
2019,11,12,6,254,131,385
2019,11,12,7,372,228,600
2019,11,12,8,275,159,434
2019,11,12,9,227,153,380
2019,11,12,10,208,142,350
2019,11,12,11,225,168,393
2019,11,12,12,194,205,399
2019,11,12,13,211,215,426
2019,11,12,14,257,318,575
2019,11,12,15,231,294,525
2019,11,12,16,186,190,376
2019,11,12,17,185,165,350
2019,11,12,18,132,126,258
2019,11,12,19,101,121,222
2019,11,12,20,77,108,185
2019,11,12,21,42,316,358
2019,11,12,22,22,174,196
2019,11,12,23,16,40,56
2019,11,13,0,11,11,22
2019,11,13,1,12,10,22
2019,11,13,2,8,6,14
2019,11,13,3,5,6,11
2019,11,13,4,19,7,26
2019,11,13,5,104,42,146
2019,11,13,6,221,131,352
2019,11,13,7,407,223,630
2019,11,13,8,290,161,451
2019,11,13,9,215,139,354
2019,11,13,10,204,147,351
2019,11,13,11,207,177,384
2019,11,13,12,198,185,383
2019,11,13,13,226,232,458
2019,11,13,14,265,321,586
2019,11,13,15,195,292,487
2019,11,13,16,182,185,367
2019,11,13,17,159,130,289
2019,11,13,18,127,157,284
2019,11,13,19,115,120,235
2019,11,13,20,76,97,173
2019,11,13,21,49,66,115
2019,11,13,22,21,44,65
2019,11,13,23,20,20,40
2019,11,14,0,10,11,21
2019,11,14,1,9,10,19
2019,11,14,2,9,11,20
2019,11,14,3,10,13,23
2019,11,14,4,16,12,28
2019,11,14,5,100,52,152
2019,11,14,6,241,137,378
2019,11,14,7,388,205,593
2019,11,14,8,262,170,432
2019,11,14,9,208,159,367
2019,11,14,10,216,169,385
2019,11,14,11,221,172,393
2019,11,14,12,233,192,425
2019,11,14,13,218,232,450
2019,11,14,14,276,317,593
2019,11,14,15,225,279,504
2019,11,14,16,188,192,380
2019,11,14,17,172,145,317
2019,11,14,18,123,133,256
2019,11,14,19,88,100,188
2019,11,14,20,89,96,185
2019,11,14,21,43,74,117
2019,11,14,22,38,51,89
2019,11,14,23,21,28,49
2019,11,15,0,15,18,33
2019,11,15,1,12,13,25
2019,11,15,2,12,17,29
2019,11,15,3,7,18,25
2019,11,15,4,14,10,24
2019,11,15,5,93,44,137
2019,11,15,6,243,119,362
2019,11,15,7,355,179,534
2019,11,15,8,229,156,385
2019,11,15,9,223,167,390
2019,11,15,10,246,172,418
2019,11,15,11,215,180,395
2019,11,15,12,226,218,444
2019,11,15,13,244,251,495
2019,11,15,14,273,314,587
2019,11,15,15,164,250,414
2019,11,15,16,156,174,330
2019,11,15,17,145,150,295
2019,11,15,18,118,113,231
2019,11,15,19,99,113,212
2019,11,15,20,64,71,135
2019,11,15,21,54,58,112
2019,11,15,22,44,45,89
2019,11,15,23,24,51,75
2019,11,16,0,14,32,46
2019,11,16,1,20,18,38
2019,11,16,2,20,28,48
2019,11,16,3,13,17,30
2019,11,16,4,4,8,12
2019,11,16,5,24,7,31
2019,11,16,6,30,23,53
2019,11,16,7,45,35,80
2019,11,16,8,60,39,99
2019,11,16,9,87,65,152
2019,11,16,10,139,80,219
2019,11,16,11,119,128,247
2019,11,16,12,160,113,273
2019,11,16,13,140,161,301
2019,11,16,14,139,168,307
2019,11,16,15,126,142,268
2019,11,16,16,120,138,258
2019,11,16,17,135,125,260
2019,11,16,18,101,102,203
2019,11,16,19,74,75,149
2019,11,16,20,72,79,151
2019,11,16,21,42,66,108
2019,11,16,22,46,70,116
2019,11,16,23,35,57,92
2019,11,17,0,30,47,77
2019,11,17,1,25,28,53
2019,11,17,2,28,37,65
2019,11,17,3,23,27,50
2019,11,17,4,12,16,28
2019,11,17,5,18,12,30
2019,11,17,6,17,15,32
2019,11,17,7,35,15,50
2019,11,17,8,35,43,78
2019,11,17,9,100,45,145
2019,11,17,10,115,65,180
2019,11,17,11,147,131,278
2019,11,17,12,142,150,292
2019,11,17,13,200,183,383
2019,11,17,14,167,217,384
2019,11,17,15,155,192,347
2019,11,17,16,152,166,318
2019,11,17,17,120,131,251
2019,11,17,18,123,129,252
2019,11,17,19,95,118,213
2019,11,17,20,65,82,147
2019,11,17,21,41,64,105
2019,11,17,22,30,29,59
2019,11,17,23,20,22,42
2019,11,18,0,14,12,26
2019,11,18,1,8,6,14
2019,11,18,2,6,14,20
2019,11,18,3,6,11,17
2019,11,18,4,21,8,29
2019,11,18,5,111,53,164
2019,11,18,6,248,145,393
2019,11,18,7,386,208,594
2019,11,18,8,254,168,422
2019,11,18,9,224,169,393
2019,11,18,10,211,166,377
2019,11,18,11,208,166,374
2019,11,18,12,216,192,408
2019,11,18,13,183,258,441
2019,11,18,14,246,302,548
2019,11,18,15,211,267,478
2019,11,18,16,170,162,332
2019,11,18,17,128,142,270
2019,11,18,18,121,105,226
2019,11,18,19,87,108,195
2019,11,18,20,84,98,182
2019,11,18,21,48,75,123
2019,11,18,22,29,43,72
2019,11,18,23,6,18,24
2019,11,19,0,1,7,8
2019,11,19,1,2,9,11
2019,11,19,2,2,7,9
2019,11,19,3,7,9,16
2019,11,19,4,19,5,24
2019,11,19,5,123,54,177
2019,11,19,6,220,131,351
2019,11,19,7,401,195,596
2019,11,19,8,278,165,443
2019,11,19,9,203,160,363
2019,11,19,10,208,146,354
2019,11,19,11,196,170,366
2019,11,19,12,226,183,409
2019,11,19,13,215,265,480
2019,11,19,14,282,319,601
2019,11,19,15,202,278,480
2019,11,19,16,172,174,346
2019,11,19,17,166,128,294
2019,11,19,18,135,133,268
2019,11,19,19,82,130,212
2019,11,19,20,76,93,169
2019,11,19,21,50,83,133
2019,11,19,22,30,39,69
2019,11,19,23,14,18,32
2019,11,20,0,13,11,24
2019,11,20,1,11,12,23
2019,11,20,2,5,6,11
2019,11,20,3,10,10,20
2019,11,20,4,19,7,26
2019,11,20,5,111,48,159
2019,11,20,6,224,132,356
2019,11,20,7,404,228,632
2019,11,20,8,256,138,394
2019,11,20,9,217,176,393
2019,11,20,10,197,153,350
2019,11,20,11,202,187,389
2019,11,20,12,233,189,422
2019,11,20,13,202,229,431
2019,11,20,14,261,295,556
2019,11,20,15,207,275,482
2019,11,20,16,206,217,423
2019,11,20,17,170,136,306
2019,11,20,18,123,129,252
2019,11,20,19,102,116,218
2019,11,20,20,67,79,146
2019,11,20,21,49,69,118
2019,11,20,22,31,57,88
2019,11,20,23,16,18,34
2019,11,21,0,7,16,23
2019,11,21,1,4,10,14
2019,11,21,2,9,13,22
2019,11,21,3,5,6,11
2019,11,21,4,13,8,21
2019,11,21,5,117,48,165
2019,11,21,6,251,118,369
2019,11,21,7,401,187,588
2019,11,21,8,224,161,385
2019,11,21,9,238,198,436
2019,11,21,10,228,167,395
2019,11,21,11,240,178,418
2019,11,21,12,216,204,420
2019,11,21,13,207,234,441
2019,11,21,14,237,292,529
2019,11,21,15,198,292,490
2019,11,21,16,184,167,351
2019,11,21,17,178,158,336
2019,11,21,18,114,123,237
2019,11,21,19,106,123,229
2019,11,21,20,80,109,189
2019,11,21,21,66,91,157
2019,11,21,22,30,57,87
2019,11,21,23,12,23,35
2019,11,22,0,13,17,30
2019,11,22,1,14,16,30
2019,11,22,2,8,28,36
2019,11,22,3,9,28,37
2019,11,22,4,18,10,28
2019,11,22,5,115,48,163
2019,11,22,6,223,109,332
2019,11,22,7,366,201,567
2019,11,22,8,258,138,396
2019,11,22,9,220,150,370
2019,11,22,10,219,160,379
2019,11,22,11,212,197,409
2019,11,22,12,214,229,443
2019,11,22,13,220,268,488
2019,11,22,14,239,315,554
2019,11,22,15,206,253,459
2019,11,22,16,185,189,374
2019,11,22,17,159,145,304
2019,11,22,18,119,137,256
2019,11,22,19,105,88,193
2019,11,22,20,78,74,152
2019,11,22,21,52,59,111
2019,11,22,22,50,65,115
2019,11,22,23,31,41,72
2019,11,23,0,21,28,49
2019,11,23,1,17,22,39
2019,11,23,2,10,11,21
2019,11,23,3,13,16,29
2019,11,23,4,10,12,22
2019,11,23,5,24,11,35
2019,11,23,6,26,22,48
2019,11,23,7,40,35,75
2019,11,23,8,56,38,94
2019,11,23,9,95,59,154
2019,11,23,10,139,102,241
2019,11,23,11,148,121,269
2019,11,23,12,185,137,322
2019,11,23,13,294,170,464
2019,11,23,14,560,174,734
2019,11,23,15,489,190,679
2019,11,23,16,185,523,708
2019,11,23,17,126,265,391
2019,11,23,18,102,145,247
2019,11,23,19,78,82,160
2019,11,23,20,44,64,108
2019,11,23,21,54,75,129
2019,11,23,22,44,60,104
2019,11,23,23,41,53,94
2019,11,24,0,24,36,60
2019,11,24,1,22,34,56
2019,11,24,2,27,29,56
2019,11,24,3,17,21,38
2019,11,24,4,16,20,36
2019,11,24,5,16,13,29
2019,11,24,6,19,16,35
2019,11,24,7,38,19,57
2019,11,24,8,58,39,97
2019,11,24,9,90,45,135
2019,11,24,10,114,69,183
2019,11,24,11,151,156,307
2019,11,24,12,176,160,336
2019,11,24,13,183,205,388
2019,11,24,14,183,218,401
2019,11,24,15,160,185,345
2019,11,24,16,128,137,265
2019,11,24,17,139,121,260
2019,11,24,18,123,112,235
2019,11,24,19,98,110,208
2019,11,24,20,63,96,159
2019,11,24,21,47,48,95
2019,11,24,22,16,31,47
2019,11,24,23,14,12,26
2019,11,25,0,14,12,26
2019,11,25,1,8,13,21
2019,11,25,2,7,12,19
2019,11,25,3,7,7,14
2019,11,25,4,25,12,37
2019,11,25,5,116,47,163
2019,11,25,6,253,125,378
2019,11,25,7,384,197,581
2019,11,25,8,260,138,398
2019,11,25,9,218,166,384
2019,11,25,10,238,147,385
2019,11,25,11,191,176,367
2019,11,25,12,209,190,399
2019,11,25,13,216,229,445
2019,11,25,14,229,290,519
2019,11,25,15,194,316,510
2019,11,25,16,192,165,357
2019,11,25,17,145,146,291
2019,11,25,18,123,103,226
2019,11,25,19,114,108,222
2019,11,25,20,65,105,170
2019,11,25,21,53,61,114
2019,11,25,22,22,75,97
2019,11,25,23,15,35,50
2019,11,26,0,12,12,24
2019,11,26,1,2,2,4
2019,11,26,2,6,12,18
2019,11,26,3,7,3,10
2019,11,26,4,16,11,27
2019,11,26,5,125,53,178
2019,11,26,6,248,142,390
2019,11,26,7,405,197,602
2019,11,26,8,261,188,449
2019,11,26,9,177,158,335
2019,11,26,10,215,149,364
2019,11,26,11,194,171,365
2019,11,26,12,199,185,384
2019,11,26,13,211,213,424
2019,11,26,14,235,333,568
2019,11,26,15,197,301,498
2019,11,26,16,194,160,354
2019,11,26,17,150,152,302
2019,11,26,18,105,118,223
2019,11,26,19,84,93,177
2019,11,26,20,63,95,158
2019,11,26,21,48,62,110
2019,11,26,22,31,42,73
2019,11,26,23,19,11,30
2019,11,27,0,10,8,18
2019,11,27,1,15,9,24
2019,11,27,2,17,6,23
2019,11,27,3,17,5,22
2019,11,27,4,22,10,32
2019,11,27,5,124,46,170
2019,11,27,6,219,108,327
2019,11,27,7,366,169,535
2019,11,27,8,203,120,323
2019,11,27,9,172,130,302
2019,11,27,10,181,140,321
2019,11,27,11,165,142,307
2019,11,27,12,208,167,375
2019,11,27,13,198,231,429
2019,11,27,14,215,280,495
2019,11,27,15,178,232,410
2019,11,27,16,171,170,341
2019,11,27,17,149,140,289
2019,11,27,18,140,131,271
2019,11,27,19,121,128,249
2019,11,27,20,105,102,207
2019,11,27,21,65,96,161
2019,11,27,22,31,32,63
2019,11,27,23,23,21,44
2019,11,28,0,21,12,33
2019,11,28,1,13,7,20
2019,11,28,2,7,6,13
2019,11,28,3,17,5,22
2019,11,28,4,27,15,42
2019,11,28,5,125,51,176
2019,11,28,6,223,113,336
2019,11,28,7,375,194,569
2019,11,28,8,255,169,424
2019,11,28,9,196,136,332
2019,11,28,10,233,171,404
2019,11,28,11,202,173,375
2019,11,28,12,212,192,404
2019,11,28,13,226,249,475
2019,11,28,14,272,333,605
2019,11,28,15,192,267,459
2019,11,28,16,180,174,354
2019,11,28,17,179,146,325
2019,11,28,18,111,125,236
2019,11,28,19,95,124,219
2019,11,28,20,85,97,182
2019,11,28,21,52,94,146
2019,11,28,22,32,38,70
2019,11,28,23,21,28,49
2019,11,29,0,13,18,31
2019,11,29,1,9,19,28
2019,11,29,2,10,20,30
2019,11,29,3,8,8,16
2019,11,29,4,20,13,33
2019,11,29,5,110,45,155
2019,11,29,6,234,136,370
2019,11,29,7,385,199,584
2019,11,29,8,248,147,395
2019,11,29,9,197,154,351
2019,11,29,10,205,159,364
2019,11,29,11,215,191,406
2019,11,29,12,245,201,446
2019,11,29,13,248,260,508
2019,11,29,14,257,290,547
2019,11,29,15,213,262,475
2019,11,29,16,147,176,323
2019,11,29,17,180,163,343
2019,11,29,18,133,162,295
2019,11,29,19,88,87,175
2019,11,29,20,68,90,158
2019,11,29,21,69,80,149
2019,11,29,22,59,88,147
2019,11,29,23,46,54,100
2019,11,30,0,25,32,57
2019,11,30,1,23,28,51
2019,11,30,2,16,23,39
2019,11,30,3,12,20,32
2019,11,30,4,10,11,21
2019,11,30,5,22,12,34
2019,11,30,6,28,27,55
2019,11,30,7,50,31,81
2019,11,30,8,70,33,103
2019,11,30,9,106,70,176
2019,11,30,10,129,90,219
2019,11,30,11,152,111,263
2019,11,30,12,174,142,316
2019,11,30,13,147,140,287
2019,11,30,14,158,177,335
2019,11,30,15,139,163,302
2019,11,30,16,129,153,282
2019,11,30,17,130,135,265
2019,11,30,18,111,114,225
2019,11,30,19,69,96,165
2019,11,30,20,55,60,115
2019,11,30,21,53,72,125
2019,11,30,22,54,61,115
2019,11,30,23,28,52,80
2019,12,1,0,29,31,60
2019,12,1,1,25,24,49
2019,12,1,2,18,35,53
2019,12,1,3,20,23,43
2019,12,1,4,15,17,32
2019,12,1,5,17,16,33
2019,12,1,6,17,18,35
2019,12,1,7,33,16,49
2019,12,1,8,53,28,81
2019,12,1,9,79,51,130
2019,12,1,10,98,82,180
2019,12,1,11,128,144,272
2019,12,1,12,147,141,288
2019,12,1,13,197,164,361
2019,12,1,14,164,203,367
2019,12,1,15,163,175,338
2019,12,1,16,155,190,345
2019,12,1,17,126,143,269
2019,12,1,18,118,126,244
2019,12,1,19,142,139,281
2019,12,1,20,61,81,142
2019,12,1,21,47,50,97
2019,12,1,22,32,40,72
2019,12,1,23,17,26,43
2019,12,2,0,15,10,25
2019,12,2,1,9,14,23
2019,12,2,2,13,13,26
2019,12,2,3,7,7,14
2019,12,2,4,16,11,27
2019,12,2,5,107,48,155
2019,12,2,6,214,131,345
2019,12,2,7,399,201,600
2019,12,2,8,265,157,422
2019,12,2,9,227,157,384
2019,12,2,10,209,168,377
2019,12,2,11,206,160,366
2019,12,2,12,186,194,380
2019,12,2,13,209,205,414
2019,12,2,14,237,319,556
2019,12,2,15,197,289,486
2019,12,2,16,158,194,352
2019,12,2,17,146,130,276
2019,12,2,18,115,112,227
2019,12,2,19,88,126,214
2019,12,2,20,88,95,183
2019,12,2,21,65,65,130
2019,12,2,22,27,20,47
2019,12,2,23,18,19,37
2019,12,3,0,8,10,18
2019,12,3,1,8,10,18
2019,12,3,2,11,6,17
2019,12,3,3,5,3,8
2019,12,3,4,23,6,29
2019,12,3,5,119,48,167
2019,12,3,6,242,135,377
2019,12,3,7,300,203,503
2019,12,3,8,289,176,465
2019,12,3,9,218,181,399
2019,12,3,10,223,166,389
2019,12,3,11,180,182,362
2019,12,3,12,225,191,416
2019,12,3,13,212,231,443
2019,12,3,14,266,304,570
2019,12,3,15,204,276,480
2019,12,3,16,194,199,393
2019,12,3,17,173,167,340
2019,12,3,18,117,131,248
2019,12,3,19,98,114,212
2019,12,3,20,73,101,174
2019,12,3,21,77,51,128
2019,12,3,22,36,55,91
2019,12,3,23,19,13,32
2019,12,4,0,11,6,17
2019,12,4,1,4,5,9
2019,12,4,2,10,3,13
2019,12,4,3,5,6,11
2019,12,4,4,17,7,24
2019,12,4,5,119,41,160
2019,12,4,6,277,139,416
2019,12,4,7,402,210,612
2019,12,4,8,267,141,408
2019,12,4,9,212,172,384
2019,12,4,10,217,156,373
2019,12,4,11,210,187,397
2019,12,4,12,186,178,364
2019,12,4,13,227,259,486
2019,12,4,14,268,302,570
2019,12,4,15,235,334,569
2019,12,4,16,171,179,350
2019,12,4,17,171,141,312
2019,12,4,18,130,137,267
2019,12,4,19,103,119,222
2019,12,4,20,80,100,180
2019,12,4,21,52,58,110
2019,12,4,22,40,41,81
2019,12,4,23,18,15,33
2019,12,5,0,9,14,23
2019,12,5,1,8,18,26
2019,12,5,2,9,24,33
2019,12,5,3,5,18,23
2019,12,5,4,15,6,21
2019,12,5,5,121,48,169
2019,12,5,6,273,109,382
2019,12,5,7,416,204,620
2019,12,5,8,226,141,367
2019,12,5,9,206,160,366
2019,12,5,10,224,174,398
2019,12,5,11,245,175,420
2019,12,5,12,187,213,400
2019,12,5,13,256,237,493
2019,12,5,14,252,358,610
2019,12,5,15,221,306,527
2019,12,5,16,175,193,368
2019,12,5,17,182,145,327
2019,12,5,18,121,138,259
2019,12,5,19,93,143,236
2019,12,5,20,67,82,149
2019,12,5,21,68,60,128
2019,12,5,22,38,50,88
2019,12,5,23,20,28,48
2019,12,6,0,19,24,43
2019,12,6,1,8,17,25
2019,12,6,2,21,17,38
2019,12,6,3,12,2,14
2019,12,6,4,18,6,24
2019,12,6,5,106,57,163
2019,12,6,6,247,108,355
2019,12,6,7,376,198,574
2019,12,6,8,256,149,405
2019,12,6,9,220,187,407
2019,12,6,10,223,154,377
2019,12,6,11,219,184,403
2019,12,6,12,245,220,465
2019,12,6,13,263,252,515
2019,12,6,14,290,284,574
2019,12,6,15,218,293,511
2019,12,6,16,169,171,340
2019,12,6,17,180,143,323
2019,12,6,18,116,151,267
2019,12,6,19,80,113,193
2019,12,6,20,70,77,147
2019,12,6,21,66,64,130
2019,12,6,22,54,73,127
2019,12,6,23,36,42,78
2019,12,7,0,45,49,94
2019,12,7,1,21,19,40
2019,12,7,2,14,33,47
2019,12,7,3,20,22,42
2019,12,7,4,14,15,29
2019,12,7,5,21,9,30
2019,12,7,6,30,16,46
2019,12,7,7,46,23,69
2019,12,7,8,56,30,86
2019,12,7,9,101,72,173
2019,12,7,10,157,100,257
2019,12,7,11,169,127,296
2019,12,7,12,174,145,319
2019,12,7,13,209,267,476
2019,12,7,14,156,197,353
2019,12,7,15,125,150,275
2019,12,7,16,131,175,306
2019,12,7,17,136,135,271
2019,12,7,18,99,101,200
2019,12,7,19,81,87,168
2019,12,7,20,60,70,130
2019,12,7,21,42,61,103
2019,12,7,22,51,62,113
2019,12,7,23,42,39,81
2019,12,8,0,21,32,53
2019,12,8,1,25,33,58
2019,12,8,2,20,44,64
2019,12,8,3,17,26,43
2019,12,8,4,15,14,29
2019,12,8,5,17,8,25
2019,12,8,6,23,19,42
2019,12,8,7,31,16,47
2019,12,8,8,37,30,67
2019,12,8,9,116,51,167
2019,12,8,10,99,58,157
2019,12,8,11,136,120,256
2019,12,8,12,159,152,311
2019,12,8,13,180,173,353
2019,12,8,14,154,177,331
2019,12,8,15,155,160,315
2019,12,8,16,127,161,288
2019,12,8,17,139,125,264
2019,12,8,18,122,101,223
2019,12,8,19,103,120,223
2019,12,8,20,64,74,138
2019,12,8,21,39,58,97
2019,12,8,22,21,26,47
2019,12,8,23,19,13,32
2019,12,9,0,8,18,26
2019,12,9,1,10,6,16
2019,12,9,2,12,11,23
2019,12,9,3,9,7,16
2019,12,9,4,19,7,26
2019,12,9,5,122,50,172
2019,12,9,6,224,141,365
2019,12,9,7,406,198,604
2019,12,9,8,266,142,408
2019,12,9,9,204,163,367
2019,12,9,10,209,144,353
2019,12,9,11,207,171,378
2019,12,9,12,234,192,426
2019,12,9,13,226,256,482
2019,12,9,14,245,317,562
2019,12,9,15,216,303,519
2019,12,9,16,176,184,360
2019,12,9,17,153,134,287
2019,12,9,18,114,111,225
2019,12,9,19,99,87,186
2019,12,9,20,73,80,153
2019,12,9,21,70,62,132
2019,12,9,22,34,46,80
2019,12,9,23,21,15,36
2019,12,10,0,14,27,41
2019,12,10,1,6,6,12
2019,12,10,2,5,8,13
2019,12,10,3,9,8,17
2019,12,10,4,16,8,24
2019,12,10,5,102,47,149
2019,12,10,6,250,140,390
2019,12,10,7,385,191,576
2019,12,10,8,271,154,425
2019,12,10,9,206,157,363
2019,12,10,10,215,166,381
2019,12,10,11,232,202,434
2019,12,10,12,230,214,444
2019,12,10,13,233,243,476
2019,12,10,14,252,306,558
2019,12,10,15,226,340,566
2019,12,10,16,196,167,363
2019,12,10,17,180,158,338
2019,12,10,18,110,120,230
2019,12,10,19,77,93,170
2019,12,10,20,91,114,205
2019,12,10,21,59,84,143
2019,12,10,22,39,48,87
2019,12,10,23,20,15,35
2019,12,11,0,17,10,27
2019,12,11,1,8,15,23
2019,12,11,2,15,12,27
2019,12,11,3,14,5,19
2019,12,11,4,15,6,21
2019,12,11,5,111,45,156
2019,12,11,6,260,148,408
2019,12,11,7,414,207,621
2019,12,11,8,281,166,447
2019,12,11,9,226,160,386
2019,12,11,10,222,181,403
2019,12,11,11,205,179,384
2019,12,11,12,210,176,386
2019,12,11,13,228,251,479
2019,12,11,14,278,339,617
2019,12,11,15,248,303,551
2019,12,11,16,203,182,385
2019,12,11,17,149,146,295
2019,12,11,18,127,162,289
2019,12,11,19,90,109,199
2019,12,11,20,67,124,191
2019,12,11,21,68,305,373
2019,12,11,22,32,176,208
2019,12,11,23,13,60,73
2019,12,12,0,11,46,57
2019,12,12,1,5,30,35
2019,12,12,2,11,34,45
2019,12,12,3,10,31,41
2019,12,12,4,17,21,38
2019,12,12,5,107,58,165
2019,12,12,6,260,139,399
2019,12,12,7,418,203,621
2019,12,12,8,256,142,398
2019,12,12,9,193,156,349
2019,12,12,10,241,185,426
2019,12,12,11,236,184,420
2019,12,12,12,230,205,435
2019,12,12,13,248,227,475
2019,12,12,14,288,310,598
2019,12,12,15,265,306,571
2019,12,12,16,192,186,378
2019,12,12,17,193,167,360
2019,12,12,18,154,139,293
2019,12,12,19,97,116,213
2019,12,12,20,87,123,210
2019,12,12,21,68,82,150
2019,12,12,22,36,62,98
2019,12,12,23,24,32,56
2019,12,13,0,22,20,42
2019,12,13,1,16,14,30
2019,12,13,2,14,15,29
2019,12,13,3,10,11,21
2019,12,13,4,19,4,23
2019,12,13,5,96,44,140
2019,12,13,6,256,133,389
2019,12,13,7,388,210,598
2019,12,13,8,315,146,461
2019,12,13,9,234,144,378
2019,12,13,10,237,198,435
2019,12,13,11,245,213,458
2019,12,13,12,248,210,458
2019,12,13,13,256,256,512
2019,12,13,14,273,348,621
2019,12,13,15,215,452,667
2019,12,13,16,176,201,377
2019,12,13,17,181,177,358
2019,12,13,18,128,152,280
2019,12,13,19,94,122,216
2019,12,13,20,70,100,170
2019,12,13,21,64,74,138
2019,12,13,22,46,68,114
2019,12,13,23,49,42,91
2019,12,14,0,32,36,68
2019,12,14,1,28,37,65
2019,12,14,2,21,30,51
2019,12,14,3,19,21,40
2019,12,14,4,11,9,20
2019,12,14,5,21,10,31
2019,12,14,6,27,25,52
2019,12,14,7,36,19,55
2019,12,14,8,50,42,92
2019,12,14,9,99,83,182
2019,12,14,10,155,104,259
2019,12,14,11,196,109,305
2019,12,14,12,243,172,415
2019,12,14,13,264,185,449
2019,12,14,14,166,235,401
2019,12,14,15,179,215,394
2019,12,14,16,149,198,347
2019,12,14,17,148,166,314
2019,12,14,18,110,129,239
2019,12,14,19,99,97,196
2019,12,14,20,65,89,154
2019,12,14,21,68,76,144
2019,12,14,22,55,68,123
2019,12,14,23,47,61,108
2019,12,15,0,27,34,61
2019,12,15,1,28,31,59
2019,12,15,2,26,44,70
2019,12,15,3,17,21,38
2019,12,15,4,14,12,26
2019,12,15,5,15,6,21
2019,12,15,6,18,24,42
2019,12,15,7,30,24,54
2019,12,15,8,57,31,88
2019,12,15,9,93,60,153
2019,12,15,10,132,86,218
2019,12,15,11,120,147,267
2019,12,15,12,160,154,314
2019,12,15,13,183,186,369
2019,12,15,14,169,181,350
2019,12,15,15,153,181,334
2019,12,15,16,171,127,298
2019,12,15,17,138,160,298
2019,12,15,18,107,125,232
2019,12,15,19,102,118,220
2019,12,15,20,71,78,149
2019,12,15,21,44,76,120
2019,12,15,22,21,28,49
2019,12,15,23,21,25,46
2019,12,16,0,10,16,26
2019,12,16,1,8,3,11
2019,12,16,2,5,13,18
2019,12,16,3,11,5,16
2019,12,16,4,15,10,25
2019,12,16,5,116,44,160
2019,12,16,6,238,143,381
2019,12,16,7,426,198,624
2019,12,16,8,259,159,418
2019,12,16,9,226,156,382
2019,12,16,10,267,192,459
2019,12,16,11,252,176,428
2019,12,16,12,254,227,481
2019,12,16,13,212,254,466
2019,12,16,14,272,311,583
2019,12,16,15,217,326,543
2019,12,16,16,159,182,341
2019,12,16,17,139,119,258
2019,12,16,18,125,117,242
2019,12,16,19,107,119,226
2019,12,16,20,81,90,171
2019,12,16,21,51,74,125
2019,12,16,22,23,33,56
2019,12,16,23,22,14,36
2019,12,17,0,9,13,22
2019,12,17,1,7,10,17
2019,12,17,2,20,11,31
2019,12,17,3,12,12,24
2019,12,17,4,18,10,28
2019,12,17,5,110,47,157
2019,12,17,6,243,123,366
2019,12,17,7,420,208,628
2019,12,17,8,256,164,420
2019,12,17,9,248,148,396
2019,12,17,10,241,185,426
2019,12,17,11,205,200,405
2019,12,17,12,217,189,406
2019,12,17,13,246,252,498
2019,12,17,14,279,332,611
2019,12,17,15,256,363,619
2019,12,17,16,173,181,354
2019,12,17,17,150,146,296
2019,12,17,18,158,142,300
2019,12,17,19,107,125,232
2019,12,17,20,72,90,162
2019,12,17,21,54,78,132
2019,12,17,22,27,36,63
2019,12,17,23,14,19,33
2019,12,18,0,10,17,27
2019,12,18,1,14,16,30
2019,12,18,2,13,15,28
2019,12,18,3,7,4,11
2019,12,18,4,13,6,19
2019,12,18,5,95,48,143
2019,12,18,6,258,134,392
2019,12,18,7,388,185,573
2019,12,18,8,246,163,409
2019,12,18,9,271,167,438
2019,12,18,10,258,168,426
2019,12,18,11,233,213,446
2019,12,18,12,247,227,474
2019,12,18,13,269,248,517
2019,12,18,14,266,329,595
2019,12,18,15,222,322,544
2019,12,18,16,201,210,411
2019,12,18,17,148,177,325
2019,12,18,18,119,153,272
2019,12,18,19,113,120,233
2019,12,18,20,80,94,174
2019,12,18,21,87,57,144
2019,12,18,22,49,50,99
2019,12,18,23,23,23,46
2019,12,19,0,24,39,63
2019,12,19,1,8,50,58
2019,12,19,2,14,51,65
2019,12,19,3,7,41,48
2019,12,19,4,15,34,49
2019,12,19,5,112,55,167
2019,12,19,6,229,117,346
2019,12,19,7,382,196,578
2019,12,19,8,268,146,414
2019,12,19,9,252,181,433
2019,12,19,10,314,187,501
2019,12,19,11,258,217,475
2019,12,19,12,257,251,508
2019,12,19,13,251,270,521
2019,12,19,14,282,345,627
2019,12,19,15,239,371,610
2019,12,19,16,162,194,356
2019,12,19,17,151,157,308
2019,12,19,18,140,132,272
2019,12,19,19,133,128,261
2019,12,19,20,77,101,178
2019,12,19,21,73,97,170
2019,12,19,22,29,53,82
2019,12,19,23,25,26,51
2019,12,20,0,17,23,40
2019,12,20,1,15,17,32
2019,12,20,2,9,23,32
2019,12,20,3,17,14,31
2019,12,20,4,18,15,33
2019,12,20,5,99,38,137
2019,12,20,6,223,105,328
2019,12,20,7,332,178,510
2019,12,20,8,241,153,394
2019,12,20,9,258,195,453
2019,12,20,10,308,225,533
2019,12,20,11,280,235,515
2019,12,20,12,274,275,549
2019,12,20,13,296,287,583
2019,12,20,14,293,327,620
2019,12,20,15,185,294,479
2019,12,20,16,179,158,337
2019,12,20,17,162,160,322
2019,12,20,18,128,132,260
2019,12,20,19,88,111,199
2019,12,20,20,63,85,148
2019,12,20,21,55,89,144
2019,12,20,22,46,59,105
2019,12,20,23,32,48,80
2019,12,21,0,21,29,50
2019,12,21,1,21,17,38
2019,12,21,2,16,33,49
2019,12,21,3,13,16,29
2019,12,21,4,9,4,13
2019,12,21,5,23,17,40
2019,12,21,6,25,14,39
2019,12,21,7,35,26,61
2019,12,21,8,52,34,86
2019,12,21,9,101,65,166
2019,12,21,10,164,112,276
2019,12,21,11,164,141,305
2019,12,21,12,178,148,326
2019,12,21,13,177,148,325
2019,12,21,14,159,176,335
2019,12,21,15,139,174,313
2019,12,21,16,118,138,256
2019,12,21,17,132,163,295
2019,12,21,18,105,93,198
2019,12,21,19,64,82,146
2019,12,21,20,55,74,129
2019,12,21,21,54,63,117
2019,12,21,22,55,73,128
2019,12,21,23,29,37,66
2019,12,22,0,29,28,57
2019,12,22,1,12,17,29
2019,12,22,2,26,42,68
2019,12,22,3,14,26,40
2019,12,22,4,16,15,31
2019,12,22,5,21,12,33
2019,12,22,6,17,14,31
2019,12,22,7,22,14,36
2019,12,22,8,37,26,63
2019,12,22,9,94,46,140
2019,12,22,10,115,85,200
2019,12,22,11,152,133,285
2019,12,22,12,166,153,319
2019,12,22,13,187,148,335
2019,12,22,14,193,151,344
2019,12,22,15,146,158,304
2019,12,22,16,112,137,249
2019,12,22,17,123,138,261
2019,12,22,18,109,113,222
2019,12,22,19,102,107,209
2019,12,22,20,79,81,160
2019,12,22,21,68,76,144
2019,12,22,22,28,41,69
2019,12,22,23,19,67,86
2019,12,23,0,14,11,25
2019,12,23,1,6,12,18
2019,12,23,2,12,10,22
2019,12,23,3,8,8,16
2019,12,23,4,12,9,21
2019,12,23,5,47,29,76
2019,12,23,6,106,65,171
2019,12,23,7,135,85,220
2019,12,23,8,146,96,242
2019,12,23,9,159,133,292
2019,12,23,10,215,138,353
2019,12,23,11,205,164,369
2019,12,23,12,205,194,399
2019,12,23,13,222,240,462
2019,12,23,14,205,216,421
2019,12,23,15,165,191,356
2019,12,23,16,126,151,277
2019,12,23,17,130,120,250
2019,12,23,18,95,120,215
2019,12,23,19,85,74,159
2019,12,23,20,58,62,120
2019,12,23,21,52,51,103
2019,12,23,22,30,32,62
2019,12,23,23,11,9,20
2019,12,24,0,10,14,24
2019,12,24,1,5,8,13
2019,12,24,2,8,3,11
2019,12,24,3,5,5,10
2019,12,24,4,6,2,8
2019,12,24,5,32,9,41
2019,12,24,6,45,35,80
2019,12,24,7,43,28,71
2019,12,24,8,46,48,94
2019,12,24,9,80,68,148
2019,12,24,10,115,106,221
2019,12,24,11,138,126,264
2019,12,24,12,120,120,240
2019,12,24,13,132,125,257
2019,12,24,14,139,121,260
2019,12,24,15,116,131,247
2019,12,24,16,77,76,153
2019,12,24,17,46,35,81
2019,12,24,18,28,30,58
2019,12,24,19,45,30,75
2019,12,24,20,52,50,102
2019,12,24,21,81,89,170
2019,12,24,22,70,55,125
2019,12,24,23,55,60,115
2019,12,25,0,20,18,38
2019,12,25,1,6,9,15
2019,12,25,2,8,7,15
2019,12,25,3,3,8,11
2019,12,25,4,5,5,10
2019,12,25,5,11,9,20
2019,12,25,6,16,12,28
2019,12,25,7,12,7,19
2019,12,25,8,20,11,31
2019,12,25,9,25,28,53
2019,12,25,10,42,30,72
2019,12,25,11,72,62,134
2019,12,25,12,71,91,162
2019,12,25,13,116,113,229
2019,12,25,14,96,113,209
2019,12,25,15,84,103,187
2019,12,25,16,78,71,149
2019,12,25,17,76,63,139
2019,12,25,18,69,72,141
2019,12,25,19,84,71,155
2019,12,25,20,57,91,148
2019,12,25,21,48,56,104
2019,12,25,22,27,36,63
2019,12,25,23,22,24,46
2019,12,26,0,9,22,31
2019,12,26,1,13,12,25
2019,12,26,2,14,21,35
2019,12,26,3,7,6,13
2019,12,26,4,10,4,14
2019,12,26,5,6,11,17
2019,12,26,6,16,14,30
2019,12,26,7,17,19,36
2019,12,26,8,20,15,35
2019,12,26,9,36,29,65
2019,12,26,10,58,39,97
2019,12,26,11,83,71,154
2019,12,26,12,120,106,226
2019,12,26,13,104,110,214
2019,12,26,14,111,106,217
2019,12,26,15,83,110,193
2019,12,26,16,97,107,204
2019,12,26,17,91,97,188
2019,12,26,18,95,72,167
2019,12,26,19,100,119,219
2019,12,26,20,65,82,147
2019,12,26,21,42,67,109
2019,12,26,22,33,61,94
2019,12,26,23,19,30,49
2019,12,27,0,20,19,39
2019,12,27,1,19,25,44
2019,12,27,2,17,25,42
2019,12,27,3,14,19,33
2019,12,27,4,10,19,29
2019,12,27,5,35,23,58
2019,12,27,6,55,43,98
2019,12,27,7,81,47,128
2019,12,27,8,89,71,160
2019,12,27,9,110,75,185
2019,12,27,10,154,104,258
2019,12,27,11,167,117,284
2019,12,27,12,149,143,292
2019,12,27,13,157,166,323
2019,12,27,14,153,188,341
2019,12,27,15,117,159,276
2019,12,27,16,109,119,228
2019,12,27,17,88,92,180
2019,12,27,18,74,86,160
2019,12,27,19,87,74,161
2019,12,27,20,68,57,125
2019,12,27,21,43,65,108
2019,12,27,22,34,51,85
2019,12,27,23,26,34,60
2019,12,28,0,15,19,34
2019,12,28,1,15,13,28
2019,12,28,2,13,30,43
2019,12,28,3,7,7,14
2019,12,28,4,9,3,12
2019,12,28,5,20,7,27
2019,12,28,6,19,15,34
2019,12,28,7,23,15,38
2019,12,28,8,33,24,57
2019,12,28,9,57,31,88
2019,12,28,10,85,51,136
2019,12,28,11,95,81,176
2019,12,28,12,124,111,235
2019,12,28,13,112,125,237
2019,12,28,14,107,123,230
2019,12,28,15,105,133,238
2019,12,28,16,99,101,200
2019,12,28,17,111,95,206
2019,12,28,18,68,99,167
2019,12,28,19,59,65,124
2019,12,28,20,42,53,95
2019,12,28,21,37,63,100
2019,12,28,22,28,38,66
2019,12,28,23,46,49,95
2019,12,29,0,24,29,53
2019,12,29,1,22,27,49
2019,12,29,2,16,25,41
2019,12,29,3,18,25,43
2019,12,29,4,6,8,14
2019,12,29,5,21,11,32
2019,12,29,6,16,7,23
2019,12,29,7,12,14,26
2019,12,29,8,21,17,38
2019,12,29,9,46,34,80
2019,12,29,10,67,41,108
2019,12,29,11,110,69,179
2019,12,29,12,116,106,222
2019,12,29,13,123,140,263
2019,12,29,14,123,127,250
2019,12,29,15,102,140,242
2019,12,29,16,107,132,239
2019,12,29,17,95,93,188
2019,12,29,18,90,113,203
2019,12,29,19,98,93,191
2019,12,29,20,60,77,137
2019,12,29,21,47,61,108
2019,12,29,22,23,43,66
2019,12,29,23,29,26,55
2019,12,30,0,18,20,38
2019,12,30,1,7,7,14
2019,12,30,2,7,11,18
2019,12,30,3,7,9,16
2019,12,30,4,9,5,14
2019,12,30,5,35,20,55
2019,12,30,6,79,46,125
2019,12,30,7,105,57,162
2019,12,30,8,99,64,163
2019,12,30,9,135,94,229
2019,12,30,10,156,111,267
2019,12,30,11,174,155,329
2019,12,30,12,189,171,360
2019,12,30,13,194,209,403
2019,12,30,14,159,188,347
2019,12,30,15,112,143,255
2019,12,30,16,115,157,272
2019,12,30,17,104,114,218
2019,12,30,18,98,88,186
2019,12,30,19,85,85,170
2019,12,30,20,61,69,130
2019,12,30,21,37,41,78
2019,12,30,22,29,43,72
2019,12,30,23,22,24,46
2019,12,31,0,16,17,33
2019,12,31,1,12,11,23
2019,12,31,2,7,8,15
2019,12,31,3,4,6,10
2019,12,31,4,6,4,10
2019,12,31,5,33,11,44
2019,12,31,6,50,31,81
2019,12,31,7,44,31,75
2019,12,31,8,55,46,101
2019,12,31,9,63,53,116
2019,12,31,10,86,91,177
2019,12,31,11,118,101,219
2019,12,31,12,102,111,213
2019,12,31,13,92,132,224
2019,12,31,14,99,113,212
2019,12,31,15,105,96,201
2019,12,31,16,100,95,195
2019,12,31,17,107,95,202
2019,12,31,18,79,93,172
2019,12,31,19,77,72,149
2019,12,31,20,58,61,119
2019,12,31,21,52,51,103
2019,12,31,22,51,39,90
2019,12,31,23,34,81,115
